instant,dteday,yr,mnth,hr,holiday,weekday,workingday,weathersit,temp,atemp,hum,windspeed,casual,registered,cnt,cnt_check,season,time_cluster
1,2011-01-01,0,1,0,0,6,0,1,0.24,0.2879,0.81,0.0,3,13,16,16,1,
2,2011-01-01,0,1,1,0,6,0,1,0.22,0.2727,0.8,0.0,8,32,40,40,1,Pagi
3,2011-01-01,0,1,2,0,6,0,1,0.22,0.2727,0.8,0.0,5,27,32,32,1,Pagi
4,2011-01-01,0,1,3,0,6,0,1,0.24,0.2879,0.75,0.0,3,10,13,13,1,Pagi
5,2011-01-01,0,1,4,0,6,0,1,0.24,0.2879,0.75,0.0,0,1,1,1,1,Pagi
6,2011-01-01,0,1,5,0,6,0,2,0.24,0.2576,0.75,0.0896,0,1,1,1,1,Pagi
7,2011-01-01,0,1,6,0,6,0,1,0.22,0.2727,0.8,0.0,2,0,2,2,1,Pagi
8,2011-01-01,0,1,7,0,6,0,1,0.2,0.2576,0.86,0.0,1,2,3,3,1,Siang
9,2011-01-01,0,1,8,0,6,0,1,0.24,0.2879,0.75,0.0,1,7,8,8,1,Siang
10,2011-01-01,0,1,9,0,6,0,1,0.32,0.3485,0.76,0.0,8,6,14,14,1,Siang
11,2011-01-01,0,1,10,0,6,0,1,0.38,0.3939,0.76,0.2537,12,24,36,36,1,Siang
12,2011-01-01,0,1,11,0,6,0,1,0.36,0.3333,0.81,0.2836,26,30,56,56,1,Siang
13,2011-01-01,0,1,12,0,6,0,1,0.42,0.4242,0.77,0.2836,29,55,84,84,1,Siang
14,2011-01-01,0,1,13,0,6,0,2,0.46,0.4545,0.72,0.2985,47,47,94,94,1,Sore
15,2011-01-01,0,1,14,0,6,0,2,0.46,0.4545,0.72,0.2836,35,71,106,106,1,Sore
16,2011-01-01,0,1,15,0,6,0,2,0.44,0.4394,0.77,0.2985,40,70,110,110,1,Sore
17,2011-01-01,0,1,16,0,6,0,2,0.42,0.4242,0.82,0.2985,41,52,93,93,1,Sore
18,2011-01-01,0,1,17,0,6,0,2,0.44,0.4394,0.82,0.2836,15,52,67,67,1,Sore
19,2011-01-01,0,1,18,0,6,0,3,0.42,0.4242,0.88,0.2537,9,26,35,35,1,Sore
20,2011-01-01,0,1,19,0,6,0,3,0.42,0.4242,0.88,0.2537,6,31,37,37,1,Malam
21,2011-01-01,0,1,20,0,6,0,2,0.4,0.4091,0.87,0.2537,11,25,36,36,1,Malam
22,2011-01-01,0,1,21,0,6,0,2,0.4,0.4091,0.87,0.194,3,31,34,34,1,Malam
23,2011-01-01,0,1,22,0,6,0,2,0.4,0.4091,0.94,0.2239,11,17,28,28,1,Malam
24,2011-01-01,0,1,23,0,6,0,2,0.46,0.4545,0.88,0.2985,15,24,39,39,1,Malam
25,2011-01-02,0,1,0,0,0,0,2,0.46,0.4545,0.88,0.2985,4,13,17,17,1,
26,2011-01-02,0,1,1,0,0,0,2,0.44,0.4394,0.94,0.2537,1,16,17,17,1,Pagi
27,2011-01-02,0,1,2,0,0,0,2,0.42,0.4242,1.0,0.2836,1,8,9,9,1,Pagi
28,2011-01-02,0,1,3,0,0,0,2,0.46,0.4545,0.94,0.194,2,4,6,6,1,Pagi
29,2011-01-02,0,1,4,0,0,0,2,0.46,0.4545,0.94,0.194,2,1,3,3,1,Pagi
30,2011-01-02,0,1,6,0,0,0,3,0.42,0.4242,0.77,0.2985,0,2,2,2,1,Pagi
31,2011-01-02,0,1,7,0,0,0,2,0.4,0.4091,0.76,0.194,0,1,1,1,1,Siang
32,2011-01-02,0,1,8,0,0,0,3,0.4,0.4091,0.71,0.2239,0,8,8,8,1,Siang
33,2011-01-02,0,1,9,0,0,0,2,0.38,0.3939,0.76,0.2239,1,19,20,20,1,Siang
34,2011-01-02,0,1,10,0,0,0,2,0.36,0.3485,0.81,0.2239,7,46,53,53,1,Siang
35,2011-01-02,0,1,11,0,0,0,2,0.36,0.3333,0.71,0.2537,16,54,70,70,1,Siang
36,2011-01-02,0,1,12,0,0,0,2,0.36,0.3333,0.66,0.2985,20,73,93,93,1,Siang
37,2011-01-02,0,1,13,0,0,0,2,0.36,0.3485,0.66,0.1343,11,64,75,75,1,Sore
38,2011-01-02,0,1,14,0,0,0,3,0.36,0.3485,0.76,0.194,4,55,59,59,1,Sore
39,2011-01-02,0,1,15,0,0,0,3,0.34,0.3333,0.81,0.1642,19,55,74,74,1,Sore
40,2011-01-02,0,1,16,0,0,0,3,0.34,0.3333,0.71,0.1642,9,67,76,76,1,Sore
41,2011-01-02,0,1,17,0,0,0,1,0.34,0.3333,0.57,0.194,7,58,65,65,1,Sore
42,2011-01-02,0,1,18,0,0,0,2,0.36,0.3333,0.46,0.3284,10,43,53,53,1,Sore
43,2011-01-02,0,1,19,0,0,0,1,0.32,0.2879,0.42,0.4478,1,29,30,30,1,Malam
44,2011-01-02,0,1,20,0,0,0,1,0.3,0.2727,0.39,0.3582,5,17,22,22,1,Malam
45,2011-01-02,0,1,21,0,0,0,1,0.26,0.2273,0.44,0.3284,11,20,31,31,1,Malam
46,2011-01-02,0,1,22,0,0,0,1,0.24,0.2121,0.44,0.2985,0,9,9,9,1,Malam
47,2011-01-02,0,1,23,0,0,0,1,0.22,0.2273,0.47,0.1642,0,8,8,8,1,Malam
48,2011-01-03,0,1,0,0,1,1,1,0.22,0.197,0.44,0.3582,0,5,5,5,1,
49,2011-01-03,0,1,1,0,1,1,1,0.2,0.1667,0.44,0.4179,0,2,2,2,1,Pagi
50,2011-01-03,0,1,4,0,1,1,1,0.16,0.1364,0.47,0.3881,0,1,1,1,1,Pagi
51,2011-01-03,0,1,5,0,1,1,1,0.16,0.1364,0.47,0.2836,0,3,3,3,1,Pagi
52,2011-01-03,0,1,6,0,1,1,1,0.14,0.1061,0.5,0.3881,0,30,30,30,1,Pagi
53,2011-01-03,0,1,7,0,1,1,1,0.14,0.1364,0.5,0.194,1,63,64,64,1,Siang
54,2011-01-03,0,1,8,0,1,1,1,0.14,0.1212,0.5,0.2836,1,153,154,154,1,Siang
55,2011-01-03,0,1,9,0,1,1,1,0.16,0.1364,0.43,0.3881,7,81,88,88,1,Siang
56,2011-01-03,0,1,10,0,1,1,1,0.18,0.1667,0.43,0.2537,11,33,44,44,1,Siang
57,2011-01-03,0,1,11,0,1,1,1,0.2,0.1818,0.4,0.3284,10,41,51,51,1,Siang
58,2011-01-03,0,1,12,0,1,1,1,0.22,0.2121,0.35,0.2985,13,48,61,61,1,Siang
59,2011-01-03,0,1,13,0,1,1,1,0.24,0.2121,0.35,0.2836,8,53,61,61,1,Sore
60,2011-01-03,0,1,14,0,1,1,1,0.26,0.2424,0.3,0.2836,11,66,77,77,1,Sore
61,2011-01-03,0,1,15,0,1,1,1,0.26,0.2424,0.3,0.2537,14,58,72,72,1,Sore
62,2011-01-03,0,1,16,0,1,1,1,0.26,0.2424,0.3,0.2537,9,67,76,76,1,Sore
63,2011-01-03,0,1,17,0,1,1,1,0.24,0.2273,0.3,0.2239,11,146,157,157,1,Sore
64,2011-01-03,0,1,18,0,1,1,1,0.24,0.2576,0.32,0.1045,9,148,157,157,1,Sore
65,2011-01-03,0,1,19,0,1,1,1,0.2,0.2576,0.47,0.0,8,102,110,110,1,Malam
66,2011-01-03,0,1,20,0,1,1,1,0.2,0.2273,0.47,0.1045,3,49,52,52,1,Malam
67,2011-01-03,0,1,21,0,1,1,1,0.18,0.197,0.64,0.1343,3,49,52,52,1,Malam
68,2011-01-03,0,1,22,0,1,1,1,0.14,0.1515,0.69,0.1343,0,20,20,20,1,Malam
69,2011-01-03,0,1,23,0,1,1,1,0.18,0.2121,0.55,0.1045,1,11,12,12,1,Malam
70,2011-01-04,0,1,0,0,2,1,1,0.16,0.1818,0.55,0.1045,0,5,5,5,1,
71,2011-01-04,0,1,1,0,2,1,1,0.16,0.1818,0.59,0.1045,0,2,2,2,1,Pagi
72,2011-01-04,0,1,2,0,2,1,1,0.14,0.1515,0.63,0.1343,0,1,1,1,1,Pagi
73,2011-01-04,0,1,4,0,2,1,1,0.14,0.1818,0.63,0.0896,0,2,2,2,1,Pagi
74,2011-01-04,0,1,5,0,2,1,1,0.12,0.1515,0.68,0.1045,0,4,4,4,1,Pagi
75,2011-01-04,0,1,6,0,2,1,1,0.12,0.1515,0.74,0.1045,0,36,36,36,1,Pagi
76,2011-01-04,0,1,7,0,2,1,1,0.12,0.1515,0.74,0.1343,2,92,94,94,1,Siang
77,2011-01-04,0,1,8,0,2,1,1,0.14,0.1515,0.69,0.1642,2,177,179,179,1,Siang
78,2011-01-04,0,1,9,0,2,1,1,0.16,0.1515,0.64,0.2239,2,98,100,100,1,Siang
79,2011-01-04,0,1,10,0,2,1,2,0.16,0.1364,0.69,0.3284,5,37,42,42,1,Siang
80,2011-01-04,0,1,11,0,2,1,1,0.22,0.2121,0.51,0.2985,7,50,57,57,1,Siang
81,2011-01-04,0,1,12,0,2,1,1,0.22,0.2273,0.51,0.1642,12,66,78,78,1,Siang
82,2011-01-04,0,1,13,0,2,1,1,0.24,0.2273,0.56,0.194,18,79,97,97,1,Sore
83,2011-01-04,0,1,14,0,2,1,1,0.26,0.2576,0.52,0.2239,9,54,63,63,1,Sore
84,2011-01-04,0,1,15,0,2,1,1,0.28,0.2727,0.52,0.2537,17,48,65,65,1,Sore
85,2011-01-04,0,1,16,0,2,1,1,0.3,0.2879,0.49,0.2537,15,68,83,83,1,Sore
86,2011-01-04,0,1,17,0,2,1,1,0.28,0.2727,0.48,0.2239,10,202,212,212,1,Sore
87,2011-01-04,0,1,18,0,2,1,1,0.26,0.2576,0.48,0.194,3,179,182,182,1,Sore
88,2011-01-04,0,1,19,0,2,1,1,0.24,0.2576,0.48,0.1045,2,110,112,112,1,Malam
89,2011-01-04,0,1,20,0,2,1,1,0.24,0.2576,0.48,0.1045,1,53,54,54,1,Malam
90,2011-01-04,0,1,21,0,2,1,1,0.22,0.2727,0.64,0.0,0,48,48,48,1,Malam
91,2011-01-04,0,1,22,0,2,1,1,0.22,0.2576,0.64,0.0896,1,34,35,35,1,Malam
92,2011-01-04,0,1,23,0,2,1,1,0.2,0.2273,0.69,0.0896,2,9,11,11,1,Malam
93,2011-01-05,0,1,0,0,3,1,1,0.2,0.2576,0.64,0.0,0,6,6,6,1,
94,2011-01-05,0,1,1,0,3,1,1,0.16,0.197,0.74,0.0896,0,6,6,6,1,Pagi
95,2011-01-05,0,1,2,0,3,1,1,0.16,0.197,0.74,0.0896,0,2,2,2,1,Pagi
96,2011-01-05,0,1,4,0,3,1,1,0.24,0.2273,0.48,0.2239,0,2,2,2,1,Pagi
97,2011-01-05,0,1,5,0,3,1,1,0.22,0.2273,0.47,0.1642,0,3,3,3,1,Pagi
98,2011-01-05,0,1,6,0,3,1,1,0.2,0.197,0.47,0.2239,0,33,33,33,1,Pagi
99,2011-01-05,0,1,7,0,3,1,1,0.18,0.1818,0.43,0.194,1,87,88,88,1,Siang
100,2011-01-05,0,1,8,0,3,1,1,0.2,0.1818,0.4,0.2985,3,192,195,195,1,Siang
101,2011-01-05,0,1,9,0,3,1,1,0.22,0.197,0.37,0.3284,6,109,115,115,1,Siang
102,2011-01-05,0,1,10,0,3,1,1,0.22,0.197,0.37,0.3284,4,53,57,57,1,Siang
103,2011-01-05,0,1,11,0,3,1,1,0.26,0.2273,0.33,0.3284,12,34,46,46,1,Siang
104,2011-01-05,0,1,12,0,3,1,1,0.26,0.2273,0.33,0.3284,5,74,79,79,1,Siang
105,2011-01-05,0,1,13,0,3,1,1,0.28,0.2576,0.3,0.2985,6,65,71,71,1,Sore
106,2011-01-05,0,1,14,0,3,1,1,0.3,0.2879,0.28,0.194,10,52,62,62,1,Sore
107,2011-01-05,0,1,15,0,3,1,1,0.3,0.2879,0.28,0.194,7,55,62,62,1,Sore
108,2011-01-05,0,1,16,0,3,1,1,0.3,0.3182,0.28,0.0896,4,85,89,89,1,Sore
109,2011-01-05,0,1,17,0,3,1,1,0.24,0.2273,0.38,0.194,4,186,190,190,1,Sore
110,2011-01-05,0,1,18,0,3,1,1,0.24,0.2424,0.38,0.1343,3,166,169,169,1,Sore
111,2011-01-05,0,1,19,0,3,1,1,0.24,0.2576,0.38,0.1045,5,127,132,132,1,Malam
112,2011-01-05,0,1,20,0,3,1,1,0.22,0.2273,0.47,0.1642,7,82,89,89,1,Malam
113,2011-01-05,0,1,21,0,3,1,1,0.2,0.197,0.51,0.194,3,40,43,43,1,Malam
114,2011-01-05,0,1,22,0,3,1,1,0.18,0.197,0.55,0.1343,1,41,42,42,1,Malam
115,2011-01-05,0,1,23,0,3,1,1,0.2,0.2576,0.47,0.0,1,18,19,19,1,Malam
116,2011-01-06,0,1,0,0,4,1,1,0.18,0.2424,0.55,0.0,0,11,11,11,1,
117,2011-01-06,0,1,1,0,4,1,1,0.16,0.2273,0.64,0.0,0,4,4,4,1,Pagi
118,2011-01-06,0,1,2,0,4,1,1,0.16,0.2273,0.64,0.0,0,2,2,2,1,Pagi
119,2011-01-06,0,1,4,0,4,1,2,0.16,0.197,0.64,0.0896,0,1,1,1,1,Pagi
120,2011-01-06,0,1,5,0,4,1,2,0.14,0.1818,0.69,0.0896,0,4,4,4,1,Pagi
121,2011-01-06,0,1,6,0,4,1,2,0.14,0.1667,0.63,0.1045,0,36,36,36,1,Pagi
122,2011-01-06,0,1,7,0,4,1,2,0.16,0.2273,0.59,0.0,0,95,95,95,1,Siang
123,2011-01-06,0,1,8,0,4,1,1,0.16,0.2273,0.59,0.0,3,216,219,219,1,Siang
124,2011-01-06,0,1,9,0,4,1,2,0.18,0.2424,0.51,0.0,6,116,122,122,1,Siang
125,2011-01-06,0,1,10,0,4,1,1,0.2,0.2576,0.47,0.0,3,42,45,45,1,Siang
126,2011-01-06,0,1,11,0,4,1,1,0.22,0.2576,0.44,0.0896,2,57,59,59,1,Siang
127,2011-01-06,0,1,12,0,4,1,1,0.26,0.2879,0.35,0.0,6,78,84,84,1,Siang
128,2011-01-06,0,1,13,0,4,1,1,0.26,0.2727,0.35,0.1045,12,55,67,67,1,Sore
129,2011-01-06,0,1,14,0,4,1,1,0.28,0.2727,0.36,0.1642,11,59,70,70,1,Sore
130,2011-01-06,0,1,15,0,4,1,1,0.28,0.2727,0.36,0.0,8,54,62,62,1,Sore
131,2011-01-06,0,1,16,0,4,1,1,0.26,0.2576,0.38,0.1642,12,74,86,86,1,Sore
132,2011-01-06,0,1,17,0,4,1,1,0.22,0.2273,0.51,0.1642,9,163,172,172,1,Sore
133,2011-01-06,0,1,18,0,4,1,1,0.22,0.2273,0.51,0.1343,5,158,163,163,1,Sore
134,2011-01-06,0,1,19,0,4,1,1,0.22,0.2576,0.55,0.0896,3,109,112,112,1,Malam
135,2011-01-06,0,1,20,0,4,1,1,0.2,0.2121,0.51,0.1642,3,66,69,69,1,Malam
136,2011-01-06,0,1,21,0,4,1,2,0.22,0.2121,0.55,0.2239,0,48,48,48,1,Malam
137,2011-01-06,0,1,22,0,4,1,2,0.22,0.2121,0.51,0.2836,1,51,52,52,1,Malam
138,2011-01-06,0,1,23,0,4,1,2,0.2,0.197,0.59,0.194,4,19,23,23,1,Malam
139,2011-01-07,0,1,0,0,5,1,2,0.2,0.197,0.64,0.194,4,13,17,17,1,
140,2011-01-07,0,1,1,0,5,1,2,0.2,0.197,0.69,0.2239,2,5,7,7,1,Pagi
141,2011-01-07,0,1,2,0,5,1,2,0.2,0.197,0.69,0.2239,0,1,1,1,1,Pagi
142,2011-01-07,0,1,4,0,5,1,2,0.2,0.2121,0.69,0.1343,0,1,1,1,1,Pagi
143,2011-01-07,0,1,5,0,5,1,3,0.22,0.2727,0.55,0.0,0,5,5,5,1,Pagi
144,2011-01-07,0,1,6,0,5,1,2,0.2,0.2576,0.69,0.0,8,26,34,34,1,Pagi
145,2011-01-07,0,1,7,0,5,1,1,0.2,0.2121,0.69,0.1343,8,76,84,84,1,Siang
146,2011-01-07,0,1,8,0,5,1,1,0.2,0.197,0.51,0.2537,20,190,210,210,1,Siang
147,2011-01-07,0,1,9,0,5,1,1,0.2,0.1818,0.47,0.2985,9,125,134,134,1,Siang
148,2011-01-07,0,1,10,0,5,1,1,0.22,0.197,0.37,0.3284,16,47,63,63,1,Siang
149,2011-01-07,0,1,11,0,5,1,2,0.2,0.197,0.4,0.2239,19,48,67,67,1,Siang
150,2011-01-07,0,1,12,0,5,1,2,0.2,0.197,0.37,0.2537,9,50,59,59,1,Siang
151,2011-01-07,0,1,13,0,5,1,2,0.2,0.1818,0.37,0.2836,9,64,73,73,1,Sore
152,2011-01-07,0,1,14,0,5,1,2,0.2,0.197,0.4,0.2537,7,43,50,50,1,Sore
153,2011-01-07,0,1,15,0,5,1,2,0.2,0.2121,0.37,0.1642,9,63,72,72,1,Sore
154,2011-01-07,0,1,16,0,5,1,2,0.2,0.2121,0.37,0.1642,5,82,87,87,1,Sore
155,2011-01-07,0,1,17,0,5,1,2,0.2,0.2576,0.37,0.0,9,178,187,187,1,Sore
156,2011-01-07,0,1,18,0,5,1,1,0.2,0.2273,0.4,0.0896,7,116,123,123,1,Sore
157,2011-01-07,0,1,19,0,5,1,1,0.16,0.197,0.55,0.0896,3,92,95,95,1,Malam
158,2011-01-07,0,1,20,0,5,1,1,0.18,0.2121,0.47,0.1045,1,50,51,51,1,Malam
159,2011-01-07,0,1,21,0,5,1,1,0.18,0.197,0.47,0.1343,0,39,39,39,1,Malam
160,2011-01-07,0,1,22,0,5,1,2,0.18,0.197,0.43,0.1642,2,34,36,36,1,Malam
161,2011-01-07,0,1,23,0,5,1,2,0.18,0.197,0.51,0.1642,1,14,15,15,1,Malam
162,2011-01-08,0,1,0,0,6,0,2,0.18,0.197,0.51,0.1642,1,24,25,25,1,
163,2011-01-08,0,1,1,0,6,0,2,0.18,0.2121,0.55,0.0896,1,15,16,16,1,Pagi
164,2011-01-08,0,1,2,0,6,0,2,0.18,0.2424,0.55,0.0,3,13,16,16,1,Pagi
165,2011-01-08,0,1,3,0,6,0,3,0.18,0.197,0.55,0.1642,0,7,7,7,1,Pagi
166,2011-01-08,0,1,4,0,6,0,3,0.18,0.197,0.55,0.1642,0,1,1,1,1,Pagi
167,2011-01-08,0,1,5,0,6,0,2,0.16,0.1667,0.74,0.1642,0,5,5,5,1,Pagi
168,2011-01-08,0,1,6,0,6,0,2,0.16,0.1667,0.74,0.1642,0,2,2,2,1,Pagi
169,2011-01-08,0,1,7,0,6,0,2,0.16,0.1818,0.74,0.1045,1,8,9,9,1,Siang
170,2011-01-08,0,1,8,0,6,0,3,0.16,0.1818,0.93,0.1045,0,15,15,15,1,Siang
171,2011-01-08,0,1,9,0,6,0,3,0.16,0.1818,0.93,0.1045,0,20,20,20,1,Siang
172,2011-01-08,0,1,10,0,6,0,2,0.18,0.197,0.8,0.1642,5,56,61,61,1,Siang
173,2011-01-08,0,1,11,0,6,0,2,0.2,0.1818,0.69,0.3881,2,60,62,62,1,Siang
174,2011-01-08,0,1,12,0,6,0,2,0.2,0.1818,0.59,0.3582,8,90,98,98,1,Siang
175,2011-01-08,0,1,13,0,6,0,1,0.2,0.1818,0.44,0.3284,7,95,102,102,1,Sore
176,2011-01-08,0,1,14,0,6,0,1,0.2,0.1667,0.32,0.4925,12,83,95,95,1,Sore
177,2011-01-08,0,1,15,0,6,0,1,0.2,0.1667,0.32,0.4478,5,69,74,74,1,Sore
178,2011-01-08,0,1,16,0,6,0,1,0.18,0.1364,0.29,0.4478,8,68,76,76,1,Sore
179,2011-01-08,0,1,17,0,6,0,1,0.16,0.1212,0.37,0.5522,5,64,69,69,1,Sore
180,2011-01-08,0,1,18,0,6,0,1,0.14,0.1212,0.39,0.2985,3,52,55,55,1,Sore
181,2011-01-08,0,1,19,0,6,0,1,0.14,0.1212,0.36,0.2537,4,26,30,30,1,Malam
182,2011-01-08,0,1,20,0,6,0,1,0.12,0.1212,0.36,0.2537,0,28,28,28,1,Malam
183,2011-01-08,0,1,21,0,6,0,1,0.12,0.1061,0.39,0.3582,2,35,37,37,1,Malam
184,2011-01-08,0,1,22,0,6,0,1,0.12,0.1061,0.36,0.3881,1,33,34,34,1,Malam
185,2011-01-08,0,1,23,0,6,0,1,0.1,0.0606,0.39,0.4478,0,22,22,22,1,Malam
186,2011-01-09,0,1,0,0,0,0,1,0.1,0.0758,0.42,0.3881,1,24,25,25,1,
187,2011-01-09,0,1,1,0,0,0,1,0.1,0.0606,0.42,0.4627,0,12,12,12,1,Pagi
188,2011-01-09,0,1,2,0,0,0,1,0.1,0.0606,0.46,0.4627,0,11,11,11,1,Pagi
189,2011-01-09,0,1,3,0,0,0,1,0.1,0.0758,0.46,0.4179,0,4,4,4,1,Pagi
190,2011-01-09,0,1,4,0,0,0,1,0.08,0.0909,0.53,0.194,0,1,1,1,1,Pagi
191,2011-01-09,0,1,5,0,0,0,1,0.08,0.0909,0.53,0.194,0,1,1,1,1,Pagi
192,2011-01-09,0,1,6,0,0,0,1,0.1,0.0909,0.49,0.2836,0,1,1,1,1,Pagi
193,2011-01-09,0,1,7,0,0,0,1,0.08,0.0909,0.53,0.194,1,5,6,6,1,Siang
194,2011-01-09,0,1,8,0,0,0,1,0.1,0.0909,0.49,0.2836,0,10,10,10,1,Siang
195,2011-01-09,0,1,9,0,0,0,1,0.12,0.0758,0.46,0.5224,0,19,19,19,1,Siang
196,2011-01-09,0,1,10,0,0,0,1,0.14,0.1061,0.43,0.3881,0,49,49,49,1,Siang
197,2011-01-09,0,1,11,0,0,0,1,0.16,0.1212,0.4,0.5224,2,47,49,49,1,Siang
198,2011-01-09,0,1,12,0,0,0,1,0.18,0.1364,0.37,0.4478,4,79,83,83,1,Siang
199,2011-01-09,0,1,13,0,0,0,1,0.2,0.1667,0.34,0.4478,6,69,75,75,1,Sore
200,2011-01-09,0,1,14,0,0,0,1,0.22,0.1818,0.32,0.4627,8,64,72,72,1,Sore
201,2011-01-09,0,1,15,0,0,0,1,0.22,0.197,0.35,0.3582,5,77,82,82,1,Sore
202,2011-01-09,0,1,16,0,0,0,1,0.2,0.1667,0.34,0.4478,13,79,92,92,1,Sore
203,2011-01-09,0,1,17,0,0,0,1,0.18,0.1515,0.37,0.3881,3,59,62,62,1,Sore
204,2011-01-09,0,1,18,0,0,0,1,0.16,0.1364,0.4,0.3284,4,44,48,48,1,Sore
205,2011-01-09,0,1,19,0,0,0,1,0.16,0.1364,0.43,0.3284,1,40,41,41,1,Malam
206,2011-01-09,0,1,20,0,0,0,1,0.14,0.1212,0.46,0.2537,0,38,38,38,1,Malam
207,2011-01-09,0,1,21,0,0,0,1,0.14,0.1061,0.46,0.4179,1,19,20,20,1,Malam
208,2011-01-09,0,1,22,0,0,0,1,0.14,0.1212,0.46,0.2985,5,10,15,15,1,Malam
209,2011-01-09,0,1,23,0,0,0,1,0.12,0.1364,0.5,0.194,0,6,6,6,1,Malam
210,2011-01-10,0,1,0,0,1,1,1,0.12,0.1212,0.5,0.2836,2,3,5,5,1,
211,2011-01-10,0,1,1,0,1,1,1,0.12,0.1212,0.5,0.2836,1,0,1,1,1,Pagi
212,2011-01-10,0,1,2,0,1,1,1,0.12,0.1212,0.5,0.2239,0,3,3,3,1,Pagi
213,2011-01-10,0,1,3,0,1,1,1,0.12,0.1212,0.5,0.2239,0,1,1,1,1,Pagi
214,2011-01-10,0,1,4,0,1,1,1,0.1,0.1212,0.54,0.1343,1,2,3,3,1,Pagi
215,2011-01-10,0,1,5,0,1,1,1,0.1,0.1061,0.54,0.2537,0,3,3,3,1,Pagi
216,2011-01-10,0,1,6,0,1,1,1,0.12,0.1212,0.5,0.2836,0,31,31,31,1,Pagi
217,2011-01-10,0,1,7,0,1,1,1,0.12,0.1212,0.5,0.2239,2,75,77,77,1,Siang
218,2011-01-10,0,1,8,0,1,1,2,0.12,0.1212,0.5,0.2836,4,184,188,188,1,Siang
219,2011-01-10,0,1,9,0,1,1,2,0.14,0.1212,0.5,0.2537,2,92,94,94,1,Siang
220,2011-01-10,0,1,10,0,1,1,2,0.14,0.1212,0.5,0.2985,0,31,31,31,1,Siang
221,2011-01-10,0,1,11,0,1,1,2,0.16,0.1364,0.47,0.2836,2,28,30,30,1,Siang
222,2011-01-10,0,1,12,0,1,1,2,0.2,0.1818,0.4,0.2836,5,47,52,52,1,Siang
223,2011-01-10,0,1,13,0,1,1,2,0.2,0.1818,0.4,0.2836,4,50,54,54,1,Sore
224,2011-01-10,0,1,14,0,1,1,2,0.2,0.197,0.4,0.2239,0,47,47,47,1,Sore
225,2011-01-10,0,1,15,0,1,1,2,0.2,0.197,0.4,0.2239,2,43,45,45,1,Sore
226,2011-01-10,0,1,16,0,1,1,1,0.2,0.2121,0.4,0.1343,4,70,74,74,1,Sore
227,2011-01-10,0,1,17,0,1,1,1,0.2,0.2273,0.4,0.1045,4,174,178,178,1,Sore
228,2011-01-10,0,1,18,0,1,1,1,0.2,0.197,0.4,0.2239,1,154,155,155,1,Sore
229,2011-01-10,0,1,19,0,1,1,1,0.16,0.1667,0.47,0.1642,3,92,95,95,1,Malam
230,2011-01-10,0,1,20,0,1,1,1,0.16,0.1667,0.5,0.1642,1,73,74,74,1,Malam
231,2011-01-10,0,1,21,0,1,1,1,0.14,0.1364,0.59,0.194,1,37,38,38,1,Malam
232,2011-01-10,0,1,22,0,1,1,1,0.14,0.1515,0.59,0.1642,2,22,24,24,1,Malam
233,2011-01-10,0,1,23,0,1,1,1,0.14,0.1515,0.59,0.1642,0,18,18,18,1,Malam
234,2011-01-11,0,1,0,0,2,1,1,0.14,0.1667,0.59,0.1045,2,10,12,12,1,
235,2011-01-11,0,1,1,0,2,1,1,0.14,0.1515,0.59,0.1642,0,3,3,3,1,Pagi
236,2011-01-11,0,1,2,0,2,1,2,0.16,0.1515,0.55,0.194,0,3,3,3,1,Pagi
237,2011-01-11,0,1,5,0,2,1,2,0.16,0.1818,0.55,0.1343,0,6,6,6,1,Pagi
238,2011-01-11,0,1,6,0,2,1,2,0.16,0.1818,0.55,0.1343,0,27,27,27,1,Pagi
239,2011-01-11,0,1,7,0,2,1,2,0.16,0.2273,0.55,0.0,2,97,99,99,1,Siang
240,2011-01-11,0,1,8,0,2,1,2,0.18,0.2121,0.51,0.0896,3,214,217,217,1,Siang
241,2011-01-11,0,1,9,0,2,1,2,0.18,0.197,0.51,0.1642,3,127,130,130,1,Siang
242,2011-01-11,0,1,10,0,2,1,2,0.2,0.2121,0.51,0.1642,3,51,54,54,1,Siang
243,2011-01-11,0,1,11,0,2,1,2,0.2,0.2121,0.47,0.1343,4,31,35,35,1,Siang
244,2011-01-11,0,1,12,0,2,1,2,0.2,0.2273,0.51,0.1045,2,55,57,57,1,Siang
245,2011-01-11,0,1,13,0,2,1,2,0.2,0.2273,0.59,0.0896,6,46,52,52,1,Sore
246,2011-01-11,0,1,14,0,2,1,2,0.2,0.2273,0.59,0.0896,3,60,63,63,1,Sore
247,2011-01-11,0,1,15,0,2,1,2,0.16,0.197,0.8,0.0896,2,45,47,47,1,Sore
248,2011-01-11,0,1,16,0,2,1,2,0.16,0.1515,0.86,0.2239,4,72,76,76,1,Sore
249,2011-01-11,0,1,17,0,2,1,2,0.16,0.1515,0.86,0.2239,6,130,136,136,1,Sore
250,2011-01-11,0,1,18,0,2,1,3,0.16,0.1818,0.93,0.1045,1,94,95,95,1,Sore
251,2011-01-11,0,1,19,0,2,1,3,0.16,0.2273,0.93,0.0,0,51,51,51,1,Malam
252,2011-01-11,0,1,20,0,2,1,3,0.16,0.1515,0.93,0.194,0,32,32,32,1,Malam
253,2011-01-11,0,1,21,0,2,1,3,0.16,0.197,0.86,0.0896,0,20,20,20,1,Malam
254,2011-01-11,0,1,22,0,2,1,3,0.16,0.1818,0.93,0.1045,1,28,29,29,1,Malam
255,2011-01-11,0,1,23,0,2,1,3,0.16,0.197,0.93,0.0896,1,18,19,19,1,Malam
256,2011-01-12,0,1,0,0,3,1,2,0.16,0.197,0.86,0.0896,0,7,7,7,1,
257,2011-01-12,0,1,1,0,3,1,2,0.16,0.1818,0.86,0.1045,0,6,6,6,1,Pagi
258,2011-01-12,0,1,2,0,3,1,1,0.14,0.1515,0.86,0.1343,0,1,1,1,1,Pagi
259,2011-01-12,0,1,5,0,3,1,1,0.14,0.1515,0.86,0.1642,0,5,5,5,1,Pagi
260,2011-01-12,0,1,6,0,3,1,1,0.12,0.1515,0.93,0.1343,0,16,16,16,1,Pagi
261,2011-01-12,0,1,7,0,3,1,1,0.14,0.1515,0.69,0.1343,0,54,54,54,1,Siang
262,2011-01-12,0,1,8,0,3,1,1,0.16,0.1667,0.59,0.1642,3,125,128,128,1,Siang
263,2011-01-12,0,1,9,0,3,1,1,0.16,0.1364,0.59,0.3284,3,78,81,81,1,Siang
264,2011-01-12,0,1,10,0,3,1,1,0.18,0.1818,0.55,0.2239,0,39,39,39,1,Siang
265,2011-01-12,0,1,11,0,3,1,1,0.2,0.1818,0.51,0.3881,3,32,35,35,1,Siang
266,2011-01-12,0,1,12,0,3,1,1,0.2,0.1515,0.47,0.5821,3,52,55,55,1,Siang
267,2011-01-12,0,1,13,0,3,1,1,0.22,0.197,0.44,0.3582,0,49,49,49,1,Sore
268,2011-01-12,0,1,14,0,3,1,1,0.2,0.1818,0.47,0.3284,0,44,44,44,1,Sore
269,2011-01-12,0,1,15,0,3,1,1,0.2,0.1667,0.47,0.4179,1,48,49,49,1,Sore
270,2011-01-12,0,1,16,0,3,1,1,0.22,0.197,0.44,0.3284,5,63,68,68,1,Sore
271,2011-01-12,0,1,17,0,3,1,1,0.2,0.1818,0.47,0.3582,0,139,139,139,1,Sore
272,2011-01-12,0,1,18,0,3,1,1,0.2,0.1515,0.47,0.5224,2,135,137,137,1,Sore
273,2011-01-12,0,1,19,0,3,1,1,0.18,0.1515,0.47,0.4179,1,82,83,83,1,Malam
274,2011-01-12,0,1,20,0,3,1,1,0.16,0.1364,0.5,0.3284,2,54,56,56,1,Malam
275,2011-01-12,0,1,21,0,3,1,1,0.16,0.1364,0.55,0.3284,0,57,57,57,1,Malam
276,2011-01-12,0,1,22,0,3,1,1,0.16,0.1212,0.55,0.4478,1,32,33,33,1,Malam
277,2011-01-12,0,1,23,0,3,1,1,0.14,0.1061,0.59,0.4179,1,19,20,20,1,Malam
278,2011-01-13,0,1,0,0,4,1,1,0.14,0.1212,0.59,0.2836,1,6,7,7,1,
279,2011-01-13,0,1,1,0,4,1,1,0.14,0.1212,0.5,0.2836,0,2,2,2,1,Pagi
280,2011-01-13,0,1,2,0,4,1,1,0.14,0.1212,0.5,0.3582,0,2,2,2,1,Pagi
281,2011-01-13,0,1,3,0,4,1,1,0.14,0.1212,0.5,0.3284,0,3,3,3,1,Pagi
282,2011-01-13,0,1,4,0,4,1,1,0.14,0.1212,0.5,0.2537,0,4,4,4,1,Pagi
283,2011-01-13,0,1,5,0,4,1,1,0.14,0.1212,0.5,0.2985,0,3,3,3,1,Pagi
284,2011-01-13,0,1,6,0,4,1,1,0.12,0.1515,0.54,0.1343,0,28,28,28,1,Pagi
285,2011-01-13,0,1,7,0,4,1,1,0.12,0.1515,0.54,0.1343,0,72,72,72,1,Siang
286,2011-01-13,0,1,8,0,4,1,1,0.14,0.1364,0.5,0.194,5,197,202,202,1,Siang
287,2011-01-13,0,1,9,0,4,1,1,0.14,0.1212,0.5,0.3284,2,137,139,139,1,Siang
288,2011-01-13,0,1,10,0,4,1,2,0.16,0.1364,0.5,0.3582,2,36,38,38,1,Siang
289,2011-01-13,0,1,11,0,4,1,2,0.2,0.1667,0.44,0.4478,4,33,37,37,1,Siang
290,2011-01-13,0,1,12,0,4,1,1,0.2,0.1667,0.44,0.4179,3,49,52,52,1,Siang
291,2011-01-13,0,1,13,0,4,1,1,0.22,0.197,0.41,0.4478,2,81,83,83,1,Sore
292,2011-01-13,0,1,14,0,4,1,1,0.22,0.197,0.41,0.3881,3,39,42,42,1,Sore
293,2011-01-13,0,1,15,0,4,1,1,0.24,0.2121,0.38,0.2985,5,55,60,60,1,Sore
294,2011-01-13,0,1,16,0,4,1,1,0.24,0.2121,0.38,0.3582,2,76,78,78,1,Sore
295,2011-01-13,0,1,17,0,4,1,1,0.2,0.1818,0.4,0.2836,4,158,162,162,1,Sore
296,2011-01-13,0,1,18,0,4,1,1,0.2,0.1818,0.4,0.3284,3,141,144,144,1,Sore
297,2011-01-13,0,1,19,0,4,1,1,0.16,0.1515,0.47,0.2537,1,98,99,99,1,Malam
298,2011-01-13,0,1,20,0,4,1,1,0.16,0.1515,0.47,0.2239,0,64,64,64,1,Malam
299,2011-01-13,0,1,21,0,4,1,1,0.14,0.1212,0.46,0.2985,0,40,40,40,1,Malam
300,2011-01-13,0,1,22,0,4,1,1,0.14,0.1212,0.46,0.3284,0,30,30,30,1,Malam
301,2011-01-13,0,1,23,0,4,1,1,0.12,0.1364,0.5,0.194,1,14,15,15,1,Malam
302,2011-01-14,0,1,0,0,5,1,1,0.12,0.1364,0.5,0.194,0,14,14,14,1,
303,2011-01-14,0,1,1,0,5,1,1,0.1,0.1212,0.54,0.1642,0,5,5,5,1,Pagi
304,2011-01-14,0,1,2,0,5,1,1,0.1,0.1212,0.54,0.1343,0,1,1,1,1,Pagi
305,2011-01-14,0,1,3,0,5,1,1,0.1,0.1364,0.54,0.1045,0,1,1,1,1,Pagi
306,2011-01-14,0,1,5,0,5,1,1,0.1,0.1364,0.54,0.0896,0,8,8,8,1,Pagi
307,2011-01-14,0,1,6,0,5,1,1,0.1,0.1818,0.54,0.0,0,17,17,17,1,Pagi
308,2011-01-14,0,1,7,0,5,1,1,0.1,0.1212,0.74,0.1642,0,70,70,70,1,Siang
309,2011-01-14,0,1,8,0,5,1,1,0.12,0.1667,0.68,0.0,2,156,158,158,1,Siang
310,2011-01-14,0,1,9,0,5,1,1,0.14,0.1515,0.69,0.1343,0,117,117,117,1,Siang
311,2011-01-14,0,1,10,0,5,1,1,0.18,0.1818,0.55,0.194,4,40,44,44,1,Siang
312,2011-01-14,0,1,11,0,5,1,1,0.18,0.1667,0.51,0.2836,6,47,53,53,1,Siang
313,2011-01-14,0,1,12,0,5,1,1,0.2,0.197,0.44,0.2537,2,59,61,61,1,Siang
314,2011-01-14,0,1,13,0,5,1,1,0.22,0.197,0.37,0.3881,4,73,77,77,1,Sore
315,2011-01-14,0,1,14,0,5,1,1,0.22,0.2121,0.41,0.2836,5,59,64,64,1,Sore
316,2011-01-14,0,1,15,0,5,1,1,0.24,0.2424,0.38,0.1642,9,59,68,68,1,Sore
317,2011-01-14,0,1,16,0,5,1,1,0.22,0.2424,0.41,0.1045,3,87,90,90,1,Sore
318,2011-01-14,0,1,17,0,5,1,1,0.22,0.2273,0.41,0.1642,4,155,159,159,1,Sore
319,2011-01-14,0,1,18,0,5,1,1,0.2,0.2576,0.47,0.0,5,134,139,139,1,Sore
320,2011-01-14,0,1,19,0,5,1,1,0.16,0.197,0.59,0.0896,3,89,92,92,1,Malam
321,2011-01-14,0,1,20,0,5,1,1,0.18,0.2424,0.59,0.0,0,68,68,68,1,Malam
322,2011-01-14,0,1,21,0,5,1,1,0.16,0.2273,0.69,0.0,4,48,52,52,1,Malam
323,2011-01-14,0,1,22,0,5,1,2,0.16,0.2273,0.69,0.0,2,34,36,36,1,Malam
324,2011-01-14,0,1,23,0,5,1,2,0.18,0.2424,0.55,0.0,1,26,27,27,1,Malam
325,2011-01-15,0,1,0,0,6,0,1,0.18,0.2424,0.55,0.0,3,25,28,28,1,
326,2011-01-15,0,1,1,0,6,0,2,0.16,0.197,0.59,0.0896,2,18,20,20,1,Pagi
327,2011-01-15,0,1,2,0,6,0,2,0.16,0.197,0.59,0.0896,0,12,12,12,1,Pagi
328,2011-01-15,0,1,3,0,6,0,2,0.16,0.2273,0.59,0.0,1,7,8,8,1,Pagi
329,2011-01-15,0,1,4,0,6,0,2,0.16,0.2273,0.59,0.0,0,5,5,5,1,Pagi
330,2011-01-15,0,1,5,0,6,0,1,0.16,0.2273,0.59,0.0,0,1,1,1,1,Pagi
331,2011-01-15,0,1,6,0,6,0,1,0.14,0.1667,0.63,0.1045,1,2,3,3,1,Pagi
332,2011-01-15,0,1,7,0,6,0,1,0.14,0.2121,0.63,0.0,1,9,10,10,1,Siang
333,2011-01-15,0,1,8,0,6,0,1,0.14,0.1515,0.63,0.1343,1,22,23,23,1,Siang
334,2011-01-15,0,1,9,0,6,0,1,0.16,0.1818,0.64,0.1343,2,31,33,33,1,Siang
335,2011-01-15,0,1,10,0,6,0,1,0.18,0.197,0.59,0.1642,2,57,59,59,1,Siang
336,2011-01-15,0,1,11,0,6,0,1,0.2,0.197,0.55,0.2239,18,54,72,72,1,Siang
337,2011-01-15,0,1,12,0,6,0,1,0.24,0.2273,0.48,0.2239,15,74,89,89,1,Siang
338,2011-01-15,0,1,13,0,6,0,1,0.28,0.2576,0.38,0.2985,21,80,101,101,1,Sore
339,2011-01-15,0,1,14,0,6,0,1,0.3,0.2879,0.39,0.2836,26,92,118,118,1,Sore
340,2011-01-15,0,1,15,0,6,0,2,0.32,0.3182,0.36,0.194,21,108,129,129,1,Sore
341,2011-01-15,0,1,16,0,6,0,2,0.34,0.3333,0.34,0.194,33,95,128,128,1,Sore
342,2011-01-15,0,1,17,0,6,0,2,0.32,0.303,0.36,0.2836,29,54,83,83,1,Sore
343,2011-01-15,0,1,18,0,6,0,2,0.3,0.2879,0.45,0.2537,15,69,84,84,1,Sore
344,2011-01-15,0,1,19,0,6,0,2,0.32,0.303,0.39,0.2537,14,60,74,74,1,Malam
345,2011-01-15,0,1,20,0,6,0,2,0.32,0.303,0.39,0.2537,6,35,41,41,1,Malam
346,2011-01-15,0,1,21,0,6,0,2,0.32,0.303,0.39,0.2239,6,51,57,57,1,Malam
347,2011-01-15,0,1,22,0,6,0,2,0.3,0.3182,0.42,0.1045,0,26,26,26,1,Malam
348,2011-01-15,0,1,23,0,6,0,1,0.3,0.2879,0.45,0.2836,5,39,44,44,1,Malam
349,2011-01-16,0,1,0,0,0,0,1,0.26,0.303,0.56,0.0,6,33,39,39,1,
350,2011-01-16,0,1,1,0,0,0,1,0.26,0.2727,0.56,0.1343,4,19,23,23,1,Pagi
351,2011-01-16,0,1,2,0,0,0,1,0.26,0.2879,0.56,0.0896,3,13,16,16,1,Pagi
352,2011-01-16,0,1,3,0,0,0,1,0.22,0.2727,0.69,0.0,9,6,15,15,1,Pagi
353,2011-01-16,0,1,4,0,0,0,1,0.26,0.2576,0.56,0.1642,0,1,1,1,1,Pagi
354,2011-01-16,0,1,5,0,0,0,2,0.26,0.2576,0.56,0.1642,1,1,2,2,1,Pagi
355,2011-01-16,0,1,6,0,0,0,2,0.26,0.2576,0.56,0.1642,0,1,1,1,1,Pagi
356,2011-01-16,0,1,7,0,0,0,2,0.24,0.2121,0.56,0.2985,0,3,3,3,1,Siang
357,2011-01-16,0,1,8,0,0,0,1,0.22,0.2121,0.55,0.2836,0,18,18,18,1,Siang
358,2011-01-16,0,1,9,0,0,0,1,0.22,0.2121,0.51,0.2537,3,29,32,32,1,Siang
359,2011-01-16,0,1,10,0,0,0,1,0.22,0.2121,0.51,0.2836,8,71,79,79,1,Siang
360,2011-01-16,0,1,11,0,0,0,1,0.24,0.2273,0.44,0.2537,23,70,93,93,1,Siang
361,2011-01-16,0,1,12,0,0,0,1,0.24,0.2121,0.41,0.2836,29,75,104,104,1,Siang
362,2011-01-16,0,1,13,0,0,0,1,0.26,0.2273,0.35,0.2985,23,95,118,118,1,Sore
363,2011-01-16,0,1,14,0,0,0,1,0.28,0.2727,0.36,0.2537,22,69,91,91,1,Sore
364,2011-01-16,0,1,15,0,0,0,1,0.26,0.2424,0.38,0.2537,35,78,113,113,1,Sore
365,2011-01-16,0,1,16,0,0,0,1,0.24,0.2273,0.38,0.2239,22,77,99,99,1,Sore
366,2011-01-16,0,1,17,0,0,0,1,0.22,0.2121,0.37,0.2537,23,82,105,105,1,Sore
367,2011-01-16,0,1,18,0,0,0,1,0.2,0.2121,0.4,0.1642,11,56,67,67,1,Sore
368,2011-01-16,0,1,19,0,0,0,1,0.18,0.197,0.47,0.1343,14,47,61,61,1,Malam
369,2011-01-16,0,1,20,0,0,0,1,0.18,0.197,0.47,0.1642,7,50,57,57,1,Malam
370,2011-01-16,0,1,21,0,0,0,1,0.18,0.197,0.51,0.1642,6,22,28,28,1,Malam
371,2011-01-16,0,1,22,0,0,0,2,0.2,0.2121,0.49,0.1343,2,19,21,21,1,Malam
372,2011-01-16,0,1,23,0,0,0,2,0.2,0.2273,0.4,0.1045,0,18,18,18,1,Malam
373,2011-01-17,0,1,0,1,1,0,2,0.2,0.197,0.47,0.2239,1,16,17,17,1,
374,2011-01-17,0,1,1,1,1,0,2,0.2,0.197,0.44,0.194,1,15,16,16,1,Pagi
375,2011-01-17,0,1,2,1,1,0,2,0.18,0.1667,0.43,0.2537,0,8,8,8,1,Pagi
376,2011-01-17,0,1,3,1,1,0,2,0.18,0.1818,0.43,0.194,0,2,2,2,1,Pagi
377,2011-01-17,0,1,4,1,1,0,2,0.18,0.197,0.43,0.1343,1,2,3,3,1,Pagi
378,2011-01-17,0,1,5,1,1,0,2,0.18,0.197,0.43,0.1642,0,1,1,1,1,Pagi
379,2011-01-17,0,1,6,1,1,0,2,0.18,0.1818,0.43,0.194,0,5,5,5,1,Pagi
380,2011-01-17,0,1,7,1,1,0,2,0.16,0.1818,0.5,0.1343,4,9,13,13,1,Siang
381,2011-01-17,0,1,8,1,1,0,2,0.16,0.1515,0.47,0.2239,3,30,33,33,1,Siang
382,2011-01-17,0,1,9,1,1,0,2,0.16,0.1515,0.47,0.2239,8,39,47,47,1,Siang
383,2011-01-17,0,1,10,1,1,0,2,0.16,0.1515,0.5,0.2537,7,50,57,57,1,Siang
384,2011-01-17,0,1,11,1,1,0,2,0.16,0.1515,0.55,0.194,9,55,64,64,1,Siang
385,2011-01-17,0,1,12,1,1,0,2,0.18,0.197,0.47,0.1343,10,70,80,80,1,Siang
386,2011-01-17,0,1,13,1,1,0,2,0.18,0.197,0.47,0.1343,13,80,93,93,1,Sore
387,2011-01-17,0,1,14,1,1,0,2,0.18,0.2121,0.43,0.1045,12,74,86,86,1,Sore
388,2011-01-17,0,1,15,1,1,0,2,0.2,0.2121,0.47,0.1642,21,72,93,93,1,Sore
389,2011-01-17,0,1,16,1,1,0,2,0.2,0.2121,0.47,0.1642,6,76,82,82,1,Sore
390,2011-01-17,0,1,17,1,1,0,1,0.2,0.197,0.51,0.194,4,67,71,71,1,Sore
391,2011-01-17,0,1,18,1,1,0,2,0.18,0.1667,0.55,0.2537,7,85,92,92,1,Sore
392,2011-01-17,0,1,19,1,1,0,3,0.18,0.1818,0.59,0.194,2,58,60,60,1,Malam
393,2011-01-17,0,1,20,1,1,0,3,0.16,0.1515,0.8,0.194,4,29,33,33,1,Malam
394,2011-01-17,0,1,21,1,1,0,3,0.16,0.1515,0.8,0.194,3,24,27,27,1,Malam
395,2011-01-17,0,1,22,1,1,0,3,0.14,0.1212,0.93,0.2537,0,13,13,13,1,Malam
396,2011-01-17,0,1,23,1,1,0,3,0.16,0.1364,0.86,0.2836,1,3,4,4,1,Malam
397,2011-01-18,0,1,12,0,2,1,2,0.2,0.1818,0.86,0.3284,0,3,3,3,1,Siang
398,2011-01-18,0,1,13,0,2,1,2,0.2,0.197,0.86,0.2239,0,22,22,22,1,Sore
399,2011-01-18,0,1,14,0,2,1,2,0.22,0.2273,0.8,0.1642,2,26,28,28,1,Sore
400,2011-01-18,0,1,15,0,2,1,2,0.22,0.2273,0.87,0.1642,3,32,35,35,1,Sore
401,2011-01-18,0,1,16,0,2,1,2,0.22,0.2273,0.87,0.194,0,61,61,61,1,Sore
402,2011-01-18,0,1,17,0,2,1,2,0.22,0.2273,0.82,0.194,1,124,125,125,1,Sore
403,2011-01-18,0,1,18,0,2,1,2,0.22,0.2273,0.8,0.1642,1,132,133,133,1,Sore
404,2011-01-18,0,1,19,0,2,1,2,0.22,0.2273,0.8,0.1343,1,98,99,99,1,Malam
405,2011-01-18,0,1,20,0,2,1,2,0.22,0.2727,0.87,0.0,0,83,83,83,1,Malam
406,2011-01-18,0,1,21,0,2,1,2,0.22,0.2424,0.93,0.1045,0,41,41,41,1,Malam
407,2011-01-18,0,1,22,0,2,1,2,0.22,0.2576,0.93,0.0896,0,33,33,33,1,Malam
408,2011-01-18,0,1,23,0,2,1,2,0.22,0.2727,0.93,0.0,1,19,20,20,1,Malam
409,2011-01-19,0,1,0,0,3,1,2,0.22,0.2727,0.93,0.0,0,3,3,3,1,
410,2011-01-19,0,1,1,0,3,1,3,0.22,0.2273,0.93,0.1343,1,6,7,7,1,Pagi
411,2011-01-19,0,1,2,0,3,1,3,0.22,0.2273,0.93,0.1343,0,3,3,3,1,Pagi
412,2011-01-19,0,1,4,0,3,1,3,0.22,0.2273,0.93,0.1343,1,1,2,2,1,Pagi
413,2011-01-19,0,1,5,0,3,1,2,0.22,0.2576,0.93,0.0896,0,7,7,7,1,Pagi
414,2011-01-19,0,1,6,0,3,1,2,0.22,0.2576,0.93,0.0896,0,32,32,32,1,Pagi
415,2011-01-19,0,1,7,0,3,1,2,0.24,0.2576,0.92,0.1045,1,89,90,90,1,Siang
416,2011-01-19,0,1,8,0,3,1,2,0.24,0.2576,0.93,0.1045,1,196,197,197,1,Siang
417,2011-01-19,0,1,9,0,3,1,2,0.24,0.2576,0.93,0.1045,2,107,109,109,1,Siang
418,2011-01-19,0,1,10,0,3,1,2,0.26,0.2727,0.93,0.1343,1,46,47,47,1,Siang
419,2011-01-19,0,1,11,0,3,1,2,0.28,0.303,0.87,0.0896,5,47,52,52,1,Siang
420,2011-01-19,0,1,12,0,3,1,2,0.3,0.3182,0.81,0.0896,5,65,70,70,1,Siang
421,2011-01-19,0,1,13,0,3,1,1,0.4,0.4091,0.62,0.2836,11,67,78,78,1,Sore
422,2011-01-19,0,1,14,0,3,1,1,0.4,0.4091,0.58,0.2537,7,68,75,75,1,Sore
423,2011-01-19,0,1,15,0,3,1,1,0.4,0.4091,0.54,0.2836,4,78,82,82,1,Sore
424,2011-01-19,0,1,16,0,3,1,1,0.38,0.3939,0.58,0.3881,10,94,104,104,1,Sore
425,2011-01-19,0,1,17,0,3,1,1,0.36,0.3333,0.57,0.3284,7,190,197,197,1,Sore
426,2011-01-19,0,1,18,0,3,1,1,0.34,0.3182,0.61,0.2836,5,156,161,161,1,Sore
427,2011-01-19,0,1,19,0,3,1,1,0.32,0.2879,0.57,0.4179,4,108,112,112,1,Malam
428,2011-01-19,0,1,20,0,3,1,1,0.32,0.303,0.49,0.2985,2,74,76,76,1,Malam
429,2011-01-19,0,1,21,0,3,1,1,0.32,0.2879,0.49,0.4179,4,55,59,59,1,Malam
430,2011-01-19,0,1,22,0,3,1,1,0.3,0.303,0.52,0.1642,6,53,59,59,1,Malam
431,2011-01-19,0,1,23,0,3,1,1,0.3,0.2727,0.52,0.4627,1,27,28,28,1,Malam
432,2011-01-20,0,1,0,0,4,1,1,0.26,0.2273,0.56,0.3881,5,8,13,13,1,
433,2011-01-20,0,1,1,0,4,1,1,0.26,0.2727,0.56,0.0,2,3,5,5,1,Pagi
434,2011-01-20,0,1,2,0,4,1,1,0.26,0.2727,0.56,0.0,0,2,2,2,1,Pagi
435,2011-01-20,0,1,3,0,4,1,1,0.26,0.2576,0.56,0.1642,0,1,1,1,1,Pagi
436,2011-01-20,0,1,4,0,4,1,1,0.26,0.2576,0.56,0.1642,0,1,1,1,1,Pagi
437,2011-01-20,0,1,5,0,4,1,1,0.24,0.2273,0.6,0.2239,0,6,6,6,1,Pagi
438,2011-01-20,0,1,6,0,4,1,1,0.22,0.2121,0.6,0.2239,0,35,35,35,1,Pagi
439,2011-01-20,0,1,7,0,4,1,1,0.22,0.2121,0.55,0.2239,1,100,101,101,1,Siang
440,2011-01-20,0,1,8,0,4,1,1,0.22,0.2121,0.55,0.2836,2,247,249,249,1,Siang
441,2011-01-20,0,1,9,0,4,1,2,0.24,0.2273,0.52,0.2239,3,140,143,143,1,Siang
442,2011-01-20,0,1,10,0,4,1,1,0.26,0.2273,0.48,0.2985,1,56,57,57,1,Siang
443,2011-01-20,0,1,11,0,4,1,2,0.28,0.2727,0.45,0.1642,5,63,68,68,1,Siang
444,2011-01-20,0,1,12,0,4,1,2,0.3,0.3333,0.42,0.0,7,77,84,84,1,Siang
445,2011-01-20,0,1,13,0,4,1,2,0.28,0.2879,0.45,0.1045,12,86,98,98,1,Sore
446,2011-01-20,0,1,14,0,4,1,2,0.3,0.303,0.45,0.1343,6,75,81,81,1,Sore
447,2011-01-20,0,1,15,0,4,1,2,0.32,0.3182,0.45,0.194,8,62,70,70,1,Sore
448,2011-01-20,0,1,16,0,4,1,2,0.3,0.303,0.49,0.1343,8,83,91,91,1,Sore
449,2011-01-20,0,1,17,0,4,1,2,0.3,0.3182,0.49,0.1045,8,207,215,215,1,Sore
450,2011-01-20,0,1,18,0,4,1,2,0.26,0.2576,0.56,0.194,1,184,185,185,1,Sore
451,2011-01-20,0,1,19,0,4,1,1,0.26,0.2273,0.56,0.3284,6,146,152,152,1,Malam
452,2011-01-20,0,1,20,0,4,1,2,0.26,0.2424,0.6,0.2836,2,124,126,126,1,Malam
453,2011-01-20,0,1,21,0,4,1,2,0.24,0.2273,0.6,0.2537,3,54,57,57,1,Malam
454,2011-01-20,0,1,22,0,4,1,2,0.24,0.2121,0.65,0.2836,0,56,56,56,1,Malam
455,2011-01-20,0,1,23,0,4,1,2,0.24,0.2121,0.65,0.3284,3,28,31,31,1,Malam
456,2011-01-21,0,1,0,0,5,1,2,0.24,0.2273,0.7,0.2537,1,20,21,21,1,
457,2011-01-21,0,1,1,0,5,1,2,0.24,0.2273,0.7,0.2537,0,6,6,6,1,Pagi
458,2011-01-21,0,1,2,0,5,1,3,0.24,0.2424,0.75,0.1642,0,2,2,2,1,Pagi
459,2011-01-21,0,1,3,0,5,1,3,0.22,0.2121,0.8,0.2985,0,1,1,1,1,Pagi
460,2011-01-21,0,1,4,0,5,1,2,0.22,0.2576,0.87,0.0896,0,1,1,1,1,Pagi
461,2011-01-21,0,1,5,0,5,1,1,0.24,0.197,0.6,0.4179,1,4,5,5,1,Pagi
462,2011-01-21,0,1,6,0,5,1,1,0.22,0.2121,0.55,0.2537,0,27,27,27,1,Pagi
463,2011-01-21,0,1,7,0,5,1,1,0.2,0.1818,0.51,0.2836,2,66,68,68,1,Siang
464,2011-01-21,0,1,8,0,5,1,1,0.2,0.1818,0.47,0.3284,7,210,217,217,1,Siang
465,2011-01-21,0,1,9,0,5,1,1,0.2,0.1818,0.51,0.3582,7,159,166,166,1,Siang
466,2011-01-21,0,1,10,0,5,1,1,0.2,0.1667,0.47,0.4627,6,57,63,63,1,Siang
467,2011-01-21,0,1,11,0,5,1,1,0.22,0.1818,0.41,0.4627,6,53,59,59,1,Siang
468,2011-01-21,0,1,12,0,5,1,1,0.22,0.1818,0.27,0.5821,11,67,78,78,1,Siang
469,2011-01-21,0,1,13,0,5,1,1,0.2,0.1515,0.21,0.5821,8,65,73,73,1,Sore
470,2011-01-21,0,1,14,0,5,1,1,0.2,0.1515,0.25,0.5224,6,56,62,62,1,Sore
471,2011-01-21,0,1,15,0,5,1,1,0.16,0.1212,0.26,0.4478,4,61,65,65,1,Sore
472,2011-01-21,0,1,16,0,5,1,1,0.16,0.1364,0.26,0.3582,0,97,97,97,1,Sore
473,2011-01-21,0,1,17,0,5,1,1,0.14,0.1212,0.28,0.3582,10,151,161,161,1,Sore
474,2011-01-21,0,1,18,0,5,1,1,0.12,0.1212,0.3,0.2537,1,119,120,120,1,Sore
475,2011-01-21,0,1,19,0,5,1,1,0.12,0.1061,0.3,0.3284,3,93,96,96,1,Malam
476,2011-01-21,0,1,20,0,5,1,1,0.1,0.0758,0.33,0.4179,1,52,53,53,1,Malam
477,2011-01-21,0,1,21,0,5,1,1,0.08,0.0758,0.38,0.2836,0,41,41,41,1,Malam
478,2011-01-21,0,1,22,0,5,1,1,0.06,0.0303,0.41,0.3881,1,33,34,34,1,Malam
479,2011-01-21,0,1,23,0,5,1,1,0.06,0.0455,0.38,0.3284,0,27,27,27,1,Malam
480,2011-01-22,0,1,0,0,6,0,1,0.04,0.0303,0.45,0.2537,0,13,13,13,1,
481,2011-01-22,0,1,1,0,6,0,2,0.04,0.0,0.41,0.3881,3,9,12,12,1,Pagi
482,2011-01-22,0,1,2,0,6,0,2,0.04,0.0303,0.41,0.2537,0,11,11,11,1,Pagi
483,2011-01-22,0,1,3,0,6,0,2,0.04,0.0303,0.41,0.2836,1,6,7,7,1,Pagi
484,2011-01-22,0,1,4,0,6,0,2,0.02,0.0152,0.48,0.2985,0,3,3,3,1,Pagi
485,2011-01-22,0,1,6,0,6,0,2,0.02,0.0303,0.44,0.2239,0,2,2,2,1,Pagi
486,2011-01-22,0,1,7,0,6,0,1,0.02,0.0152,0.44,0.2836,0,8,8,8,1,Siang
487,2011-01-22,0,1,8,0,6,0,1,0.02,0.0,0.44,0.3284,1,26,27,27,1,Siang
488,2011-01-22,0,1,9,0,6,0,1,0.04,0.0303,0.41,0.2537,3,37,40,40,1,Siang
489,2011-01-22,0,1,10,0,6,0,2,0.04,0.0606,0.41,0.1642,3,50,53,53,1,Siang
490,2011-01-22,0,1,11,0,6,0,2,0.06,0.0758,0.38,0.1343,4,59,63,63,1,Siang
491,2011-01-22,0,1,12,0,6,0,2,0.06,0.1061,0.38,0.1045,10,60,70,70,1,Siang
492,2011-01-22,0,1,13,0,6,0,1,0.08,0.1667,0.35,0.0,12,72,84,84,1,Sore
493,2011-01-22,0,1,14,0,6,0,1,0.1,0.1364,0.33,0.1045,11,64,75,75,1,Sore
494,2011-01-22,0,1,15,0,6,0,1,0.12,0.1515,0.28,0.0,10,93,103,103,1,Sore
495,2011-01-22,0,1,16,0,6,0,1,0.12,0.1364,0.28,0.194,11,72,83,83,1,Sore
496,2011-01-22,0,1,17,0,6,0,1,0.12,0.197,0.28,0.0,8,59,67,67,1,Sore
497,2011-01-22,0,1,18,0,6,0,1,0.08,0.0909,0.35,0.194,0,54,54,54,1,Sore
498,2011-01-22,0,1,19,0,6,0,1,0.08,0.1061,0.35,0.1343,6,53,59,59,1,Malam
499,2011-01-22,0,1,20,0,6,0,1,0.06,0.0758,0.45,0.1642,1,44,45,45,1,Malam
500,2011-01-22,0,1,21,0,6,0,1,0.06,0.1061,0.41,0.0896,0,39,39,39,1,Malam
501,2011-01-22,0,1,22,0,6,0,1,0.06,0.1515,0.49,0.0,7,23,30,30,1,Malam
502,2011-01-22,0,1,23,0,6,0,1,0.04,0.0758,0.57,0.1045,2,31,33,33,1,Malam
503,2011-01-23,0,1,0,0,0,0,1,0.04,0.0758,0.57,0.1045,2,20,22,22,1,
504,2011-01-23,0,1,1,0,0,0,1,0.04,0.0758,0.57,0.1045,1,12,13,13,1,Pagi
505,2011-01-23,0,1,2,0,0,0,1,0.02,0.0606,0.62,0.1343,3,15,18,18,1,Pagi
506,2011-01-23,0,1,3,0,0,0,1,0.02,0.0606,0.62,0.1343,1,4,5,5,1,Pagi
507,2011-01-23,0,1,5,0,0,0,2,0.04,0.0758,0.57,0.1045,0,3,3,3,1,Pagi
508,2011-01-23,0,1,6,0,0,0,2,0.04,0.0758,0.57,0.1045,0,1,1,1,1,Pagi
509,2011-01-23,0,1,7,0,0,0,1,0.08,0.1061,0.58,0.1642,1,1,2,2,1,Siang
510,2011-01-23,0,1,8,0,0,0,1,0.06,0.0758,0.62,0.1642,2,17,19,19,1,Siang
511,2011-01-23,0,1,9,0,0,0,1,0.1,0.0758,0.54,0.3582,3,25,28,28,1,Siang
512,2011-01-23,0,1,10,0,0,0,1,0.14,0.1061,0.46,0.3881,7,51,58,58,1,Siang
513,2011-01-23,0,1,11,0,0,0,1,0.14,0.1364,0.43,0.2239,22,77,99,99,1,Siang
514,2011-01-23,0,1,12,0,0,0,1,0.16,0.1212,0.37,0.4627,24,92,116,116,1,Siang
515,2011-01-23,0,1,13,0,0,0,1,0.14,0.1061,0.33,0.3881,12,75,87,87,1,Sore
516,2011-01-23,0,1,14,0,0,0,1,0.16,0.1364,0.28,0.3582,17,93,110,110,1,Sore
517,2011-01-23,0,1,15,0,0,0,1,0.16,0.1364,0.28,0.3582,13,64,77,77,1,Sore
518,2011-01-23,0,1,16,0,0,0,1,0.16,0.1364,0.26,0.3284,9,56,65,65,1,Sore
519,2011-01-23,0,1,17,0,0,0,1,0.14,0.1061,0.26,0.3881,5,50,55,55,1,Sore
520,2011-01-23,0,1,18,0,0,0,1,0.12,0.1212,0.3,0.2537,5,44,49,49,1,Sore
521,2011-01-23,0,1,19,0,0,0,1,0.12,0.1212,0.3,0.2836,5,45,50,50,1,Malam
522,2011-01-23,0,1,20,0,0,0,1,0.1,0.1061,0.36,0.2537,4,31,35,35,1,Malam
523,2011-01-23,0,1,21,0,0,0,1,0.1,0.1061,0.36,0.194,5,20,25,25,1,Malam
524,2011-01-23,0,1,22,0,0,0,1,0.08,0.0909,0.38,0.194,5,23,28,28,1,Malam
525,2011-01-23,0,1,23,0,0,0,1,0.06,0.0606,0.41,0.2239,4,17,21,21,1,Malam
526,2011-01-24,0,1,0,0,1,1,1,0.06,0.0606,0.41,0.194,0,7,7,7,1,
527,2011-01-24,0,1,1,0,1,1,1,0.04,0.0455,0.45,0.194,0,1,1,1,1,Pagi
528,2011-01-24,0,1,3,0,1,1,1,0.04,0.0303,0.45,0.2537,0,1,1,1,1,Pagi
529,2011-01-24,0,1,4,0,1,1,1,0.02,0.0606,0.48,0.1343,0,1,1,1,1,Pagi
530,2011-01-24,0,1,5,0,1,1,1,0.02,0.0606,0.48,0.1343,0,5,5,5,1,Pagi
531,2011-01-24,0,1,6,0,1,1,1,0.02,0.0758,0.48,0.0896,0,15,15,15,1,Pagi
532,2011-01-24,0,1,7,0,1,1,1,0.02,0.1212,0.48,0.0,5,79,84,84,1,Siang
533,2011-01-24,0,1,8,0,1,1,1,0.04,0.1364,0.49,0.0,6,171,177,177,1,Siang
534,2011-01-24,0,1,9,0,1,1,1,0.06,0.1515,0.41,0.0,4,98,102,102,1,Siang
535,2011-01-24,0,1,10,0,1,1,1,0.1,0.1364,0.42,0.0,6,34,40,40,1,Siang
536,2011-01-24,0,1,11,0,1,1,1,0.1,0.1212,0.46,0.1343,3,43,46,46,1,Siang
537,2011-01-24,0,1,12,0,1,1,2,0.12,0.1364,0.42,0.194,11,52,63,63,1,Siang
538,2011-01-24,0,1,13,0,1,1,2,0.14,0.1364,0.43,0.2239,6,54,60,60,1,Sore
539,2011-01-24,0,1,14,0,1,1,2,0.14,0.1364,0.46,0.2239,2,43,45,45,1,Sore
540,2011-01-24,0,1,15,0,1,1,1,0.16,0.1667,0.4,0.1642,7,50,57,57,1,Sore
541,2011-01-24,0,1,16,0,1,1,1,0.16,0.1515,0.47,0.2537,4,66,70,70,1,Sore
542,2011-01-24,0,1,17,0,1,1,1,0.14,0.1212,0.5,0.2537,6,178,184,184,1,Sore
543,2011-01-24,0,1,18,0,1,1,1,0.14,0.1364,0.59,0.194,8,145,153,153,1,Sore
544,2011-01-24,0,1,19,0,1,1,1,0.14,0.1515,0.54,0.1642,5,101,106,106,1,Malam
545,2011-01-24,0,1,20,0,1,1,1,0.14,0.1364,0.59,0.194,1,80,81,81,1,Malam
546,2011-01-24,0,1,21,0,1,1,1,0.14,0.1515,0.63,0.1642,6,53,59,59,1,Malam
547,2011-01-24,0,1,22,0,1,1,2,0.14,0.1364,0.63,0.2239,3,32,35,35,1,Malam
548,2011-01-24,0,1,23,0,1,1,2,0.16,0.1515,0.64,0.2537,3,21,24,24,1,Malam
549,2011-01-25,0,1,0,0,2,1,2,0.16,0.1364,0.69,0.2836,3,6,9,9,1,
550,2011-01-25,0,1,1,0,2,1,2,0.16,0.1667,0.69,0.1642,0,5,5,5,1,Pagi
551,2011-01-25,0,1,2,0,2,1,1,0.16,0.1515,0.69,0.2239,0,2,2,2,1,Pagi
552,2011-01-25,0,1,4,0,2,1,1,0.14,0.1667,0.74,0.1045,0,1,1,1,1,Pagi
553,2011-01-25,0,1,5,0,2,1,1,0.14,0.1364,0.74,0.2239,0,9,9,9,1,Pagi
554,2011-01-25,0,1,6,0,2,1,1,0.16,0.1818,0.74,0.1045,1,35,36,36,1,Pagi
555,2011-01-25,0,1,7,0,2,1,1,0.16,0.1515,0.74,0.2239,5,103,108,108,1,Siang
556,2011-01-25,0,1,8,0,2,1,2,0.16,0.1818,0.74,0.1343,5,233,238,238,1,Siang
557,2011-01-25,0,1,9,0,2,1,2,0.2,0.2273,0.64,0.0896,10,134,144,144,1,Siang
558,2011-01-25,0,1,10,0,2,1,2,0.22,0.2424,0.6,0.1045,6,49,55,55,1,Siang
559,2011-01-25,0,1,11,0,2,1,2,0.24,0.2424,0.6,0.1343,6,55,61,61,1,Siang
560,2011-01-25,0,1,12,0,2,1,2,0.26,0.2879,0.56,0.0896,21,85,106,106,1,Siang
561,2011-01-25,0,1,13,0,2,1,2,0.26,0.2727,0.56,0.1343,21,72,93,93,1,Sore
562,2011-01-25,0,1,14,0,2,1,2,0.3,0.3333,0.45,0.0,11,57,68,68,1,Sore
563,2011-01-25,0,1,15,0,2,1,2,0.32,0.3485,0.42,0.0,21,63,84,84,1,Sore
564,2011-01-25,0,1,16,0,2,1,2,0.32,0.3485,0.42,0.0,14,102,116,116,1,Sore
565,2011-01-25,0,1,17,0,2,1,1,0.3,0.3333,0.45,0.0,14,208,222,222,1,Sore
566,2011-01-25,0,1,18,0,2,1,2,0.3,0.3182,0.49,0.0896,7,218,225,225,1,Sore
567,2011-01-25,0,1,19,0,2,1,2,0.26,0.2576,0.65,0.1642,13,133,146,146,1,Malam
568,2011-01-25,0,1,20,0,2,1,1,0.24,0.2273,0.65,0.194,16,103,119,119,1,Malam
569,2011-01-25,0,1,21,0,2,1,1,0.24,0.2273,0.65,0.194,5,40,45,45,1,Malam
570,2011-01-25,0,1,22,0,2,1,1,0.22,0.2273,0.64,0.1642,4,49,53,53,1,Malam
571,2011-01-25,0,1,23,0,2,1,2,0.22,0.2273,0.64,0.1642,3,37,40,40,1,Malam
572,2011-01-26,0,1,0,0,3,1,2,0.22,0.2273,0.69,0.1343,3,14,17,17,1,
573,2011-01-26,0,1,1,0,3,1,2,0.24,0.2424,0.65,0.1343,0,5,5,5,1,Pagi
574,2011-01-26,0,1,2,0,3,1,3,0.22,0.2273,0.69,0.194,3,7,10,10,1,Pagi
575,2011-01-26,0,1,5,0,3,1,3,0.2,0.1818,0.86,0.2836,0,1,1,1,1,Pagi
576,2011-01-26,0,1,6,0,3,1,3,0.2,0.1818,0.86,0.2836,0,8,8,8,1,Pagi
577,2011-01-26,0,1,7,0,3,1,3,0.22,0.2121,0.87,0.2985,1,29,30,30,1,Siang
578,2011-01-26,0,1,8,0,3,1,3,0.22,0.2121,0.87,0.2985,3,69,72,72,1,Siang
579,2011-01-26,0,1,9,0,3,1,3,0.22,0.2121,0.87,0.2985,3,55,58,58,1,Siang
580,2011-01-26,0,1,10,0,3,1,3,0.22,0.2121,0.93,0.2836,2,26,28,28,1,Siang
581,2011-01-26,0,1,11,0,3,1,3,0.22,0.197,0.93,0.3284,6,35,41,41,1,Siang
582,2011-01-26,0,1,12,0,3,1,3,0.22,0.197,0.93,0.3284,7,41,48,48,1,Siang
583,2011-01-26,0,1,13,0,3,1,3,0.22,0.197,0.93,0.3284,4,43,47,47,1,Sore
584,2011-01-26,0,1,14,0,3,1,3,0.22,0.197,0.93,0.3582,0,36,36,36,1,Sore
585,2011-01-26,0,1,15,0,3,1,3,0.22,0.1818,0.93,0.4627,1,42,43,43,1,Sore
586,2011-01-26,0,1,16,0,3,1,4,0.22,0.197,0.93,0.3284,1,35,36,36,1,Sore
587,2011-01-26,0,1,17,0,3,1,3,0.2,0.1818,0.93,0.3582,0,26,26,26,1,Sore
588,2011-01-27,0,1,16,0,4,1,1,0.22,0.2273,0.55,0.194,1,23,24,24,1,Sore
589,2011-01-27,0,1,17,0,4,1,1,0.22,0.2424,0.55,0.1045,2,82,84,84,1,Sore
590,2011-01-27,0,1,18,0,4,1,1,0.2,0.2273,0.69,0.0896,3,101,104,104,1,Sore
591,2011-01-27,0,1,19,0,4,1,1,0.2,0.2273,0.69,0.0896,3,76,79,79,1,Malam
592,2011-01-27,0,1,20,0,4,1,1,0.18,0.2121,0.74,0.0896,4,55,59,59,1,Malam
593,2011-01-27,0,1,21,0,4,1,1,0.18,0.2121,0.74,0.0896,2,36,38,38,1,Malam
594,2011-01-27,0,1,22,0,4,1,1,0.18,0.2121,0.74,0.0896,0,27,27,27,1,Malam
595,2011-01-27,0,1,23,0,4,1,1,0.18,0.197,0.8,0.1642,0,16,16,16,1,Malam
596,2011-01-28,0,1,0,0,5,1,2,0.2,0.2121,0.75,0.1343,0,9,9,9,1,
597,2011-01-28,0,1,1,0,5,1,2,0.2,0.2121,0.75,0.1343,1,2,3,3,1,Pagi
598,2011-01-28,0,1,2,0,5,1,2,0.2,0.2121,0.75,0.1642,0,2,2,2,1,Pagi
599,2011-01-28,0,1,3,0,5,1,2,0.2,0.2273,0.75,0.1045,1,0,1,1,1,Pagi
600,2011-01-28,0,1,5,0,5,1,2,0.18,0.2121,0.8,0.1045,0,4,4,4,1,Pagi
601,2011-01-28,0,1,6,0,5,1,2,0.18,0.197,0.8,0.1343,0,16,16,16,1,Pagi
602,2011-01-28,0,1,7,0,5,1,2,0.16,0.197,0.86,0.0896,2,58,60,60,1,Siang
603,2011-01-28,0,1,8,0,5,1,2,0.16,0.197,0.86,0.0896,2,155,157,157,1,Siang
604,2011-01-28,0,1,9,0,5,1,3,0.18,0.2121,0.86,0.0896,6,95,101,101,1,Siang
605,2011-01-28,0,1,10,0,5,1,3,0.18,0.2121,0.86,0.1045,0,49,49,49,1,Siang
606,2011-01-28,0,1,11,0,5,1,3,0.18,0.2121,0.93,0.1045,0,30,30,30,1,Siang
607,2011-01-28,0,1,12,0,5,1,3,0.18,0.2121,0.93,0.1045,1,28,29,29,1,Siang
608,2011-01-28,0,1,13,0,5,1,3,0.18,0.2121,0.93,0.1045,0,31,31,31,1,Sore
609,2011-01-28,0,1,14,0,5,1,3,0.22,0.2727,0.8,0.0,2,36,38,38,1,Sore
610,2011-01-28,0,1,15,0,5,1,2,0.2,0.2576,0.86,0.0,1,40,41,41,1,Sore
611,2011-01-28,0,1,16,0,5,1,1,0.22,0.2727,0.8,0.0,10,70,80,80,1,Sore
612,2011-01-28,0,1,17,0,5,1,1,0.24,0.2424,0.75,0.1343,2,147,149,149,1,Sore
613,2011-01-28,0,1,18,0,5,1,1,0.24,0.2273,0.75,0.194,2,107,109,109,1,Sore
614,2011-01-28,0,1,19,0,5,1,2,0.24,0.2424,0.75,0.1343,5,84,89,89,1,Malam
615,2011-01-28,0,1,20,0,5,1,2,0.24,0.2273,0.7,0.194,1,61,62,62,1,Malam
616,2011-01-28,0,1,21,0,5,1,2,0.22,0.2273,0.75,0.1343,1,57,58,58,1,Malam
617,2011-01-28,0,1,22,0,5,1,1,0.24,0.2121,0.65,0.3582,0,26,26,26,1,Malam
618,2011-01-28,0,1,23,0,5,1,1,0.24,0.2273,0.6,0.2239,1,22,23,23,1,Malam
619,2011-01-29,0,1,0,0,6,0,1,0.22,0.197,0.64,0.3582,2,26,28,28,1,
620,2011-01-29,0,1,1,0,6,0,1,0.22,0.2273,0.64,0.194,0,20,20,20,1,Pagi
621,2011-01-29,0,1,2,0,6,0,1,0.22,0.2273,0.64,0.1642,0,15,15,15,1,Pagi
622,2011-01-29,0,1,3,0,6,0,1,0.2,0.2121,0.64,0.1343,3,5,8,8,1,Pagi
623,2011-01-29,0,1,4,0,6,0,1,0.16,0.1818,0.69,0.1045,1,2,3,3,1,Pagi
624,2011-01-29,0,1,6,0,6,0,1,0.16,0.1818,0.64,0.1343,0,2,2,2,1,Pagi
625,2011-01-29,0,1,7,0,6,0,1,0.16,0.1818,0.59,0.1045,1,4,5,5,1,Siang
626,2011-01-29,0,1,8,0,6,0,1,0.18,0.197,0.55,0.1642,3,31,34,34,1,Siang
627,2011-01-29,0,1,9,0,6,0,1,0.18,0.2121,0.59,0.0896,0,34,34,34,1,Siang
628,2011-01-29,0,1,10,0,6,0,2,0.18,0.2121,0.64,0.1045,4,51,55,55,1,Siang
629,2011-01-29,0,1,11,0,6,0,2,0.18,0.197,0.64,0.1343,4,60,64,64,1,Siang
630,2011-01-29,0,1,12,0,6,0,2,0.2,0.197,0.59,0.194,12,66,78,78,1,Siang
631,2011-01-29,0,1,13,0,6,0,2,0.22,0.2273,0.55,0.1642,9,56,65,65,1,Sore
632,2011-01-29,0,1,14,0,6,0,2,0.22,0.2273,0.6,0.1343,10,89,99,99,1,Sore
633,2011-01-29,0,1,15,0,6,0,1,0.22,0.2121,0.69,0.2537,22,98,120,120,1,Sore
634,2011-01-29,0,1,16,0,6,0,1,0.24,0.2424,0.6,0.1642,19,88,107,107,1,Sore
635,2011-01-29,0,1,17,0,6,0,1,0.24,0.2879,0.6,0.0,9,82,91,91,1,Sore
636,2011-01-29,0,1,18,0,6,0,1,0.22,0.2273,0.69,0.1343,9,59,68,68,1,Sore
637,2011-01-29,0,1,19,0,6,0,2,0.22,0.2121,0.69,0.2537,6,52,58,58,1,Malam
638,2011-01-29,0,1,20,0,6,0,1,0.18,0.2121,0.74,0.0896,1,42,43,43,1,Malam
639,2011-01-29,0,1,21,0,6,0,1,0.18,0.2121,0.74,0.0896,1,35,36,36,1,Malam
640,2011-01-29,0,1,22,0,6,0,1,0.16,0.197,0.8,0.0896,4,28,32,32,1,Malam
641,2011-01-29,0,1,23,0,6,0,1,0.16,0.197,0.8,0.0896,3,30,33,33,1,Malam
642,2011-01-30,0,1,0,0,0,0,1,0.16,0.1818,0.8,0.1045,0,33,33,33,1,
643,2011-01-30,0,1,1,0,0,0,1,0.14,0.2121,0.8,0.0,7,22,29,29,1,Pagi
644,2011-01-30,0,1,2,0,0,0,1,0.16,0.2273,0.8,0.0,1,10,11,11,1,Pagi
645,2011-01-30,0,1,3,0,0,0,1,0.14,0.2121,0.93,0.0,1,7,8,8,1,Pagi
646,2011-01-30,0,1,4,0,0,0,1,0.14,0.2121,0.93,0.0,0,1,1,1,1,Pagi
647,2011-01-30,0,1,5,0,0,0,1,0.14,0.2121,0.86,0.0,0,3,3,3,1,Pagi
648,2011-01-30,0,1,7,0,0,0,1,0.14,0.2121,0.86,0.0,0,3,3,3,1,Siang
649,2011-01-30,0,1,8,0,0,0,2,0.14,0.2121,0.86,0.0,1,11,12,12,1,Siang
650,2011-01-30,0,1,9,0,0,0,2,0.16,0.2273,0.8,0.0,4,34,38,38,1,Siang
651,2011-01-30,0,1,10,0,0,0,2,0.18,0.2424,0.8,0.0,7,57,64,64,1,Siang
652,2011-01-30,0,1,11,0,0,0,1,0.22,0.2727,0.75,0.0,9,50,59,59,1,Siang
653,2011-01-30,0,1,12,0,0,0,1,0.3,0.3182,0.52,0.1045,10,87,97,97,1,Siang
654,2011-01-30,0,1,13,0,0,0,1,0.28,0.2879,0.61,0.1045,13,71,84,84,1,Sore
655,2011-01-30,0,1,14,0,0,0,1,0.28,0.303,0.61,0.0896,18,104,122,122,1,Sore
656,2011-01-30,0,1,15,0,0,0,1,0.3,0.3333,0.56,0.0,14,95,109,109,1,Sore
657,2011-01-30,0,1,16,0,0,0,1,0.3,0.3333,0.56,0.0,19,104,123,123,1,Sore
658,2011-01-30,0,1,17,0,0,0,1,0.3,0.2879,0.56,0.194,6,71,77,77,1,Sore
659,2011-01-30,0,1,18,0,0,0,1,0.26,0.2576,0.65,0.1642,8,57,65,65,1,Sore
660,2011-01-30,0,1,19,0,0,0,1,0.26,0.2576,0.65,0.194,9,46,55,55,1,Malam
661,2011-01-30,0,1,20,0,0,0,2,0.26,0.2727,0.65,0.1045,3,30,33,33,1,Malam
662,2011-01-30,0,1,21,0,0,0,2,0.24,0.2424,0.7,0.1642,3,25,28,28,1,Malam
663,2011-01-30,0,1,22,0,0,0,2,0.24,0.2273,0.7,0.194,2,19,21,21,1,Malam
664,2011-01-30,0,1,23,0,0,0,2,0.24,0.2121,0.65,0.2836,5,16,21,21,1,Malam
665,2011-01-31,0,1,0,0,1,1,2,0.24,0.2273,0.65,0.2239,1,6,7,7,1,
666,2011-01-31,0,1,1,0,1,1,1,0.22,0.2121,0.64,0.2537,2,5,7,7,1,Pagi
667,2011-01-31,0,1,2,0,1,1,1,0.22,0.2273,0.64,0.194,0,1,1,1,1,Pagi
668,2011-01-31,0,1,3,0,1,1,1,0.22,0.2273,0.64,0.194,0,2,2,2,1,Pagi
669,2011-01-31,0,1,4,0,1,1,1,0.2,0.197,0.59,0.2239,0,2,2,2,1,Pagi
670,2011-01-31,0,1,5,0,1,1,1,0.18,0.1667,0.64,0.2836,0,8,8,8,1,Pagi
671,2011-01-31,0,1,6,0,1,1,1,0.16,0.1364,0.69,0.3284,0,37,37,37,1,Pagi
672,2011-01-31,0,1,7,0,1,1,2,0.16,0.1364,0.64,0.2836,1,71,72,72,1,Siang
673,2011-01-31,0,1,8,0,1,1,2,0.16,0.1364,0.59,0.2836,3,182,185,185,1,Siang
674,2011-01-31,0,1,9,0,1,1,2,0.16,0.1364,0.59,0.2985,0,112,112,112,1,Siang
675,2011-01-31,0,1,10,0,1,1,2,0.16,0.1515,0.59,0.194,1,68,69,69,1,Siang
676,2011-01-31,0,1,11,0,1,1,2,0.16,0.1515,0.59,0.194,2,46,48,48,1,Siang
677,2011-01-31,0,1,12,0,1,1,2,0.18,0.2121,0.55,0.1045,6,62,68,68,1,Siang
678,2011-01-31,0,1,13,0,1,1,2,0.16,0.2273,0.59,0.0,2,52,54,54,1,Sore
679,2011-01-31,0,1,14,0,1,1,2,0.18,0.197,0.55,0.1343,1,85,86,86,1,Sore
680,2011-01-31,0,1,15,0,1,1,2,0.16,0.1818,0.59,0.1343,3,41,44,44,1,Sore
681,2011-01-31,0,1,16,0,1,1,2,0.16,0.1818,0.56,0.194,3,83,86,86,1,Sore
682,2011-01-31,0,1,17,0,1,1,2,0.16,0.1515,0.59,0.194,6,155,161,161,1,Sore
683,2011-01-31,0,1,18,0,1,1,2,0.16,0.1515,0.55,0.2239,3,153,156,156,1,Sore
684,2011-01-31,0,1,19,0,1,1,1,0.3,0.3182,0.61,0.1045,3,108,111,111,1,Malam
685,2011-01-31,0,1,20,0,1,1,3,0.16,0.1667,0.59,0.1642,0,78,78,78,1,Malam
686,2011-01-31,0,1,21,0,1,1,3,0.16,0.197,0.59,0.0896,3,53,56,56,1,Malam
687,2011-01-31,0,1,22,0,1,1,2,0.16,0.1818,0.59,0.1045,0,34,34,34,1,Malam
688,2011-01-31,0,1,23,0,1,1,2,0.16,0.197,0.64,0.0896,2,15,17,17,1,Malam
689,2011-02-01,0,2,0,0,2,1,2,0.16,0.1818,0.64,0.1045,2,6,8,8,1,
690,2011-02-01,0,2,1,0,2,1,2,0.16,0.1818,0.69,0.1045,0,3,3,3,1,Pagi
691,2011-02-01,0,2,2,0,2,1,2,0.16,0.2273,0.69,0.0,0,2,2,2,1,Pagi
692,2011-02-01,0,2,3,0,2,1,2,0.16,0.2273,0.69,0.0,0,2,2,2,1,Pagi
693,2011-02-01,0,2,5,0,2,1,3,0.14,0.2121,0.93,0.0,0,3,3,3,1,Pagi
694,2011-02-01,0,2,6,0,2,1,3,0.14,0.2121,0.93,0.0,0,22,22,22,1,Pagi
695,2011-02-01,0,2,7,0,2,1,3,0.16,0.2273,0.93,0.0,0,52,52,52,1,Siang
696,2011-02-01,0,2,8,0,2,1,3,0.16,0.2273,0.93,0.0,3,132,135,135,1,Siang
697,2011-02-01,0,2,9,0,2,1,2,0.16,0.2273,0.93,0.0,2,114,116,116,1,Siang
698,2011-02-01,0,2,10,0,2,1,2,0.16,0.2273,0.93,0.0,0,47,47,47,1,Siang
699,2011-02-01,0,2,11,0,2,1,2,0.18,0.2424,0.86,0.0,2,49,51,51,1,Siang
700,2011-02-01,0,2,12,0,2,1,2,0.2,0.2576,0.86,0.0,2,53,55,55,1,Siang
701,2011-02-01,0,2,13,0,2,1,2,0.2,0.2576,0.86,0.0,3,49,52,52,1,Sore
702,2011-02-01,0,2,14,0,2,1,2,0.22,0.2576,0.8,0.0896,5,49,54,54,1,Sore
703,2011-02-01,0,2,15,0,2,1,2,0.24,0.2879,0.75,0.0,7,45,52,52,1,Sore
704,2011-02-01,0,2,16,0,2,1,2,0.24,0.2424,0.75,0.1343,3,61,64,64,1,Sore
705,2011-02-01,0,2,17,0,2,1,2,0.24,0.2879,0.75,0.0,4,172,176,176,1,Sore
706,2011-02-01,0,2,18,0,2,1,2,0.24,0.2576,0.81,0.1045,3,165,168,168,1,Sore
707,2011-02-01,0,2,19,0,2,1,2,0.24,0.2424,0.81,0.1343,3,105,108,108,1,Malam
708,2011-02-01,0,2,20,0,2,1,2,0.22,0.2273,0.87,0.1343,5,69,74,74,1,Malam
709,2011-02-01,0,2,21,0,2,1,2,0.22,0.2273,0.87,0.1343,0,64,64,64,1,Malam
710,2011-02-01,0,2,22,0,2,1,2,0.22,0.2576,0.87,0.0896,2,34,36,36,1,Malam
711,2011-02-01,0,2,23,0,2,1,3,0.2,0.197,0.93,0.194,1,15,16,16,1,Malam
712,2011-02-02,0,2,0,0,3,1,3,0.22,0.2424,0.93,0.1045,0,2,2,2,1,
713,2011-02-02,0,2,1,0,3,1,3,0.22,0.2273,0.93,0.194,0,3,3,3,1,Pagi
714,2011-02-02,0,2,2,0,3,1,3,0.22,0.2273,0.93,0.1343,4,0,4,4,1,Pagi
715,2011-02-02,0,2,3,0,3,1,3,0.22,0.2273,0.93,0.1343,0,1,1,1,1,Pagi
716,2011-02-02,0,2,4,0,3,1,3,0.22,0.2121,0.93,0.2836,0,1,1,1,1,Pagi
717,2011-02-02,0,2,5,0,3,1,3,0.22,0.2424,0.93,0.1045,0,3,3,3,1,Pagi
718,2011-02-02,0,2,6,0,3,1,3,0.22,0.2424,0.93,0.1045,1,17,18,18,1,Pagi
719,2011-02-02,0,2,7,0,3,1,3,0.22,0.2121,0.93,0.2239,1,48,49,49,1,Siang
720,2011-02-02,0,2,8,0,3,1,3,0.22,0.2121,0.93,0.2239,1,154,155,155,1,Siang
721,2011-02-02,0,2,9,0,3,1,2,0.24,0.2576,0.93,0.0896,4,119,123,123,1,Siang
722,2011-02-02,0,2,10,0,3,1,2,0.22,0.2727,1.0,0.0,2,59,61,61,1,Siang
723,2011-02-02,0,2,11,0,3,1,2,0.24,0.2273,0.93,0.194,5,47,52,52,1,Siang
724,2011-02-02,0,2,12,0,3,1,2,0.24,0.2273,0.93,0.2239,3,61,64,64,1,Siang
725,2011-02-02,0,2,13,0,3,1,1,0.34,0.3333,0.93,0.1642,1,74,75,75,1,Sore
726,2011-02-02,0,2,14,0,3,1,1,0.38,0.3939,0.82,0.3881,2,61,63,63,1,Sore
727,2011-02-02,0,2,15,0,3,1,1,0.38,0.3939,0.76,0.3284,10,66,76,76,1,Sore
728,2011-02-02,0,2,16,0,3,1,1,0.36,0.3333,0.71,0.2985,8,95,103,103,1,Sore
729,2011-02-02,0,2,17,0,3,1,1,0.36,0.3182,0.53,0.5224,7,183,190,190,1,Sore
730,2011-02-02,0,2,18,0,3,1,1,0.34,0.2879,0.42,0.5522,7,175,182,182,1,Sore
731,2011-02-02,0,2,19,0,3,1,1,0.28,0.2424,0.45,0.4925,3,88,91,91,1,Malam
732,2011-02-02,0,2,20,0,3,1,1,0.24,0.197,0.48,0.5522,4,71,75,75,1,Malam
733,2011-02-02,0,2,21,0,3,1,1,0.22,0.197,0.47,0.3284,1,62,63,63,1,Malam
734,2011-02-02,0,2,22,0,3,1,1,0.22,0.2121,0.44,0.2537,5,35,40,40,1,Malam
735,2011-02-02,0,2,23,0,3,1,1,0.2,0.1667,0.44,0.4478,3,29,32,32,1,Malam
736,2011-02-03,0,2,0,0,4,1,1,0.2,0.1667,0.4,0.4478,1,11,12,12,1,
737,2011-02-03,0,2,1,0,4,1,1,0.2,0.1515,0.44,0.5224,0,5,5,5,1,Pagi
738,2011-02-03,0,2,2,0,4,1,1,0.18,0.1667,0.43,0.2537,0,2,2,2,1,Pagi
739,2011-02-03,0,2,3,0,4,1,1,0.18,0.1667,0.43,0.2537,0,1,1,1,1,Pagi
740,2011-02-03,0,2,5,0,4,1,1,0.16,0.1364,0.5,0.2985,0,2,2,2,1,Pagi
741,2011-02-03,0,2,6,0,4,1,1,0.16,0.1364,0.43,0.3582,0,39,39,39,1,Pagi
742,2011-02-03,0,2,7,0,4,1,1,0.14,0.1212,0.5,0.3284,1,86,87,87,1,Siang
743,2011-02-03,0,2,8,0,4,1,1,0.14,0.1212,0.5,0.3582,4,184,188,188,1,Siang
744,2011-02-03,0,2,9,0,4,1,1,0.16,0.1364,0.47,0.2985,6,127,133,133,1,Siang
745,2011-02-03,0,2,10,0,4,1,1,0.18,0.1515,0.43,0.3284,2,50,52,52,1,Siang
746,2011-02-03,0,2,11,0,4,1,1,0.18,0.1364,0.43,0.4478,9,55,64,64,1,Siang
747,2011-02-03,0,2,12,0,4,1,1,0.2,0.1818,0.4,0.3582,2,67,69,69,1,Siang
748,2011-02-03,0,2,13,0,4,1,1,0.2,0.1667,0.4,0.4179,4,47,51,51,1,Sore
749,2011-02-03,0,2,14,0,4,1,1,0.22,0.197,0.37,0.3881,4,43,47,47,1,Sore
750,2011-02-03,0,2,15,0,4,1,1,0.22,0.197,0.37,0.3284,4,56,60,60,1,Sore
751,2011-02-03,0,2,16,0,4,1,1,0.22,0.2121,0.37,0.2537,5,73,78,78,1,Sore
752,2011-02-03,0,2,17,0,4,1,1,0.2,0.197,0.4,0.194,5,170,175,175,1,Sore
753,2011-02-03,0,2,18,0,4,1,1,0.2,0.2121,0.4,0.1642,2,145,147,147,1,Sore
754,2011-02-03,0,2,19,0,4,1,1,0.2,0.2576,0.4,0.0,4,92,96,96,1,Malam
755,2011-02-03,0,2,20,0,4,1,1,0.2,0.2273,0.47,0.0896,1,108,109,109,1,Malam
756,2011-02-03,0,2,21,0,4,1,1,0.18,0.2121,0.55,0.1045,1,53,54,54,1,Malam
757,2011-02-03,0,2,22,0,4,1,1,0.18,0.2121,0.51,0.0896,2,39,41,41,1,Malam
758,2011-02-03,0,2,23,0,4,1,1,0.2,0.2273,0.47,0.1045,4,34,38,38,1,Malam
759,2011-02-04,0,2,0,0,5,1,2,0.2,0.2576,0.44,0.0,3,10,13,13,1,
760,2011-02-04,0,2,1,0,5,1,2,0.16,0.2273,0.59,0.0,0,7,7,7,1,Pagi
761,2011-02-04,0,2,2,0,5,1,2,0.14,0.1667,0.63,0.1045,0,1,1,1,1,Pagi
762,2011-02-04,0,2,3,0,5,1,2,0.14,0.1667,0.63,0.1045,0,1,1,1,1,Pagi
763,2011-02-04,0,2,5,0,5,1,2,0.14,0.1515,0.63,0.1343,0,7,7,7,1,Pagi
764,2011-02-04,0,2,6,0,5,1,2,0.16,0.2273,0.55,0.0,2,26,28,28,1,Pagi
765,2011-02-04,0,2,7,0,5,1,1,0.14,0.2121,0.59,0.0,0,87,87,87,1,Siang
766,2011-02-04,0,2,8,0,5,1,1,0.14,0.1515,0.74,0.1343,3,217,220,220,1,Siang
767,2011-02-04,0,2,9,0,5,1,2,0.16,0.1818,0.8,0.1343,3,124,127,127,1,Siang
768,2011-02-04,0,2,10,0,5,1,2,0.2,0.2121,0.51,0.1343,5,46,51,51,1,Siang
769,2011-02-04,0,2,11,0,5,1,1,0.22,0.2273,0.51,0.1642,3,61,64,64,1,Siang
770,2011-02-04,0,2,12,0,5,1,2,0.24,0.2424,0.48,0.1642,8,78,86,86,1,Siang
771,2011-02-04,0,2,13,0,5,1,2,0.26,0.2576,0.5,0.2239,9,73,82,82,1,Sore
772,2011-02-04,0,2,14,0,5,1,2,0.28,0.2727,0.45,0.1642,15,76,91,91,1,Sore
773,2011-02-04,0,2,15,0,5,1,2,0.28,0.2727,0.48,0.2537,9,81,90,90,1,Sore
774,2011-02-04,0,2,16,0,5,1,2,0.3,0.2879,0.42,0.2239,8,91,99,99,1,Sore
775,2011-02-04,0,2,17,0,5,1,2,0.26,0.2727,0.56,0.1343,10,195,205,205,1,Sore
776,2011-02-04,0,2,18,0,5,1,2,0.24,0.2576,0.6,0.1045,3,152,155,155,1,Sore
777,2011-02-04,0,2,19,0,5,1,2,0.24,0.2424,0.65,0.1343,1,102,103,103,1,Malam
778,2011-02-04,0,2,20,0,5,1,2,0.24,0.2424,0.65,0.1642,2,69,71,71,1,Malam
779,2011-02-04,0,2,21,0,5,1,2,0.24,0.2424,0.7,0.1642,2,41,43,43,1,Malam
780,2011-02-04,0,2,22,0,5,1,2,0.24,0.2424,0.65,0.1642,1,45,46,46,1,Malam
781,2011-02-04,0,2,23,0,5,1,2,0.24,0.2424,0.7,0.1343,1,30,31,31,1,Malam
782,2011-02-05,0,2,0,0,6,0,2,0.24,0.2424,0.7,0.1642,3,36,39,39,1,
783,2011-02-05,0,2,1,0,6,0,2,0.24,0.2424,0.65,0.1642,1,17,18,18,1,Pagi
784,2011-02-05,0,2,2,0,6,0,2,0.24,0.2424,0.75,0.1642,5,12,17,17,1,Pagi
785,2011-02-05,0,2,3,0,6,0,2,0.24,0.2424,0.75,0.1642,1,10,11,11,1,Pagi
786,2011-02-05,0,2,4,0,6,0,3,0.22,0.2273,0.93,0.1343,0,8,8,8,1,Pagi
787,2011-02-05,0,2,5,0,6,0,3,0.2,0.2273,1.0,0.0896,0,9,9,9,1,Pagi
788,2011-02-05,0,2,6,0,6,0,3,0.2,0.2576,1.0,0.0,0,4,4,4,1,Pagi
789,2011-02-05,0,2,7,0,6,0,3,0.22,0.2576,0.93,0.0896,0,4,4,4,1,Siang
790,2011-02-05,0,2,8,0,6,0,3,0.2,0.2273,1.0,0.0896,0,10,10,10,1,Siang
791,2011-02-05,0,2,9,0,6,0,3,0.2,0.2273,1.0,0.0896,3,17,20,20,1,Siang
792,2011-02-05,0,2,10,0,6,0,3,0.2,0.2121,1.0,0.1343,3,31,34,34,1,Siang
793,2011-02-05,0,2,11,0,6,0,3,0.22,0.2273,1.0,0.1343,1,46,47,47,1,Siang
794,2011-02-05,0,2,12,0,6,0,3,0.22,0.2273,1.0,0.1642,10,42,52,52,1,Siang
795,2011-02-05,0,2,13,0,6,0,3,0.22,0.2273,1.0,0.1642,10,62,72,72,1,Sore
796,2011-02-05,0,2,14,0,6,0,3,0.22,0.2727,1.0,0.0,5,50,55,55,1,Sore
797,2011-02-05,0,2,15,0,6,0,3,0.22,0.2727,1.0,0.0,11,49,60,60,1,Sore
798,2011-02-05,0,2,16,0,6,0,3,0.22,0.2273,1.0,0.1343,8,63,71,71,1,Sore
799,2011-02-05,0,2,17,0,6,0,2,0.24,0.2121,1.0,0.2836,14,64,78,78,1,Sore
800,2011-02-05,0,2,18,0,6,0,2,0.28,0.2424,0.93,0.4478,2,81,83,83,1,Sore
801,2011-02-05,0,2,19,0,6,0,2,0.28,0.2424,0.93,0.4478,6,78,84,84,1,Malam
802,2011-02-05,0,2,20,0,6,0,1,0.3,0.2879,0.87,0.2537,5,64,69,69,1,Malam
803,2011-02-05,0,2,21,0,6,0,1,0.26,0.2576,1.0,0.194,3,53,56,56,1,Malam
804,2011-02-05,0,2,22,0,6,0,1,0.26,0.2727,0.93,0.1343,2,43,45,45,1,Malam
805,2011-02-05,0,2,23,0,6,0,1,0.26,0.2576,0.93,0.2239,7,52,59,59,1,Malam
806,2011-02-06,0,2,0,0,0,0,1,0.26,0.2576,0.7,0.194,2,37,39,39,1,
807,2011-02-06,0,2,1,0,0,0,1,0.26,0.2273,0.65,0.4179,4,40,44,44,1,Pagi
808,2011-02-06,0,2,2,0,0,0,1,0.26,0.2273,0.6,0.3284,0,20,20,20,1,Pagi
809,2011-02-06,0,2,3,0,0,0,1,0.26,0.2879,0.6,0.0896,3,10,13,13,1,Pagi
810,2011-02-06,0,2,4,0,0,0,1,0.26,0.2273,0.6,0.3582,0,2,2,2,1,Pagi
811,2011-02-06,0,2,5,0,0,0,1,0.26,0.2576,0.6,0.2239,0,1,1,1,1,Pagi
812,2011-02-06,0,2,6,0,0,0,1,0.26,0.2576,0.6,0.2239,0,1,1,1,1,Pagi
813,2011-02-06,0,2,7,0,0,0,1,0.24,0.2424,0.65,0.1642,0,8,8,8,1,Siang
814,2011-02-06,0,2,8,0,0,0,1,0.24,0.2576,0.65,0.1045,2,21,23,23,1,Siang
815,2011-02-06,0,2,9,0,0,0,1,0.28,0.2879,0.56,0.1045,7,38,45,45,1,Siang
816,2011-02-06,0,2,10,0,0,0,1,0.3,0.2879,0.52,0.2537,15,74,89,89,1,Siang
817,2011-02-06,0,2,11,0,0,0,1,0.32,0.303,0.49,0.2537,28,89,117,117,1,Siang
818,2011-02-06,0,2,12,0,0,0,1,0.34,0.3333,0.46,0.0,48,126,174,174,1,Siang
819,2011-02-06,0,2,13,0,0,0,1,0.34,0.3636,0.46,0.0,47,135,182,182,1,Sore
820,2011-02-06,0,2,14,0,0,0,1,0.34,0.3485,0.46,0.0896,47,114,161,161,1,Sore
821,2011-02-06,0,2,15,0,0,0,1,0.34,0.3485,0.46,0.0896,52,130,182,182,1,Sore
822,2011-02-06,0,2,16,0,0,0,1,0.34,0.3485,0.49,0.1045,42,115,157,157,1,Sore
823,2011-02-06,0,2,17,0,0,0,1,0.34,0.3636,0.46,0.0,24,97,121,121,1,Sore
824,2011-02-06,0,2,18,0,0,0,1,0.3,0.303,0.56,0.1642,13,65,78,78,1,Sore
825,2011-02-06,0,2,19,0,0,0,1,0.28,0.2879,0.61,0.1343,1,20,21,21,1,Malam
826,2011-02-06,0,2,20,0,0,0,1,0.28,0.2879,0.61,0.1045,5,21,26,26,1,Malam
827,2011-02-06,0,2,21,0,0,0,1,0.26,0.303,0.6,0.0,5,22,27,27,1,Malam
828,2011-02-06,0,2,22,0,0,0,1,0.26,0.303,0.6,0.0,5,57,62,62,1,Malam
829,2011-02-06,0,2,23,0,0,0,1,0.24,0.2879,0.65,0.0,4,26,30,30,1,Malam
830,2011-02-07,0,2,0,0,1,1,1,0.24,0.2879,0.65,0.0,1,14,15,15,1,
831,2011-02-07,0,2,1,0,1,1,1,0.22,0.2727,0.75,0.0,1,4,5,5,1,Pagi
832,2011-02-07,0,2,2,0,1,1,1,0.2,0.2576,0.8,0.0,0,3,3,3,1,Pagi
833,2011-02-07,0,2,3,0,1,1,1,0.2,0.2576,0.86,0.0,0,1,1,1,1,Pagi
834,2011-02-07,0,2,4,0,1,1,1,0.2,0.2576,0.86,0.0,1,1,2,2,1,Pagi
835,2011-02-07,0,2,5,0,1,1,1,0.2,0.2576,0.86,0.0,1,9,10,10,1,Pagi
836,2011-02-07,0,2,6,0,1,1,1,0.18,0.2424,0.93,0.0,1,29,30,30,1,Pagi
837,2011-02-07,0,2,7,0,1,1,1,0.18,0.2424,0.86,0.0,6,89,95,95,1,Siang
838,2011-02-07,0,2,8,0,1,1,2,0.16,0.2273,1.0,0.0,7,223,230,230,1,Siang
839,2011-02-07,0,2,9,0,1,1,1,0.22,0.2727,0.8,0.0,3,115,118,118,1,Siang
840,2011-02-07,0,2,10,0,1,1,1,0.24,0.2576,0.75,0.1045,6,49,55,55,1,Siang
841,2011-02-07,0,2,11,0,1,1,1,0.3,0.3182,0.65,0.0896,11,36,47,47,1,Siang
842,2011-02-07,0,2,12,0,1,1,2,0.32,0.3485,0.62,0.0,7,59,66,66,1,Siang
843,2011-02-07,0,2,13,0,1,1,2,0.36,0.3636,0.57,0.0896,10,54,64,64,1,Sore
844,2011-02-07,0,2,14,0,1,1,2,0.36,0.3636,0.57,0.0896,8,52,60,60,1,Sore
845,2011-02-07,0,2,15,0,1,1,2,0.38,0.3939,0.54,0.0896,4,46,50,50,1,Sore
846,2011-02-07,0,2,16,0,1,1,2,0.36,0.3485,0.57,0.1343,16,98,114,114,1,Sore
847,2011-02-07,0,2,17,0,1,1,2,0.32,0.3182,0.7,0.1642,9,207,216,216,1,Sore
848,2011-02-07,0,2,18,0,1,1,2,0.34,0.3333,0.66,0.1343,5,170,175,175,1,Sore
849,2011-02-07,0,2,19,0,1,1,2,0.32,0.3485,0.7,0.0,5,123,128,128,1,Malam
850,2011-02-07,0,2,20,0,1,1,2,0.32,0.3333,0.7,0.1045,6,82,88,88,1,Malam
851,2011-02-07,0,2,21,0,1,1,1,0.32,0.3485,0.7,0.0,3,75,78,78,1,Malam
852,2011-02-07,0,2,22,0,1,1,1,0.28,0.303,0.81,0.0896,3,34,37,37,1,Malam
853,2011-02-07,0,2,23,0,1,1,2,0.3,0.3333,0.81,0.0,6,19,25,25,1,Malam
854,2011-02-08,0,2,0,0,2,1,2,0.28,0.3182,0.87,0.0,4,6,10,10,1,
855,2011-02-08,0,2,1,0,2,1,2,0.28,0.3182,0.87,0.0,0,4,4,4,1,Pagi
856,2011-02-08,0,2,2,0,2,1,2,0.26,0.2727,0.93,0.1045,1,1,2,2,1,Pagi
857,2011-02-08,0,2,3,0,2,1,3,0.28,0.2727,0.93,0.1642,0,1,1,1,1,Pagi
858,2011-02-08,0,2,4,0,2,1,1,0.26,0.2576,0.93,0.1642,0,3,3,3,1,Pagi
859,2011-02-08,0,2,5,0,2,1,1,0.26,0.2273,0.81,0.3284,0,2,2,2,1,Pagi
860,2011-02-08,0,2,6,0,2,1,1,0.26,0.2273,0.7,0.3284,0,39,39,39,1,Pagi
861,2011-02-08,0,2,7,0,2,1,1,0.24,0.197,0.65,0.4179,3,97,100,100,1,Siang
862,2011-02-08,0,2,8,0,2,1,1,0.24,0.197,0.56,0.4925,7,236,243,243,1,Siang
863,2011-02-08,0,2,9,0,2,1,1,0.24,0.197,0.52,0.4925,7,128,135,135,1,Siang
864,2011-02-08,0,2,10,0,2,1,1,0.22,0.1818,0.47,0.5522,4,44,48,48,1,Siang
865,2011-02-08,0,2,11,0,2,1,1,0.22,0.1818,0.47,0.4627,1,49,50,50,1,Siang
866,2011-02-08,0,2,12,0,2,1,1,0.24,0.197,0.38,0.4925,2,63,65,65,1,Siang
867,2011-02-08,0,2,13,0,2,1,2,0.24,0.197,0.32,0.4478,2,48,50,50,1,Sore
868,2011-02-08,0,2,14,0,2,1,1,0.22,0.197,0.37,0.4179,3,61,64,64,1,Sore
869,2011-02-08,0,2,15,0,2,1,1,0.22,0.197,0.35,0.3881,6,45,51,51,1,Sore
870,2011-02-08,0,2,16,0,2,1,1,0.22,0.1818,0.35,0.5224,4,79,83,83,1,Sore
871,2011-02-08,0,2,17,0,2,1,1,0.22,0.1818,0.32,0.5821,4,172,176,176,1,Sore
872,2011-02-08,0,2,18,0,2,1,1,0.2,0.1818,0.32,0.3881,1,151,152,152,1,Sore
873,2011-02-08,0,2,19,0,2,1,1,0.16,0.1212,0.4,0.4627,1,100,101,101,1,Malam
874,2011-02-08,0,2,20,0,2,1,1,0.16,0.1364,0.4,0.3284,3,53,56,56,1,Malam
875,2011-02-08,0,2,21,0,2,1,1,0.14,0.1061,0.33,0.4627,8,46,54,54,1,Malam
876,2011-02-08,0,2,22,0,2,1,1,0.12,0.1061,0.33,0.3582,0,29,29,29,1,Malam
877,2011-02-08,0,2,23,0,2,1,1,0.12,0.1061,0.33,0.3284,3,9,12,12,1,Malam
878,2011-02-09,0,2,0,0,3,1,1,0.1,0.0758,0.36,0.3582,0,17,17,17,1,
879,2011-02-09,0,2,1,0,3,1,1,0.1,0.1061,0.36,0.2239,0,7,7,7,1,Pagi
880,2011-02-09,0,2,2,0,3,1,1,0.08,0.0758,0.38,0.2836,1,2,3,3,1,Pagi
881,2011-02-09,0,2,3,0,3,1,1,0.06,0.0758,0.45,0.1343,0,2,2,2,1,Pagi
882,2011-02-09,0,2,5,0,3,1,1,0.06,0.1061,0.45,0.1045,0,7,7,7,1,Pagi
883,2011-02-09,0,2,6,0,3,1,1,0.06,0.1515,0.45,0.0,0,43,43,43,1,Pagi
884,2011-02-09,0,2,7,0,3,1,1,0.06,0.1061,0.49,0.1045,4,95,99,99,1,Siang
885,2011-02-09,0,2,8,0,3,1,1,0.1,0.1364,0.42,0.0,1,198,199,199,1,Siang
886,2011-02-09,0,2,9,0,3,1,1,0.12,0.1364,0.39,0.1642,4,119,123,123,1,Siang
887,2011-02-09,0,2,10,0,3,1,1,0.14,0.1818,0.36,0.0,8,51,59,59,1,Siang
888,2011-02-09,0,2,11,0,3,1,2,0.14,0.1515,0.43,0.1642,1,40,41,41,1,Siang
889,2011-02-09,0,2,12,0,3,1,2,0.18,0.1818,0.4,0.2239,4,57,61,61,1,Siang
890,2011-02-09,0,2,13,0,3,1,1,0.18,0.1667,0.4,0.2537,2,67,69,69,1,Sore
891,2011-02-09,0,2,14,0,3,1,1,0.2,0.1818,0.34,0.2985,2,56,58,58,1,Sore
892,2011-02-09,0,2,15,0,3,1,2,0.2,0.1818,0.34,0.2836,3,61,64,64,1,Sore
893,2011-02-09,0,2,16,0,3,1,2,0.2,0.197,0.37,0.2537,7,72,79,79,1,Sore
894,2011-02-09,0,2,17,0,3,1,2,0.2,0.197,0.34,0.2537,9,157,166,166,1,Sore
895,2011-02-09,0,2,18,0,3,1,2,0.18,0.1667,0.47,0.2985,2,168,170,170,1,Sore
896,2011-02-09,0,2,19,0,3,1,3,0.14,0.1212,0.86,0.2537,1,87,88,88,1,Malam
897,2011-02-09,0,2,20,0,3,1,3,0.14,0.1515,0.86,0.1642,0,84,84,84,1,Malam
898,2011-02-09,0,2,21,0,3,1,2,0.14,0.1515,0.86,0.1642,0,83,83,83,1,Malam
899,2011-02-09,0,2,22,0,3,1,3,0.16,0.1667,0.8,0.1642,4,42,46,46,1,Malam
900,2011-02-09,0,2,23,0,3,1,3,0.16,0.1515,0.8,0.194,0,37,37,37,1,Malam
901,2011-02-10,0,2,0,0,4,1,3,0.14,0.1364,0.86,0.194,0,16,16,16,1,
902,2011-02-10,0,2,1,0,4,1,3,0.14,0.1515,0.8,0.1343,0,7,7,7,1,Pagi
903,2011-02-10,0,2,2,0,4,1,3,0.14,0.1515,0.8,0.1343,0,3,3,3,1,Pagi
904,2011-02-10,0,2,4,0,4,1,2,0.14,0.1364,0.59,0.2239,0,1,1,1,1,Pagi
905,2011-02-10,0,2,5,0,4,1,2,0.12,0.1212,0.5,0.2239,0,6,6,6,1,Pagi
906,2011-02-10,0,2,6,0,4,1,2,0.12,0.1212,0.54,0.2836,0,26,26,26,1,Pagi
907,2011-02-10,0,2,7,0,4,1,1,0.1,0.0758,0.5,0.4179,0,99,99,99,1,Siang
908,2011-02-10,0,2,8,0,4,1,1,0.1,0.0758,0.49,0.3284,5,173,178,178,1,Siang
909,2011-02-10,0,2,9,0,4,1,1,0.12,0.1061,0.42,0.3582,1,121,122,122,1,Siang
910,2011-02-10,0,2,10,0,4,1,1,0.12,0.1061,0.42,0.2985,1,34,35,35,1,Siang
911,2011-02-10,0,2,11,0,4,1,1,0.14,0.1212,0.39,0.3582,1,44,45,45,1,Siang
912,2011-02-10,0,2,12,0,4,1,1,0.16,0.1364,0.34,0.3881,4,65,69,69,1,Siang
913,2011-02-10,0,2,13,0,4,1,1,0.18,0.1667,0.29,0.2985,3,59,62,62,1,Sore
914,2011-02-10,0,2,14,0,4,1,1,0.2,0.1818,0.27,0.2836,6,42,48,48,1,Sore
915,2011-02-10,0,2,15,0,4,1,1,0.2,0.197,0.25,0.2537,0,50,50,50,1,Sore
916,2011-02-10,0,2,16,0,4,1,1,0.2,0.1818,0.27,0.2985,4,76,80,80,1,Sore
917,2011-02-10,0,2,17,0,4,1,1,0.18,0.1818,0.26,0.194,6,159,165,165,1,Sore
918,2011-02-10,0,2,18,0,4,1,1,0.16,0.1818,0.28,0.1343,3,157,160,160,1,Sore
919,2011-02-10,0,2,19,0,4,1,1,0.14,0.1667,0.28,0.1045,2,110,112,112,1,Malam
920,2011-02-10,0,2,20,0,4,1,1,0.14,0.1818,0.31,0.0896,4,93,97,97,1,Malam
921,2011-02-10,0,2,21,0,4,1,1,0.14,0.2121,0.39,0.0,2,70,72,72,1,Malam
922,2011-02-10,0,2,22,0,4,1,1,0.12,0.197,0.39,0.0,4,47,51,51,1,Malam
923,2011-02-10,0,2,23,0,4,1,1,0.12,0.1515,0.42,0.1045,1,33,34,34,1,Malam
924,2011-02-11,0,2,0,0,5,1,1,0.1,0.1364,0.49,0.1045,2,12,14,14,1,
925,2011-02-11,0,2,1,0,5,1,1,0.1,0.1364,0.54,0.0896,1,6,7,7,1,Pagi
926,2011-02-11,0,2,2,0,5,1,1,0.1,0.1364,0.54,0.0896,0,3,3,3,1,Pagi
927,2011-02-11,0,2,5,0,5,1,1,0.08,0.1212,0.63,0.0896,0,4,4,4,1,Pagi
928,2011-02-11,0,2,6,0,5,1,1,0.1,0.1818,0.68,0.0,1,23,24,24,1,Pagi
929,2011-02-11,0,2,7,0,5,1,1,0.08,0.1667,0.73,0.0,1,73,74,74,1,Siang
930,2011-02-11,0,2,8,0,5,1,1,0.1,0.1212,0.74,0.1642,4,212,216,216,1,Siang
931,2011-02-11,0,2,9,0,5,1,1,0.12,0.1212,0.74,0.2239,8,132,140,140,1,Siang
932,2011-02-11,0,2,10,0,5,1,1,0.14,0.1364,0.69,0.194,5,39,44,44,1,Siang
933,2011-02-11,0,2,11,0,5,1,1,0.22,0.2273,0.47,0.1343,12,52,64,64,1,Siang
934,2011-02-11,0,2,12,0,5,1,1,0.22,0.2273,0.47,0.1343,7,64,71,71,1,Siang
935,2011-02-11,0,2,13,0,5,1,1,0.24,0.2273,0.35,0.194,21,89,110,110,1,Sore
936,2011-02-11,0,2,14,0,5,1,1,0.3,0.2879,0.26,0.2537,17,67,84,84,1,Sore
937,2011-02-11,0,2,15,0,5,1,1,0.32,0.3182,0.21,0.1642,12,62,74,74,1,Sore
938,2011-02-11,0,2,16,0,5,1,1,0.3,0.2879,0.28,0.194,14,111,125,125,1,Sore
939,2011-02-11,0,2,17,0,5,1,1,0.3,0.3333,0.24,0.0,18,193,211,211,1,Sore
940,2011-02-11,0,2,18,0,5,1,1,0.28,0.3182,0.28,0.0,9,165,174,174,1,Sore
941,2011-02-11,0,2,19,0,5,1,1,0.26,0.303,0.33,0.0,7,94,101,101,1,Malam
942,2011-02-11,0,2,20,0,5,1,1,0.22,0.2273,0.55,0.1343,2,61,63,63,1,Malam
943,2011-02-11,0,2,21,0,5,1,1,0.2,0.2121,0.59,0.1343,1,46,47,47,1,Malam
944,2011-02-11,0,2,22,0,5,1,1,0.2,0.2273,0.64,0.0896,2,41,43,43,1,Malam
945,2011-02-11,0,2,23,0,5,1,1,0.18,0.2424,0.69,0.0,5,48,53,53,1,Malam
946,2011-02-12,0,2,0,0,6,0,1,0.16,0.197,0.69,0.0896,3,27,30,30,1,
947,2011-02-12,0,2,1,0,6,0,1,0.14,0.2121,0.86,0.0,2,22,24,24,1,Pagi
948,2011-02-12,0,2,2,0,6,0,1,0.14,0.2121,0.8,0.0,2,13,15,15,1,Pagi
949,2011-02-12,0,2,3,0,6,0,1,0.12,0.197,0.8,0.0,3,7,10,10,1,Pagi
950,2011-02-12,0,2,4,0,6,0,1,0.12,0.1667,0.74,0.0896,0,4,4,4,1,Pagi
951,2011-02-12,0,2,5,0,6,0,1,0.12,0.1667,0.74,0.0896,0,1,1,1,1,Pagi
952,2011-02-12,0,2,6,0,6,0,1,0.12,0.1364,0.93,0.194,1,1,2,2,1,Pagi
953,2011-02-12,0,2,7,0,6,0,1,0.12,0.1515,0.8,0.1045,2,9,11,11,1,Siang
954,2011-02-12,0,2,8,0,6,0,1,0.14,0.1515,0.86,0.1343,2,28,30,30,1,Siang
955,2011-02-12,0,2,9,0,6,0,1,0.16,0.1818,0.64,0.1343,5,38,43,43,1,Siang
956,2011-02-12,0,2,10,0,6,0,1,0.22,0.2121,0.41,0.2537,13,71,84,84,1,Siang
957,2011-02-12,0,2,11,0,6,0,1,0.3,0.2727,0.28,0.3284,30,84,114,114,1,Siang
958,2011-02-12,0,2,12,0,6,0,1,0.3,0.2727,0.39,0.4627,27,93,120,120,1,Siang
959,2011-02-12,0,2,13,0,6,0,1,0.3,0.2727,0.39,0.4179,32,103,135,135,1,Sore
960,2011-02-12,0,2,14,0,6,0,1,0.34,0.3182,0.31,0.2836,30,90,120,120,1,Sore
961,2011-02-12,0,2,15,0,6,0,1,0.34,0.303,0.29,0.4179,47,127,174,174,1,Sore
962,2011-02-12,0,2,16,0,6,0,1,0.34,0.303,0.29,0.4179,42,103,145,145,1,Sore
963,2011-02-12,0,2,17,0,6,0,1,0.32,0.2879,0.31,0.5224,24,113,137,137,1,Sore
964,2011-02-12,0,2,18,0,6,0,1,0.28,0.2576,0.38,0.3284,4,60,64,64,1,Sore
965,2011-02-12,0,2,19,0,6,0,1,0.28,0.2727,0.38,0.1642,2,39,41,41,1,Malam
966,2011-02-12,0,2,20,0,6,0,1,0.26,0.2576,0.41,0.2239,1,39,40,40,1,Malam
967,2011-02-12,0,2,21,0,6,0,1,0.26,0.303,0.41,0.0,9,42,51,51,1,Malam
968,2011-02-12,0,2,22,0,6,0,1,0.24,0.2576,0.44,0.0896,6,39,45,45,1,Malam
969,2011-02-12,0,2,23,0,6,0,1,0.22,0.2273,0.51,0.1343,1,31,32,32,1,Malam
970,2011-02-13,0,2,0,0,0,0,1,0.2,0.2273,0.64,0.1045,5,34,39,39,1,
971,2011-02-13,0,2,1,0,0,0,1,0.2,0.2273,0.59,0.0896,1,23,24,24,1,Pagi
972,2011-02-13,0,2,2,0,0,0,2,0.2,0.2273,0.75,0.0896,1,19,20,20,1,Pagi
973,2011-02-13,0,2,3,0,0,0,2,0.2,0.2273,0.69,0.1045,4,8,12,12,1,Pagi
974,2011-02-13,0,2,4,0,0,0,2,0.2,0.2121,0.69,0.1642,0,2,2,2,1,Pagi
975,2011-02-13,0,2,6,0,0,0,2,0.2,0.2121,0.69,0.1343,2,3,5,5,1,Pagi
976,2011-02-13,0,2,7,0,0,0,2,0.22,0.2727,0.55,0.0,0,3,3,3,1,Siang
977,2011-02-13,0,2,8,0,0,0,2,0.22,0.2273,0.64,0.194,1,11,12,12,1,Siang
978,2011-02-13,0,2,9,0,0,0,2,0.24,0.2273,0.6,0.2239,12,35,47,47,1,Siang
979,2011-02-13,0,2,10,0,0,0,1,0.3,0.2727,0.45,0.3284,19,86,105,105,1,Siang
980,2011-02-13,0,2,11,0,0,0,1,0.32,0.2879,0.39,0.4478,26,86,112,112,1,Siang
981,2011-02-13,0,2,12,0,0,0,1,0.36,0.3182,0.32,0.4627,58,94,152,152,1,Siang
982,2011-02-13,0,2,13,0,0,0,1,0.38,0.3939,0.29,0.3582,62,92,154,154,1,Sore
983,2011-02-13,0,2,14,0,0,0,2,0.4,0.4091,0.3,0.4179,51,110,161,161,1,Sore
984,2011-02-13,0,2,15,0,0,0,2,0.4,0.4091,0.3,0.2985,40,122,162,162,1,Sore
985,2011-02-13,0,2,16,0,0,0,2,0.42,0.4242,0.28,0.3284,28,106,134,134,1,Sore
986,2011-02-13,0,2,17,0,0,0,1,0.42,0.4242,0.28,0.3284,30,95,125,125,1,Sore
987,2011-02-13,0,2,18,0,0,0,1,0.4,0.4091,0.32,0.2985,17,78,95,95,1,Sore
988,2011-02-13,0,2,19,0,0,0,1,0.4,0.4091,0.35,0.2836,11,50,61,61,1,Malam
989,2011-02-13,0,2,20,0,0,0,1,0.4,0.4091,0.35,0.3284,15,32,47,47,1,Malam
990,2011-02-13,0,2,21,0,0,0,1,0.4,0.4091,0.35,0.3582,6,45,51,51,1,Malam
991,2011-02-13,0,2,22,0,0,0,1,0.4,0.4091,0.35,0.2985,5,31,36,36,1,Malam
992,2011-02-13,0,2,23,0,0,0,1,0.4,0.4091,0.35,0.3582,3,27,30,30,1,Malam
993,2011-02-14,0,2,0,0,1,1,1,0.38,0.3939,0.37,0.3582,3,8,11,11,1,
994,2011-02-14,0,2,1,0,1,1,1,0.38,0.3939,0.37,0.3582,1,6,7,7,1,Pagi
995,2011-02-14,0,2,2,0,1,1,1,0.36,0.3333,0.4,0.2985,0,2,2,2,1,Pagi
996,2011-02-14,0,2,3,0,1,1,1,0.34,0.3182,0.46,0.2239,1,1,2,2,1,Pagi
997,2011-02-14,0,2,4,0,1,1,1,0.32,0.303,0.53,0.2836,0,2,2,2,1,Pagi
998,2011-02-14,0,2,5,0,1,1,1,0.32,0.303,0.53,0.2836,0,3,3,3,1,Pagi
999,2011-02-14,0,2,6,0,1,1,1,0.34,0.303,0.46,0.2985,1,25,26,26,1,Pagi
1000,2011-02-14,0,2,7,0,1,1,1,0.34,0.303,0.46,0.2985,2,96,98,98,1,Siang
1001,2011-02-14,0,2,8,0,1,1,1,0.38,0.3939,0.4,0.4627,7,249,256,256,1,Siang
1002,2011-02-14,0,2,9,0,1,1,1,0.4,0.4091,0.37,0.3881,8,122,130,130,1,Siang
1003,2011-02-14,0,2,10,0,1,1,1,0.44,0.4394,0.33,0.2239,9,46,55,55,1,Siang
1004,2011-02-14,0,2,11,0,1,1,1,0.52,0.5,0.23,0.2537,10,43,53,53,1,Siang
1005,2011-02-14,0,2,12,0,1,1,1,0.56,0.5303,0.22,0.4478,27,99,126,126,1,Siang
1006,2011-02-14,0,2,13,0,1,1,1,0.58,0.5455,0.19,0.3881,27,93,120,120,1,Sore
1007,2011-02-14,0,2,14,0,1,1,1,0.6,0.5909,0.15,0.4925,14,76,90,90,1,Sore
1008,2011-02-14,0,2,15,0,1,1,1,0.56,0.5303,0.21,0.6567,19,71,90,90,1,Sore
1009,2011-02-14,0,2,16,0,1,1,1,0.52,0.5,0.27,0.4627,16,102,118,118,1,Sore
1010,2011-02-14,0,2,17,0,1,1,1,0.46,0.4545,0.33,0.6119,25,218,243,243,1,Sore
1011,2011-02-14,0,2,18,0,1,1,1,0.4,0.4091,0.4,0.6119,11,194,205,205,1,Sore
1012,2011-02-14,0,2,19,0,1,1,1,0.38,0.3939,0.43,0.4925,12,86,98,98,1,Malam
1013,2011-02-14,0,2,20,0,1,1,1,0.36,0.3182,0.46,0.4627,5,65,70,70,1,Malam
1014,2011-02-14,0,2,21,0,1,1,1,0.36,0.3182,0.5,0.5224,8,35,43,43,1,Malam
1015,2011-02-14,0,2,22,0,1,1,1,0.34,0.2879,0.46,0.6567,1,44,45,45,1,Malam
1016,2011-02-14,0,2,23,0,1,1,1,0.32,0.2879,0.49,0.4925,1,19,20,20,1,Malam
1017,2011-02-15,0,2,0,0,2,1,1,0.3,0.2727,0.49,0.4179,7,12,19,19,1,
1018,2011-02-15,0,2,1,0,2,1,1,0.3,0.2424,0.42,0.7761,0,5,5,5,1,Pagi
1019,2011-02-15,0,2,2,0,2,1,1,0.28,0.2273,0.41,0.6866,1,2,3,3,1,Pagi
1020,2011-02-15,0,2,4,0,2,1,1,0.22,0.1818,0.37,0.5224,0,1,1,1,1,Pagi
1021,2011-02-15,0,2,5,0,2,1,1,0.22,0.1818,0.32,0.4627,0,4,4,4,1,Pagi
1022,2011-02-15,0,2,6,0,2,1,1,0.2,0.1818,0.32,0.3284,0,30,30,30,1,Pagi
1023,2011-02-15,0,2,7,0,2,1,1,0.2,0.1818,0.32,0.3582,2,103,105,105,1,Siang
1024,2011-02-15,0,2,8,0,2,1,1,0.2,0.1818,0.32,0.3582,10,213,223,223,1,Siang
1025,2011-02-15,0,2,9,0,2,1,1,0.22,0.197,0.29,0.4478,2,108,110,110,1,Siang
1026,2011-02-15,0,2,10,0,2,1,1,0.24,0.2121,0.27,0.2836,5,47,52,52,1,Siang
1027,2011-02-15,0,2,11,0,2,1,1,0.26,0.2424,0.25,0.2537,11,46,57,57,1,Siang
1028,2011-02-15,0,2,12,0,2,1,1,0.28,0.2727,0.24,0.2537,6,65,71,71,1,Siang
1029,2011-02-15,0,2,13,0,2,1,1,0.32,0.303,0.21,0.2239,14,68,82,82,1,Sore
1030,2011-02-15,0,2,14,0,2,1,1,0.34,0.3182,0.19,0.2239,10,69,79,79,1,Sore
1031,2011-02-15,0,2,15,0,2,1,1,0.34,0.3333,0.19,0.1642,11,74,85,85,1,Sore
1032,2011-02-15,0,2,16,0,2,1,1,0.34,0.3182,0.19,0.2537,21,77,98,98,1,Sore
1033,2011-02-15,0,2,17,0,2,1,1,0.32,0.303,0.22,0.2239,15,191,206,206,1,Sore
1034,2011-02-15,0,2,18,0,2,1,1,0.3,0.303,0.22,0.1343,14,198,212,212,1,Sore
1035,2011-02-15,0,2,19,0,2,1,1,0.28,0.2879,0.26,0.1343,3,142,145,145,1,Malam
1036,2011-02-15,0,2,20,0,2,1,1,0.26,0.2727,0.33,0.1045,3,98,101,101,1,Malam
1037,2011-02-15,0,2,21,0,2,1,1,0.24,0.2879,0.52,0.0,5,61,66,66,1,Malam
1038,2011-02-15,0,2,22,0,2,1,1,0.24,0.2879,0.44,0.0,0,41,41,41,1,Malam
1039,2011-02-15,0,2,23,0,2,1,2,0.22,0.2576,0.44,0.0896,0,20,20,20,1,Malam
1040,2011-02-16,0,2,0,0,3,1,1,0.22,0.2576,0.41,0.0896,0,15,15,15,1,
1041,2011-02-16,0,2,1,0,3,1,1,0.2,0.2273,0.44,0.0896,0,9,9,9,1,Pagi
1042,2011-02-16,0,2,3,0,3,1,2,0.2,0.197,0.47,0.194,0,1,1,1,1,Pagi
1043,2011-02-16,0,2,4,0,3,1,1,0.2,0.197,0.51,0.194,0,1,1,1,1,Pagi
1044,2011-02-16,0,2,5,0,3,1,1,0.2,0.197,0.47,0.194,0,5,5,5,1,Pagi
1045,2011-02-16,0,2,6,0,3,1,1,0.2,0.197,0.55,0.2239,1,32,33,33,1,Pagi
1046,2011-02-16,0,2,7,0,3,1,2,0.2,0.197,0.55,0.2239,5,103,108,108,1,Siang
1047,2011-02-16,0,2,8,0,3,1,2,0.22,0.2273,0.55,0.1642,6,224,230,230,1,Siang
1048,2011-02-16,0,2,9,0,3,1,1,0.24,0.2121,0.52,0.2836,2,122,124,124,1,Siang
1049,2011-02-16,0,2,10,0,3,1,1,0.26,0.2273,0.41,0.3881,14,55,69,69,1,Siang
1050,2011-02-16,0,2,11,0,3,1,1,0.34,0.303,0.34,0.2985,7,59,66,66,1,Siang
1051,2011-02-16,0,2,12,0,3,1,1,0.38,0.3939,0.32,0.3284,14,72,86,86,1,Siang
1052,2011-02-16,0,2,13,0,3,1,1,0.42,0.4242,0.3,0.3582,13,80,93,93,1,Sore
1053,2011-02-16,0,2,14,0,3,1,1,0.46,0.4545,0.28,0.4179,17,65,82,82,1,Sore
1054,2011-02-16,0,2,15,0,3,1,1,0.46,0.4545,0.28,0.4179,35,82,117,117,1,Sore
1055,2011-02-16,0,2,16,0,3,1,1,0.46,0.4545,0.31,0.3881,26,96,122,122,1,Sore
1056,2011-02-16,0,2,17,0,3,1,1,0.46,0.4545,0.28,0.2836,11,244,255,255,1,Sore
1057,2011-02-16,0,2,18,0,3,1,1,0.4,0.4091,0.4,0.2239,20,202,222,222,1,Sore
1058,2011-02-16,0,2,19,0,3,1,1,0.34,0.3182,0.53,0.2239,18,143,161,161,1,Malam
1059,2011-02-16,0,2,20,0,3,1,1,0.38,0.3939,0.43,0.194,10,108,118,118,1,Malam
1060,2011-02-16,0,2,21,0,3,1,1,0.36,0.3485,0.46,0.194,5,87,92,92,1,Malam
1061,2011-02-16,0,2,22,0,3,1,1,0.34,0.3333,0.53,0.194,12,61,73,73,1,Malam
1062,2011-02-16,0,2,23,0,3,1,1,0.38,0.3939,0.4,0.2239,2,31,33,33,1,Malam
1063,2011-02-17,0,2,0,0,4,1,1,0.34,0.3333,0.53,0.194,1,16,17,17,1,
1064,2011-02-17,0,2,1,0,4,1,1,0.34,0.3182,0.53,0.2239,0,6,6,6,1,Pagi
1065,2011-02-17,0,2,2,0,4,1,2,0.34,0.3182,0.53,0.2239,2,4,6,6,1,Pagi
1066,2011-02-17,0,2,3,0,4,1,1,0.34,0.3333,0.53,0.194,3,1,4,4,1,Pagi
1067,2011-02-17,0,2,4,0,4,1,1,0.32,0.3182,0.57,0.194,3,1,4,4,1,Pagi
1068,2011-02-17,0,2,5,0,4,1,1,0.32,0.3333,0.66,0.0896,1,11,12,12,1,Pagi
1069,2011-02-17,0,2,6,0,4,1,1,0.3,0.303,0.7,0.1343,3,44,47,47,1,Pagi
1070,2011-02-17,0,2,7,0,4,1,1,0.32,0.3333,0.57,0.1045,7,119,126,126,1,Siang
1071,2011-02-17,0,2,8,0,4,1,1,0.32,0.3333,0.57,0.0896,18,267,285,285,1,Siang
1072,2011-02-17,0,2,9,0,4,1,1,0.36,0.3485,0.57,0.194,16,163,179,179,1,Siang
1073,2011-02-17,0,2,10,0,4,1,1,0.38,0.3939,0.54,0.194,18,70,88,88,1,Siang
1074,2011-02-17,0,2,11,0,4,1,2,0.44,0.4394,0.44,0.2537,19,71,90,90,1,Siang
1075,2011-02-17,0,2,12,0,4,1,1,0.48,0.4697,0.41,0.2239,15,86,101,101,1,Siang
1076,2011-02-17,0,2,13,0,4,1,1,0.54,0.5152,0.34,0.2239,15,108,123,123,1,Sore
1077,2011-02-17,0,2,14,0,4,1,1,0.6,0.6212,0.31,0.2239,26,55,81,81,1,Sore
1078,2011-02-17,0,2,15,0,4,1,1,0.6,0.6061,0.28,0.2537,15,91,106,106,1,Sore
1079,2011-02-17,0,2,16,0,4,1,2,0.56,0.5303,0.35,0.2985,29,117,146,146,1,Sore
1080,2011-02-17,0,2,17,0,4,1,2,0.58,0.5455,0.32,0.2985,18,256,274,274,1,Sore
1081,2011-02-17,0,2,18,0,4,1,2,0.54,0.5152,0.42,0.2836,11,211,222,222,1,Sore
1082,2011-02-17,0,2,19,0,4,1,1,0.48,0.4697,0.55,0.3284,14,161,175,175,1,Malam
1083,2011-02-17,0,2,20,0,4,1,1,0.48,0.4697,0.59,0.3284,8,131,139,139,1,Malam
1084,2011-02-17,0,2,21,0,4,1,1,0.52,0.5,0.55,0.3881,5,119,124,124,1,Malam
1085,2011-02-17,0,2,22,0,4,1,1,0.5,0.4848,0.59,0.2836,8,68,76,76,1,Malam
1086,2011-02-17,0,2,23,0,4,1,1,0.46,0.4545,0.67,0.2985,4,40,44,44,1,Malam
1087,2011-02-18,0,2,0,0,5,1,1,0.44,0.4394,0.72,0.2836,12,20,32,32,1,
1088,2011-02-18,0,2,1,0,5,1,1,0.44,0.4394,0.72,0.2239,1,7,8,8,1,Pagi
1089,2011-02-18,0,2,2,0,5,1,1,0.44,0.4394,0.72,0.2836,2,5,7,7,1,Pagi
1090,2011-02-18,0,2,3,0,5,1,1,0.46,0.4545,0.67,0.2537,2,6,8,8,1,Pagi
1091,2011-02-18,0,2,4,0,5,1,1,0.46,0.4545,0.67,0.2537,0,1,1,1,1,Pagi
1092,2011-02-18,0,2,5,0,5,1,2,0.46,0.4545,0.67,0.1045,1,6,7,7,1,Pagi
1093,2011-02-18,0,2,6,0,5,1,2,0.44,0.4394,0.72,0.1642,2,48,50,50,1,Pagi
1094,2011-02-18,0,2,7,0,5,1,2,0.42,0.4242,0.77,0.2239,8,108,116,116,1,Siang
1095,2011-02-18,0,2,8,0,5,1,2,0.42,0.4242,0.77,0.194,26,246,272,272,1,Siang
1096,2011-02-18,0,2,9,0,5,1,2,0.42,0.4242,0.77,0.194,15,154,169,169,1,Siang
1097,2011-02-18,0,2,10,0,5,1,2,0.44,0.4394,0.72,0.2239,17,78,95,95,1,Siang
1098,2011-02-18,0,2,11,0,5,1,1,0.44,0.4394,0.72,0.1642,31,82,113,113,1,Siang
1099,2011-02-18,0,2,12,0,5,1,1,0.5,0.4848,0.59,0.194,59,126,185,185,1,Siang
1100,2011-02-18,0,2,13,0,5,1,1,0.6,0.6212,0.43,0.194,45,131,176,176,1,Sore
1101,2011-02-18,0,2,14,0,5,1,1,0.66,0.6212,0.36,0.2985,73,118,191,191,1,Sore
1102,2011-02-18,0,2,15,0,5,1,1,0.66,0.6212,0.36,0.3284,55,117,172,172,1,Sore
1103,2011-02-18,0,2,16,0,5,1,1,0.66,0.6212,0.36,0.2836,68,164,232,232,1,Sore
1104,2011-02-18,0,2,17,0,5,1,1,0.66,0.6212,0.34,0.3582,52,275,327,327,1,Sore
1105,2011-02-18,0,2,18,0,5,1,1,0.64,0.6212,0.33,0.3284,29,195,224,224,1,Sore
1106,2011-02-18,0,2,19,0,5,1,1,0.62,0.6212,0.29,0.5821,16,146,162,162,1,Malam
1107,2011-02-18,0,2,20,0,5,1,1,0.6,0.6212,0.31,0.194,19,105,124,124,1,Malam
1108,2011-02-18,0,2,21,0,5,1,1,0.58,0.5455,0.21,0.4925,11,61,72,72,1,Malam
1109,2011-02-18,0,2,22,0,5,1,1,0.54,0.5152,0.1,0.2537,19,88,107,107,1,Malam
1110,2011-02-18,0,2,23,0,5,1,1,0.52,0.5,0.08,0.2836,16,61,77,77,1,Malam
1111,2011-02-19,0,2,0,0,6,0,1,0.48,0.4697,0.12,0.4925,6,23,29,29,1,
1112,2011-02-19,0,2,1,0,6,0,1,0.46,0.4545,0.14,0.4179,10,21,31,31,1,Pagi
1113,2011-02-19,0,2,2,0,6,0,1,0.44,0.4394,0.13,0.3881,3,14,17,17,1,Pagi
1114,2011-02-19,0,2,3,0,6,0,1,0.42,0.4242,0.14,0.2985,0,7,7,7,1,Pagi
1115,2011-02-19,0,2,4,0,6,0,1,0.4,0.4091,0.15,0.3284,0,3,3,3,1,Pagi
1116,2011-02-19,0,2,5,0,6,0,1,0.4,0.4091,0.15,0.3284,0,3,3,3,1,Pagi
1117,2011-02-19,0,2,6,0,6,0,1,0.4,0.4091,0.17,0.4179,3,3,6,6,1,Pagi
1118,2011-02-19,0,2,7,0,6,0,1,0.38,0.3939,0.17,0.5224,6,16,22,22,1,Siang
1119,2011-02-19,0,2,8,0,6,0,1,0.38,0.3939,0.17,0.5821,9,36,45,45,1,Siang
1120,2011-02-19,0,2,9,0,6,0,1,0.4,0.4091,0.16,0.6567,18,37,55,55,1,Siang
1121,2011-02-19,0,2,10,0,6,0,1,0.42,0.4242,0.16,0.5821,34,72,106,106,1,Siang
1122,2011-02-19,0,2,11,0,6,0,1,0.44,0.4394,0.16,0.5821,47,76,123,123,1,Siang
1123,2011-02-19,0,2,12,0,6,0,1,0.44,0.4394,0.18,0.4925,38,81,119,119,1,Siang
1124,2011-02-19,0,2,13,0,6,0,1,0.44,0.4394,0.16,0.6119,52,103,155,155,1,Sore
1125,2011-02-19,0,2,14,0,6,0,1,0.46,0.4545,0.15,0.6567,102,94,196,196,1,Sore
1126,2011-02-19,0,2,15,0,6,0,1,0.44,0.4394,0.16,0.7463,84,87,171,171,1,Sore
1127,2011-02-19,0,2,16,0,6,0,1,0.44,0.4394,0.16,0.6418,39,81,120,120,1,Sore
1128,2011-02-19,0,2,17,0,6,0,1,0.42,0.4242,0.19,0.6119,36,91,127,127,1,Sore
1129,2011-02-19,0,2,18,0,6,0,1,0.36,0.3182,0.25,0.4478,21,67,88,88,1,Sore
1130,2011-02-19,0,2,19,0,6,0,1,0.34,0.303,0.29,0.3582,5,54,59,59,1,Malam
1131,2011-02-19,0,2,20,0,6,0,1,0.32,0.2879,0.28,0.5224,9,38,47,47,1,Malam
1132,2011-02-19,0,2,21,0,6,0,1,0.32,0.2727,0.26,0.5522,4,29,33,33,1,Malam
1133,2011-02-19,0,2,22,0,6,0,1,0.3,0.2576,0.28,0.4925,2,42,44,44,1,Malam
1134,2011-02-19,0,2,23,0,6,0,1,0.28,0.2424,0.33,0.4478,4,25,29,29,1,Malam
1135,2011-02-20,0,2,0,0,0,0,1,0.26,0.2121,0.35,0.4478,3,14,17,17,1,
1136,2011-02-20,0,2,1,0,0,0,1,0.24,0.197,0.41,0.4627,5,11,16,16,1,Pagi
1137,2011-02-20,0,2,2,0,0,0,1,0.24,0.197,0.41,0.5522,0,17,17,17,1,Pagi
1138,2011-02-20,0,2,3,0,0,0,1,0.22,0.1818,0.44,0.5522,9,9,18,18,1,Pagi
1139,2011-02-20,0,2,4,0,0,0,1,0.22,0.1818,0.44,0.5522,0,1,1,1,1,Pagi
1140,2011-02-20,0,2,6,0,0,0,1,0.2,0.1818,0.47,0.2985,1,1,2,2,1,Pagi
1141,2011-02-20,0,2,7,0,0,0,1,0.18,0.1667,0.51,0.2537,0,2,2,2,1,Siang
1142,2011-02-20,0,2,8,0,0,0,1,0.2,0.2273,0.51,0.1045,2,22,24,24,1,Siang
1143,2011-02-20,0,2,9,0,0,0,1,0.22,0.2121,0.47,0.2836,7,48,55,55,1,Siang
1144,2011-02-20,0,2,10,0,0,0,2,0.26,0.2576,0.41,0.194,34,70,104,104,1,Siang
1145,2011-02-20,0,2,11,0,0,0,2,0.3,0.303,0.33,0.1642,72,89,161,161,1,Siang
1146,2011-02-20,0,2,12,0,0,0,1,0.3,0.3182,0.33,0.1045,62,120,182,182,1,Siang
1147,2011-02-20,0,2,13,0,0,0,1,0.34,0.3333,0.29,0.0,76,122,198,198,1,Sore
1148,2011-02-20,0,2,14,0,0,0,1,0.36,0.3485,0.27,0.1642,108,104,212,212,1,Sore
1149,2011-02-20,0,2,15,0,0,0,1,0.36,0.3636,0.27,0.0896,66,102,168,168,1,Sore
1150,2011-02-20,0,2,16,0,0,0,1,0.36,0.3636,0.29,0.0896,59,88,147,147,1,Sore
1151,2011-02-20,0,2,17,0,0,0,1,0.34,0.3485,0.33,0.1642,60,86,146,146,1,Sore
1152,2011-02-20,0,2,18,0,0,0,2,0.34,0.3333,0.36,0.1343,30,71,101,101,1,Sore
1153,2011-02-20,0,2,19,0,0,0,2,0.34,0.3333,0.36,0.1343,3,39,42,42,1,Malam
1154,2011-02-20,0,2,20,0,0,0,2,0.34,0.3636,0.42,0.0,12,30,42,42,1,Malam
1155,2011-02-20,0,2,21,0,0,0,2,0.32,0.3485,0.53,0.0,17,39,56,56,1,Malam
1156,2011-02-20,0,2,22,0,0,0,2,0.32,0.303,0.57,0.2239,4,43,47,47,1,Malam
1157,2011-02-20,0,2,23,0,0,0,2,0.3,0.303,0.61,0.1642,9,45,54,54,1,Malam
1158,2011-02-21,0,2,0,1,1,0,2,0.34,0.303,0.42,0.3284,7,30,37,37,1,
1159,2011-02-21,0,2,1,1,1,0,2,0.34,0.303,0.42,0.3284,2,11,13,13,1,Pagi
1160,2011-02-21,0,2,2,1,1,0,2,0.34,0.303,0.42,0.3284,1,3,4,4,1,Pagi
1161,2011-02-21,0,2,3,1,1,0,2,0.34,0.303,0.42,0.2985,2,3,5,5,1,Pagi
1162,2011-02-21,0,2,4,1,1,0,1,0.32,0.3182,0.45,0.1642,1,0,1,1,1,Pagi
1163,2011-02-21,0,2,5,1,1,0,2,0.34,0.3636,0.36,0.0,1,2,3,3,1,Pagi
1164,2011-02-21,0,2,6,1,1,0,2,0.42,0.4242,0.26,0.2985,2,6,8,8,1,Pagi
1165,2011-02-21,0,2,7,1,1,0,2,0.42,0.4242,0.26,0.2836,3,16,19,19,1,Siang
1166,2011-02-21,0,2,8,1,1,0,2,0.32,0.303,0.57,0.2985,7,56,63,63,1,Siang
1167,2011-02-21,0,2,9,1,1,0,2,0.32,0.303,0.57,0.2836,11,46,57,57,1,Siang
1168,2011-02-21,0,2,10,1,1,0,2,0.32,0.303,0.57,0.2537,29,52,81,81,1,Siang
1169,2011-02-21,0,2,11,1,1,0,2,0.32,0.3333,0.57,0.1045,20,70,90,90,1,Siang
1170,2011-02-21,0,2,12,1,1,0,2,0.32,0.3182,0.66,0.194,26,67,93,93,1,Siang
1171,2011-02-21,0,2,13,1,1,0,3,0.3,0.2727,0.81,0.3284,28,75,103,103,1,Sore
1172,2011-02-21,0,2,14,1,1,0,2,0.32,0.303,0.76,0.2537,15,101,116,116,1,Sore
1173,2011-02-21,0,2,15,1,1,0,2,0.3,0.2727,0.7,0.4478,11,76,87,87,1,Sore
1174,2011-02-21,0,2,16,1,1,0,3,0.28,0.2424,0.75,0.4179,8,48,56,56,1,Sore
1175,2011-02-21,0,2,17,1,1,0,2,0.28,0.2576,0.75,0.3881,18,62,80,80,1,Sore
1176,2011-02-21,0,2,18,1,1,0,2,0.24,0.2121,0.87,0.3582,2,64,66,66,1,Sore
1177,2011-02-21,0,2,19,1,1,0,2,0.24,0.2121,0.87,0.3582,0,49,49,49,1,Malam
1178,2011-02-21,0,2,20,1,1,0,3,0.24,0.2121,0.81,0.3881,0,29,29,29,1,Malam
1179,2011-02-21,0,2,21,1,1,0,3,0.22,0.197,0.75,0.4478,1,33,34,34,1,Malam
1180,2011-02-21,0,2,22,1,1,0,3,0.2,0.1667,0.75,0.4179,0,11,11,11,1,Malam
1181,2011-02-21,0,2,23,1,1,0,3,0.2,0.1667,0.75,0.4179,0,2,2,2,1,Malam
1182,2011-02-22,0,2,6,0,2,1,2,0.12,0.1212,0.8,0.2836,0,7,7,7,1,Pagi
1183,2011-02-22,0,2,7,0,2,1,2,0.12,0.1212,0.8,0.2836,0,40,40,40,1,Siang
1184,2011-02-22,0,2,8,0,2,1,2,0.12,0.1212,0.8,0.2537,7,107,114,114,1,Siang
1185,2011-02-22,0,2,9,0,2,1,2,0.14,0.1212,0.74,0.2537,5,101,106,106,1,Siang
1186,2011-02-22,0,2,10,0,2,1,1,0.16,0.1818,0.69,0.0,0,44,44,44,1,Siang
1187,2011-02-22,0,2,11,0,2,1,1,0.16,0.2273,0.64,0.0,7,43,50,50,1,Siang
1188,2011-02-22,0,2,12,0,2,1,1,0.2,0.2273,0.59,0.1045,7,48,55,55,1,Siang
1189,2011-02-22,0,2,13,0,2,1,1,0.22,0.2273,0.55,0.1642,3,52,55,55,1,Sore
1190,2011-02-22,0,2,14,0,2,1,1,0.22,0.2273,0.55,0.194,9,49,58,58,1,Sore
1191,2011-02-22,0,2,15,0,2,1,1,0.24,0.2273,0.48,0.194,2,67,69,69,1,Sore
1192,2011-02-22,0,2,16,0,2,1,1,0.22,0.2273,0.51,0.1642,7,79,86,86,1,Sore
1193,2011-02-22,0,2,17,0,2,1,1,0.22,0.2121,0.51,0.2239,8,188,196,196,1,Sore
1194,2011-02-22,0,2,18,0,2,1,1,0.22,0.2273,0.47,0.1343,6,161,167,167,1,Sore
1195,2011-02-22,0,2,19,0,2,1,1,0.2,0.1818,0.47,0.2836,4,114,118,118,1,Malam
1196,2011-02-22,0,2,20,0,2,1,1,0.2,0.197,0.47,0.2239,3,102,105,105,1,Malam
1197,2011-02-22,0,2,21,0,2,1,1,0.2,0.197,0.47,0.2537,2,80,82,82,1,Malam
1198,2011-02-22,0,2,22,0,2,1,1,0.16,0.1515,0.43,0.2537,1,76,77,77,1,Malam
1199,2011-02-22,0,2,23,0,2,1,1,0.16,0.1515,0.43,0.2537,3,18,21,21,1,Malam
1200,2011-02-23,0,2,0,0,3,1,1,0.14,0.1364,0.5,0.194,0,6,6,6,1,
1201,2011-02-23,0,2,1,0,3,1,1,0.14,0.1515,0.46,0.1642,0,4,4,4,1,Pagi
1202,2011-02-23,0,2,2,0,3,1,1,0.12,0.1515,0.5,0.1343,0,1,1,1,1,Pagi
1203,2011-02-23,0,2,3,0,3,1,1,0.12,0.1364,0.5,0.1642,0,2,2,2,1,Pagi
1204,2011-02-23,0,2,5,0,3,1,1,0.12,0.1515,0.5,0.1045,0,8,8,8,1,Pagi
1205,2011-02-23,0,2,6,0,3,1,1,0.12,0.1515,0.5,0.1045,0,36,36,36,1,Pagi
1206,2011-02-23,0,2,7,0,3,1,1,0.12,0.1515,0.54,0.1343,2,94,96,96,1,Siang
1207,2011-02-23,0,2,8,0,3,1,1,0.14,0.1515,0.54,0.1642,8,227,235,235,1,Siang
1208,2011-02-23,0,2,9,0,3,1,1,0.18,0.2121,0.51,0.0896,9,130,139,139,1,Siang
1209,2011-02-23,0,2,10,0,3,1,1,0.2,0.2576,0.4,0.0,4,47,51,51,1,Siang
1210,2011-02-23,0,2,11,0,3,1,1,0.24,0.2576,0.41,0.1045,16,53,69,69,1,Siang
1211,2011-02-23,0,2,12,0,3,1,1,0.26,0.2879,0.35,0.0896,11,56,67,67,1,Siang
1212,2011-02-23,0,2,13,0,3,1,1,0.3,0.3182,0.28,0.0896,9,78,87,87,1,Sore
1213,2011-02-23,0,2,14,0,3,1,1,0.32,0.3333,0.29,0.1045,17,61,78,78,1,Sore
1214,2011-02-23,0,2,15,0,3,1,1,0.34,0.3485,0.25,0.0896,18,54,72,72,1,Sore
1215,2011-02-23,0,2,16,0,3,1,1,0.34,0.3636,0.25,0.0,15,79,94,94,1,Sore
1216,2011-02-23,0,2,17,0,3,1,1,0.34,0.3485,0.25,0.0896,15,207,222,222,1,Sore
1217,2011-02-23,0,2,18,0,3,1,1,0.32,0.3333,0.26,0.0896,3,206,209,209,1,Sore
1218,2011-02-23,0,2,19,0,3,1,1,0.3,0.3333,0.33,0.0,6,135,141,141,1,Malam
1219,2011-02-23,0,2,20,0,3,1,1,0.24,0.2424,0.6,0.1642,2,107,109,109,1,Malam
1220,2011-02-23,0,2,21,0,3,1,1,0.24,0.2879,0.48,0.0,2,89,91,91,1,Malam
1221,2011-02-23,0,2,22,0,3,1,1,0.24,0.2879,0.48,0.0,1,60,61,61,1,Malam
1222,2011-02-23,0,2,23,0,3,1,1,0.22,0.2576,0.55,0.0896,1,38,39,39,1,Malam
1223,2011-02-24,0,2,0,0,4,1,1,0.22,0.2576,0.55,0.0896,0,11,11,11,1,
1224,2011-02-24,0,2,1,0,4,1,1,0.22,0.2576,0.6,0.0896,0,7,7,7,1,Pagi
1225,2011-02-24,0,2,2,0,4,1,1,0.2,0.2273,0.64,0.0896,0,4,4,4,1,Pagi
1226,2011-02-24,0,2,3,0,4,1,1,0.2,0.2121,0.64,0.1343,0,2,2,2,1,Pagi
1227,2011-02-24,0,2,5,0,4,1,1,0.2,0.2121,0.69,0.1343,1,3,4,4,1,Pagi
1228,2011-02-24,0,2,6,0,4,1,1,0.2,0.197,0.69,0.194,0,58,58,58,1,Pagi
1229,2011-02-24,0,2,7,0,4,1,1,0.2,0.197,0.72,0.194,0,104,104,104,1,Siang
1230,2011-02-24,0,2,8,0,4,1,1,0.24,0.2273,0.7,0.2239,8,244,252,252,1,Siang
1231,2011-02-24,0,2,9,0,4,1,2,0.24,0.2121,0.75,0.2985,4,133,137,137,1,Siang
1232,2011-02-24,0,2,10,0,4,1,2,0.26,0.2424,0.7,0.2836,8,49,57,57,1,Siang
1233,2011-02-24,0,2,11,0,4,1,2,0.32,0.2879,0.57,0.3881,8,71,79,79,1,Siang
1234,2011-02-24,0,2,12,0,4,1,2,0.36,0.3333,0.53,0.3582,10,85,95,95,1,Siang
1235,2011-02-24,0,2,13,0,4,1,2,0.38,0.3939,0.54,0.2985,16,72,88,88,1,Sore
1236,2011-02-24,0,2,14,0,4,1,2,0.4,0.4091,0.5,0.2985,2,67,69,69,1,Sore
1237,2011-02-24,0,2,15,0,4,1,3,0.4,0.4091,0.54,0.3881,5,58,63,63,1,Sore
1238,2011-02-24,0,2,16,0,4,1,3,0.38,0.3939,0.62,0.2836,4,67,71,71,1,Sore
1239,2011-02-24,0,2,17,0,4,1,3,0.36,0.3485,0.66,0.194,9,168,177,177,1,Sore
1240,2011-02-24,0,2,18,0,4,1,2,0.34,0.303,0.87,0.3284,5,132,137,137,1,Sore
1241,2011-02-24,0,2,19,0,4,1,3,0.34,0.303,0.93,0.2985,3,112,115,115,1,Malam
1242,2011-02-24,0,2,20,0,4,1,2,0.34,0.303,0.93,0.3582,2,87,89,89,1,Malam
1243,2011-02-24,0,2,21,0,4,1,2,0.34,0.303,0.87,0.3284,7,76,83,83,1,Malam
1244,2011-02-24,0,2,22,0,4,1,3,0.34,0.3182,0.87,0.2836,5,50,55,55,1,Malam
1245,2011-02-24,0,2,23,0,4,1,2,0.32,0.303,0.93,0.2239,3,47,50,50,1,Malam
1246,2011-02-25,0,2,0,0,5,1,3,0.32,0.3485,0.93,0.0,1,8,9,9,1,
1247,2011-02-25,0,2,1,0,5,1,2,0.32,0.3485,1.0,0.0,1,9,10,10,1,Pagi
1248,2011-02-25,0,2,2,0,5,1,2,0.32,0.3485,1.0,0.0,0,3,3,3,1,Pagi
1249,2011-02-25,0,2,3,0,5,1,2,0.32,0.3333,0.93,0.1045,1,1,2,2,1,Pagi
1250,2011-02-25,0,2,5,0,5,1,2,0.32,0.3333,0.93,0.1045,1,5,6,6,1,Pagi
1251,2011-02-25,0,2,6,0,5,1,3,0.34,0.3485,0.93,0.0896,0,11,11,11,1,Pagi
1252,2011-02-25,0,2,7,0,5,1,3,0.34,0.3333,1.0,0.1343,1,34,35,35,1,Siang
1253,2011-02-25,0,2,8,0,5,1,3,0.36,0.3485,0.93,0.1343,3,70,73,73,1,Siang
1254,2011-02-25,0,2,9,0,5,1,3,0.34,0.303,0.93,0.3582,3,111,114,114,1,Siang
1255,2011-02-25,0,2,10,0,5,1,3,0.42,0.4242,0.94,0.3284,7,42,49,49,1,Siang
1256,2011-02-25,0,2,11,0,5,1,1,0.52,0.5,0.77,0.4478,9,50,59,59,1,Siang
1257,2011-02-25,0,2,12,0,5,1,3,0.54,0.5152,0.6,0.4627,20,95,115,115,1,Siang
1258,2011-02-25,0,2,13,0,5,1,3,0.54,0.5152,0.6,0.4627,6,77,83,83,1,Sore
1259,2011-02-25,0,2,14,0,5,1,3,0.56,0.5303,0.56,0.6119,14,71,85,85,1,Sore
1260,2011-02-25,0,2,15,0,5,1,1,0.46,0.4545,0.41,0.806,5,50,55,55,1,Sore
1261,2011-02-25,0,2,16,0,5,1,1,0.32,0.2879,0.49,0.4627,11,91,102,102,1,Sore
1262,2011-02-25,0,2,17,0,5,1,1,0.32,0.2727,0.49,0.7463,8,181,189,189,1,Sore
1263,2011-02-25,0,2,18,0,5,1,1,0.32,0.2879,0.49,0.4925,7,150,157,157,1,Sore
1264,2011-02-25,0,2,19,0,5,1,1,0.3,0.2727,0.52,0.4478,4,86,90,90,1,Malam
1265,2011-02-25,0,2,20,0,5,1,1,0.3,0.2576,0.49,0.6119,2,60,62,62,1,Malam
1266,2011-02-25,0,2,21,0,5,1,1,0.28,0.2576,0.48,0.3881,7,56,63,63,1,Malam
1267,2011-02-25,0,2,22,0,5,1,1,0.26,0.2121,0.48,0.4478,7,43,50,50,1,Malam
1268,2011-02-25,0,2,23,0,5,1,1,0.26,0.2273,0.48,0.3284,2,37,39,39,1,Malam
1269,2011-02-26,0,2,0,0,6,0,1,0.24,0.2273,0.52,0.194,3,25,28,28,1,
1270,2011-02-26,0,2,1,0,6,0,1,0.24,0.2121,0.52,0.2985,2,25,27,27,1,Pagi
1271,2011-02-26,0,2,2,0,6,0,1,0.22,0.197,0.6,0.3582,3,9,12,12,1,Pagi
1272,2011-02-26,0,2,3,0,6,0,1,0.22,0.2273,0.55,0.1343,1,7,8,8,1,Pagi
1273,2011-02-26,0,2,4,0,6,0,2,0.22,0.2576,0.6,0.0896,1,1,2,2,1,Pagi
1274,2011-02-26,0,2,5,0,6,0,2,0.22,0.2424,0.64,0.1045,1,9,10,10,1,Pagi
1275,2011-02-26,0,2,6,0,6,0,1,0.22,0.2727,0.6,0.0,1,6,7,7,1,Pagi
1276,2011-02-26,0,2,7,0,6,0,1,0.22,0.2576,0.6,0.0896,1,21,22,22,1,Siang
1277,2011-02-26,0,2,8,0,6,0,2,0.24,0.2879,0.6,0.0,2,55,57,57,1,Siang
1278,2011-02-26,0,2,9,0,6,0,2,0.26,0.2576,0.56,0.1642,9,65,74,74,1,Siang
1279,2011-02-26,0,2,10,0,6,0,2,0.3,0.303,0.49,0.1343,14,71,85,85,1,Siang
1280,2011-02-26,0,2,11,0,6,0,1,0.3,0.3333,0.45,0.0,26,100,126,126,1,Siang
1281,2011-02-26,0,2,12,0,6,0,2,0.32,0.3182,0.45,0.1642,45,115,160,160,1,Siang
1282,2011-02-26,0,2,13,0,6,0,2,0.34,0.3182,0.42,0.2537,38,136,174,174,1,Sore
1283,2011-02-26,0,2,14,0,6,0,2,0.34,0.303,0.36,0.3284,57,154,211,211,1,Sore
1284,2011-02-26,0,2,15,0,6,0,2,0.36,0.3333,0.4,0.2836,40,125,165,165,1,Sore
1285,2011-02-26,0,2,16,0,6,0,1,0.36,0.3333,0.46,0.2836,41,130,171,171,1,Sore
1286,2011-02-26,0,2,17,0,6,0,1,0.36,0.3485,0.43,0.2239,53,130,183,183,1,Sore
1287,2011-02-26,0,2,18,0,6,0,1,0.34,0.3333,0.46,0.194,26,111,137,137,1,Sore
1288,2011-02-26,0,2,19,0,6,0,1,0.32,0.303,0.49,0.2537,30,64,94,94,1,Malam
1289,2011-02-26,0,2,20,0,6,0,1,0.3,0.303,0.56,0.1642,8,60,68,68,1,Malam
1290,2011-02-26,0,2,21,0,6,0,1,0.28,0.2727,0.65,0.2537,9,59,68,68,1,Malam
1291,2011-02-26,0,2,22,0,6,0,1,0.28,0.2727,0.75,0.2239,8,38,46,46,1,Malam
1292,2011-02-26,0,2,23,0,6,0,1,0.28,0.2576,0.75,0.2836,5,29,34,34,1,Malam
1293,2011-02-27,0,2,0,0,0,0,1,0.26,0.2424,0.87,0.2836,8,26,34,34,1,
1294,2011-02-27,0,2,1,0,0,0,1,0.26,0.2576,0.87,0.194,7,30,37,37,1,Pagi
1295,2011-02-27,0,2,2,0,0,0,1,0.26,0.2727,0.87,0.1343,2,20,22,22,1,Pagi
1296,2011-02-27,0,2,3,0,0,0,1,0.26,0.2879,0.87,0.0896,3,8,11,11,1,Pagi
1297,2011-02-27,0,2,4,0,0,0,1,0.24,0.2424,0.87,0.1343,0,2,2,2,1,Pagi
1298,2011-02-27,0,2,6,0,0,0,1,0.24,0.2879,0.87,0.0,2,1,3,3,1,Pagi
1299,2011-02-27,0,2,7,0,0,0,1,0.24,0.2424,0.87,0.1343,6,8,14,14,1,Siang
1300,2011-02-27,0,2,8,0,0,0,1,0.26,0.303,0.87,0.0,9,26,35,35,1,Siang
1301,2011-02-27,0,2,9,0,0,0,1,0.28,0.303,0.87,0.0896,17,42,59,59,1,Siang
1302,2011-02-27,0,2,10,0,0,0,1,0.3,0.303,0.81,0.1642,24,79,103,103,1,Siang
1303,2011-02-27,0,2,11,0,0,0,1,0.36,0.3485,0.62,0.1343,33,92,125,125,1,Siang
1304,2011-02-27,0,2,12,0,0,0,1,0.4,0.4091,0.54,0.0896,61,132,193,193,1,Siang
1305,2011-02-27,0,2,13,0,0,0,1,0.42,0.4242,0.47,0.0,90,169,259,259,1,Sore
1306,2011-02-27,0,2,14,0,0,0,1,0.44,0.4394,0.47,0.0896,105,177,282,282,1,Sore
1307,2011-02-27,0,2,15,0,0,0,1,0.46,0.4545,0.44,0.1343,98,163,261,261,1,Sore
1308,2011-02-27,0,2,16,0,0,0,1,0.48,0.4697,0.44,0.1642,98,170,268,268,1,Sore
1309,2011-02-27,0,2,17,0,0,0,1,0.42,0.4242,0.54,0.194,66,121,187,187,1,Sore
1310,2011-02-27,0,2,18,0,0,0,1,0.4,0.4091,0.54,0.194,24,103,127,127,1,Sore
1311,2011-02-27,0,2,19,0,0,0,1,0.4,0.4091,0.54,0.1343,16,86,102,102,1,Malam
1312,2011-02-27,0,2,20,0,0,0,1,0.4,0.4091,0.54,0.0896,9,72,81,81,1,Malam
1313,2011-02-27,0,2,21,0,0,0,1,0.38,0.3939,0.62,0.1642,8,61,69,69,1,Malam
1314,2011-02-27,0,2,22,0,0,0,2,0.38,0.3939,0.62,0.1045,2,67,69,69,1,Malam
1315,2011-02-27,0,2,23,0,0,0,2,0.36,0.3485,0.62,0.1642,6,53,59,59,1,Malam
1316,2011-02-28,0,2,0,0,1,1,2,0.36,0.3636,0.66,0.1045,5,25,30,30,1,
1317,2011-02-28,0,2,1,0,1,1,3,0.34,0.303,0.87,0.3582,1,7,8,8,1,Pagi
1318,2011-02-28,0,2,3,0,1,1,3,0.32,0.3182,0.93,0.1642,0,1,1,1,1,Pagi
1319,2011-02-28,0,2,5,0,1,1,2,0.34,0.3636,0.93,0.0,1,4,5,5,1,Pagi
1320,2011-02-28,0,2,6,0,1,1,2,0.34,0.3485,0.96,0.1045,1,27,28,28,1,Pagi
1321,2011-02-28,0,2,7,0,1,1,2,0.36,0.3636,0.93,0.1045,2,90,92,92,1,Siang
1322,2011-02-28,0,2,8,0,1,1,2,0.34,0.303,0.93,0.2985,13,242,255,255,1,Siang
1323,2011-02-28,0,2,9,0,1,1,1,0.42,0.4242,0.82,0.2836,15,127,142,142,1,Siang
1324,2011-02-28,0,2,10,0,1,1,2,0.52,0.5,0.72,0.4925,13,79,92,92,1,Siang
1325,2011-02-28,0,2,11,0,1,1,2,0.56,0.5303,0.64,0.2985,13,74,87,87,1,Siang
1326,2011-02-28,0,2,12,0,1,1,2,0.56,0.5303,0.64,0.2985,0,36,36,36,1,Siang
1327,2011-02-28,0,2,13,0,1,1,3,0.46,0.4545,0.94,0.2239,1,31,32,32,1,Sore
1328,2011-02-28,0,2,14,0,1,1,3,0.42,0.4242,1.0,0.2985,1,24,25,25,1,Sore
1329,2011-02-28,0,2,15,0,1,1,3,0.42,0.4242,1.0,0.2985,0,35,35,35,1,Sore
1330,2011-02-28,0,2,16,0,1,1,3,0.42,0.4242,1.0,0.1343,2,40,42,42,1,Sore
1331,2011-02-28,0,2,17,0,1,1,3,0.4,0.4091,1.0,0.2985,2,77,79,79,1,Sore
1332,2011-02-28,0,2,18,0,1,1,3,0.46,0.4545,0.94,0.194,4,127,131,131,1,Sore
1333,2011-02-28,0,2,19,0,1,1,3,0.44,0.4394,0.88,0.6119,1,79,80,80,1,Malam
1334,2011-02-28,0,2,20,0,1,1,3,0.44,0.4394,0.88,0.6119,0,45,45,45,1,Malam
1335,2011-02-28,0,2,21,0,1,1,2,0.38,0.3939,0.87,0.3881,2,78,80,80,1,Malam
1336,2011-02-28,0,2,22,0,1,1,3,0.34,0.303,0.93,0.4179,4,72,76,76,1,Malam
1337,2011-02-28,0,2,23,0,1,1,2,0.32,0.2879,0.81,0.3881,0,45,45,45,1,Malam
1338,2011-03-01,0,3,0,0,2,1,1,0.3,0.2727,0.7,0.4627,0,7,7,7,1,
1339,2011-03-01,0,3,1,0,2,1,1,0.26,0.2273,0.7,0.3582,0,3,3,3,1,Pagi
1340,2011-03-01,0,3,2,0,2,1,1,0.24,0.2121,0.65,0.3881,0,4,4,4,1,Pagi
1341,2011-03-01,0,3,3,0,2,1,1,0.22,0.2121,0.69,0.2836,0,2,2,2,1,Pagi
1342,2011-03-01,0,3,4,0,2,1,1,0.22,0.2121,0.69,0.2537,0,1,1,1,1,Pagi
1343,2011-03-01,0,3,5,0,2,1,1,0.2,0.1818,0.64,0.2836,1,1,2,2,1,Pagi
1344,2011-03-01,0,3,6,0,2,1,1,0.2,0.1818,0.59,0.2985,0,46,46,46,1,Pagi
1345,2011-03-01,0,3,7,0,2,1,1,0.2,0.1818,0.59,0.3284,2,105,107,107,1,Siang
1346,2011-03-01,0,3,8,0,2,1,1,0.2,0.1818,0.59,0.3881,10,204,214,214,1,Siang
1347,2011-03-01,0,3,9,0,2,1,1,0.22,0.197,0.55,0.4179,8,116,124,124,1,Siang
1348,2011-03-01,0,3,10,0,2,1,1,0.24,0.2121,0.52,0.2836,13,55,68,68,1,Siang
1349,2011-03-01,0,3,11,0,2,1,1,0.28,0.2727,0.45,0.2537,8,48,56,56,1,Siang
1350,2011-03-01,0,3,12,0,2,1,1,0.3,0.303,0.39,0.1343,6,80,86,86,1,Siang
1351,2011-03-01,0,3,13,0,2,1,1,0.32,0.3485,0.39,0.0,13,65,78,78,1,Sore
1352,2011-03-01,0,3,14,0,2,1,1,0.32,0.3333,0.36,0.1343,18,61,79,79,1,Sore
1353,2011-03-01,0,3,15,0,2,1,1,0.34,0.3636,0.34,0.0,7,57,64,64,1,Sore
1354,2011-03-01,0,3,16,0,2,1,1,0.34,0.3485,0.34,0.0896,10,92,102,102,1,Sore
1355,2011-03-01,0,3,17,0,2,1,1,0.34,0.3485,0.34,0.0896,12,230,242,242,1,Sore
1356,2011-03-01,0,3,18,0,2,1,1,0.32,0.3182,0.39,0.194,10,214,224,224,1,Sore
1357,2011-03-01,0,3,19,0,2,1,1,0.3,0.303,0.49,0.1343,4,115,119,119,1,Malam
1358,2011-03-01,0,3,20,0,2,1,1,0.3,0.3182,0.61,0.0896,2,86,88,88,1,Malam
1359,2011-03-01,0,3,21,0,2,1,1,0.26,0.303,0.56,0.0,8,55,63,63,1,Malam
1360,2011-03-01,0,3,22,0,2,1,1,0.24,0.2727,0.62,0.1045,3,44,47,47,1,Malam
1361,2011-03-01,0,3,23,0,2,1,1,0.24,0.2273,0.65,0.2239,2,23,25,25,1,Malam
1362,2011-03-02,0,3,0,0,3,1,1,0.22,0.2273,0.69,0.1642,3,5,8,8,1,
1363,2011-03-02,0,3,1,0,3,1,1,0.22,0.2273,0.69,0.194,0,4,4,4,1,Pagi
1364,2011-03-02,0,3,2,0,3,1,1,0.22,0.2273,0.69,0.194,0,2,2,2,1,Pagi
1365,2011-03-02,0,3,3,0,3,1,1,0.22,0.2121,0.69,0.2836,3,1,4,4,1,Pagi
1366,2011-03-02,0,3,4,0,3,1,1,0.2,0.2121,0.75,0.1343,1,0,1,1,1,Pagi
1367,2011-03-02,0,3,5,0,3,1,1,0.22,0.2121,0.69,0.2239,0,5,5,5,1,Pagi
1368,2011-03-02,0,3,6,0,3,1,1,0.22,0.2121,0.55,0.2537,1,39,40,40,1,Pagi
1369,2011-03-02,0,3,7,0,3,1,1,0.22,0.2121,0.64,0.2537,2,108,110,110,1,Siang
1370,2011-03-02,0,3,8,0,3,1,1,0.24,0.2121,0.65,0.2836,13,243,256,256,1,Siang
1371,2011-03-02,0,3,9,0,3,1,1,0.28,0.2576,0.56,0.2985,7,141,148,148,1,Siang
1372,2011-03-02,0,3,10,0,3,1,1,0.32,0.303,0.49,0.2836,11,65,76,76,1,Siang
1373,2011-03-02,0,3,11,0,3,1,1,0.34,0.303,0.53,0.3284,8,65,73,73,1,Siang
1374,2011-03-02,0,3,12,0,3,1,1,0.4,0.4091,0.43,0.194,20,62,82,82,1,Siang
1375,2011-03-02,0,3,13,0,3,1,1,0.5,0.4848,0.25,0.0,35,90,125,125,1,Sore
1376,2011-03-02,0,3,14,0,3,1,1,0.52,0.5,0.23,0.2985,21,75,96,96,1,Sore
1377,2011-03-02,0,3,15,0,3,1,1,0.54,0.5152,0.19,0.4179,19,91,110,110,1,Sore
1378,2011-03-02,0,3,16,0,3,1,1,0.54,0.5152,0.19,0.3284,27,112,139,139,1,Sore
1379,2011-03-02,0,3,17,0,3,1,1,0.5,0.4848,0.23,0.2836,30,238,268,268,1,Sore
1380,2011-03-02,0,3,18,0,3,1,1,0.46,0.4545,0.23,0.4925,8,193,201,201,1,Sore
1381,2011-03-02,0,3,19,0,3,1,1,0.4,0.4091,0.28,0.5224,6,144,150,150,1,Malam
1382,2011-03-02,0,3,20,0,3,1,1,0.36,0.3333,0.29,0.4179,9,86,95,95,1,Malam
1383,2011-03-02,0,3,21,0,3,1,1,0.34,0.2879,0.29,0.4627,3,68,71,71,1,Malam
1384,2011-03-02,0,3,22,0,3,1,1,0.3,0.2576,0.26,0.5522,4,44,48,48,1,Malam
1385,2011-03-02,0,3,23,0,3,1,1,0.26,0.2121,0.3,0.5224,0,22,22,22,1,Malam
1386,2011-03-03,0,3,0,0,4,1,1,0.24,0.197,0.3,0.4627,3,10,13,13,1,
1387,2011-03-03,0,3,1,0,4,1,1,0.24,0.197,0.3,0.4627,0,1,1,1,1,Pagi
1388,2011-03-03,0,3,2,0,4,1,1,0.2,0.1667,0.27,0.4627,1,2,3,3,1,Pagi
1389,2011-03-03,0,3,3,0,4,1,1,0.2,0.1667,0.27,0.4627,0,1,1,1,1,Pagi
1390,2011-03-03,0,3,4,0,4,1,1,0.16,0.1212,0.31,0.4925,0,1,1,1,1,Pagi
1391,2011-03-03,0,3,5,0,4,1,1,0.14,0.1212,0.33,0.2985,1,7,8,8,1,Pagi
1392,2011-03-03,0,3,6,0,4,1,1,0.14,0.1212,0.33,0.2985,1,34,35,35,1,Pagi
1393,2011-03-03,0,3,7,0,4,1,1,0.12,0.0909,0.42,0.4179,1,110,111,111,1,Siang
1394,2011-03-03,0,3,8,0,4,1,1,0.14,0.1212,0.39,0.2985,4,216,220,220,1,Siang
1395,2011-03-03,0,3,9,0,4,1,1,0.16,0.1364,0.37,0.2836,10,135,145,145,1,Siang
1396,2011-03-03,0,3,10,0,4,1,1,0.18,0.1818,0.29,0.194,7,49,56,56,1,Siang
1397,2011-03-03,0,3,11,0,4,1,1,0.2,0.2273,0.29,0.0896,10,40,50,50,1,Siang
1398,2011-03-03,0,3,12,0,4,1,1,0.22,0.2273,0.25,0.1343,7,65,72,72,1,Siang
1399,2011-03-03,0,3,13,0,4,1,1,0.22,0.2576,0.25,0.0896,13,67,80,80,1,Sore
1400,2011-03-03,0,3,14,0,4,1,1,0.24,0.2576,0.21,0.1045,18,60,78,78,1,Sore
1401,2011-03-03,0,3,15,0,4,1,1,0.24,0.2879,0.23,0.0,6,62,68,68,1,Sore
1402,2011-03-03,0,3,16,0,4,1,1,0.26,0.303,0.23,0.0,6,65,71,71,1,Sore
1403,2011-03-03,0,3,17,0,4,1,1,0.26,0.303,0.22,0.0,17,185,202,202,1,Sore
1404,2011-03-03,0,3,18,0,4,1,1,0.24,0.2121,0.35,0.3284,6,161,167,167,1,Sore
1405,2011-03-03,0,3,19,0,4,1,1,0.2,0.197,0.4,0.2537,5,101,106,106,1,Malam
1406,2011-03-03,0,3,20,0,4,1,1,0.2,0.2273,0.4,0.0896,1,69,70,70,1,Malam
1407,2011-03-03,0,3,21,0,4,1,1,0.18,0.2121,0.4,0.1045,3,48,51,51,1,Malam
1408,2011-03-03,0,3,22,0,4,1,1,0.2,0.2576,0.4,0.0,3,50,53,53,1,Malam
1409,2011-03-03,0,3,23,0,4,1,2,0.18,0.2121,0.43,0.0896,0,23,23,23,1,Malam
1410,2011-03-04,0,3,0,0,5,1,2,0.2,0.197,0.55,0.194,0,12,12,12,1,
1411,2011-03-04,0,3,1,0,5,1,2,0.18,0.1818,0.64,0.194,0,4,4,4,1,Pagi
1412,2011-03-04,0,3,2,0,5,1,2,0.18,0.1818,0.64,0.194,0,2,2,2,1,Pagi
1413,2011-03-04,0,3,3,0,5,1,2,0.18,0.1667,0.74,0.2537,0,1,1,1,1,Pagi
1414,2011-03-04,0,3,4,0,5,1,2,0.18,0.1818,0.74,0.194,1,0,1,1,1,Pagi
1415,2011-03-04,0,3,5,0,5,1,2,0.16,0.1818,0.74,0.1343,0,7,7,7,1,Pagi
1416,2011-03-04,0,3,6,0,5,1,2,0.16,0.197,0.74,0.0896,1,28,29,29,1,Pagi
1417,2011-03-04,0,3,7,0,5,1,1,0.16,0.1818,0.8,0.1343,0,83,83,83,1,Siang
1418,2011-03-04,0,3,8,0,5,1,1,0.18,0.197,0.74,0.1343,6,222,228,228,1,Siang
1419,2011-03-04,0,3,9,0,5,1,1,0.22,0.2273,0.6,0.1343,12,138,150,150,1,Siang
1420,2011-03-04,0,3,10,0,5,1,1,0.24,0.2273,0.6,0.2537,10,56,66,66,1,Siang
1421,2011-03-04,0,3,11,0,5,1,1,0.28,0.2727,0.52,0.2239,16,73,89,89,1,Siang
1422,2011-03-04,0,3,12,0,5,1,1,0.32,0.303,0.43,0.1642,10,87,97,97,1,Siang
1423,2011-03-04,0,3,13,0,5,1,1,0.34,0.3182,0.42,0.2239,13,74,87,87,1,Sore
1424,2011-03-04,0,3,14,0,5,1,1,0.36,0.3333,0.4,0.2836,30,65,95,95,1,Sore
1425,2011-03-04,0,3,15,0,5,1,1,0.36,0.3333,0.4,0.2985,31,75,106,106,1,Sore
1426,2011-03-04,0,3,16,0,5,1,1,0.36,0.3485,0.46,0.194,17,101,118,118,1,Sore
1427,2011-03-04,0,3,17,0,5,1,2,0.36,0.3333,0.5,0.2537,22,206,228,228,1,Sore
1428,2011-03-04,0,3,18,0,5,1,2,0.34,0.303,0.53,0.2985,15,172,187,187,1,Sore
1429,2011-03-04,0,3,19,0,5,1,1,0.32,0.303,0.61,0.2537,5,102,107,107,1,Malam
1430,2011-03-04,0,3,20,0,5,1,2,0.3,0.2879,0.7,0.194,9,78,87,87,1,Malam
1431,2011-03-04,0,3,21,0,5,1,2,0.3,0.2879,0.7,0.2239,6,64,70,70,1,Malam
1432,2011-03-04,0,3,22,0,5,1,1,0.3,0.2879,0.7,0.194,4,40,44,44,1,Malam
1433,2011-03-04,0,3,23,0,5,1,2,0.3,0.303,0.75,0.1642,6,40,46,46,1,Malam
1434,2011-03-05,0,3,0,0,6,0,2,0.28,0.2879,0.81,0.1045,4,15,19,19,1,
1435,2011-03-05,0,3,1,0,6,0,2,0.3,0.3182,0.81,0.1045,5,20,25,25,1,Pagi
1436,2011-03-05,0,3,2,0,6,0,2,0.3,0.2879,0.87,0.194,5,15,20,20,1,Pagi
1437,2011-03-05,0,3,3,0,6,0,2,0.3,0.2879,0.87,0.194,0,2,2,2,1,Pagi
1438,2011-03-05,0,3,4,0,6,0,2,0.3,0.303,0.93,0.1642,0,1,1,1,1,Pagi
1439,2011-03-05,0,3,5,0,6,0,2,0.3,0.303,1.0,0.1343,0,3,3,3,1,Pagi
1440,2011-03-05,0,3,6,0,6,0,2,0.3,0.2879,1.0,0.2239,1,3,4,4,1,Pagi
1441,2011-03-05,0,3,7,0,6,0,2,0.3,0.2727,1.0,0.2985,5,10,15,15,1,Siang
1442,2011-03-05,0,3,8,0,6,0,2,0.3,0.2727,1.0,0.2985,11,34,45,45,1,Siang
1443,2011-03-05,0,3,9,0,6,0,2,0.32,0.303,0.93,0.2239,15,48,63,63,1,Siang
1444,2011-03-05,0,3,10,0,6,0,2,0.34,0.3333,0.93,0.194,34,69,103,103,1,Siang
1445,2011-03-05,0,3,11,0,6,0,2,0.4,0.4091,0.76,0.2239,43,116,159,159,1,Siang
1446,2011-03-05,0,3,12,0,6,0,2,0.44,0.4394,0.67,0.2537,46,121,167,167,1,Siang
1447,2011-03-05,0,3,13,0,6,0,2,0.46,0.4545,0.67,0.2836,60,130,190,190,1,Sore
1448,2011-03-05,0,3,14,0,6,0,2,0.48,0.4697,0.59,0.2836,80,118,198,198,1,Sore
1449,2011-03-05,0,3,15,0,6,0,2,0.46,0.4545,0.63,0.2985,83,122,205,205,1,Sore
1450,2011-03-05,0,3,16,0,6,0,2,0.48,0.4697,0.59,0.2985,74,130,204,204,1,Sore
1451,2011-03-05,0,3,17,0,6,0,2,0.48,0.4697,0.59,0.3582,60,104,164,164,1,Sore
1452,2011-03-05,0,3,18,0,6,0,2,0.48,0.4697,0.59,0.3284,37,115,152,152,1,Sore
1453,2011-03-05,0,3,19,0,6,0,2,0.46,0.4545,0.67,0.3284,27,62,89,89,1,Malam
1454,2011-03-05,0,3,20,0,6,0,2,0.44,0.4394,0.77,0.3284,12,58,70,70,1,Malam
1455,2011-03-05,0,3,21,0,6,0,2,0.44,0.4394,0.72,0.3284,12,60,72,72,1,Malam
1456,2011-03-05,0,3,22,0,6,0,2,0.42,0.4242,0.77,0.2985,16,47,63,63,1,Malam
1457,2011-03-05,0,3,23,0,6,0,2,0.44,0.4394,0.77,0.2985,10,34,44,44,1,Malam
1458,2011-03-06,0,3,0,0,0,0,2,0.42,0.4242,0.77,0.3582,11,41,52,52,1,
1459,2011-03-06,0,3,1,0,0,0,2,0.42,0.4242,0.77,0.2836,12,27,39,39,1,Pagi
1460,2011-03-06,0,3,2,0,0,0,2,0.4,0.4091,0.82,0.2836,5,27,32,32,1,Pagi
1461,2011-03-06,0,3,3,0,0,0,2,0.42,0.4242,0.82,0.2985,2,9,11,11,1,Pagi
1462,2011-03-06,0,3,4,0,0,0,2,0.42,0.4242,0.88,0.3582,0,3,3,3,1,Pagi
1463,2011-03-06,0,3,6,0,0,0,2,0.42,0.4242,0.94,0.3582,1,1,2,2,1,Pagi
1464,2011-03-06,0,3,7,0,0,0,3,0.42,0.4242,1.0,0.4478,0,5,5,5,1,Siang
1465,2011-03-06,0,3,8,0,0,0,2,0.4,0.4091,1.0,0.2985,1,8,9,9,1,Siang
1466,2011-03-06,0,3,9,0,0,0,2,0.42,0.4242,1.0,0.2836,4,18,22,22,1,Siang
1467,2011-03-06,0,3,10,0,0,0,2,0.42,0.4242,1.0,0.2985,4,27,31,31,1,Siang
1468,2011-03-06,0,3,11,0,0,0,2,0.42,0.4242,1.0,0.2239,18,44,62,62,1,Siang
1469,2011-03-06,0,3,12,0,0,0,2,0.46,0.4545,0.94,0.3284,10,69,79,79,1,Siang
1470,2011-03-06,0,3,13,0,0,0,2,0.46,0.4545,0.94,0.3582,22,83,105,105,1,Sore
1471,2011-03-06,0,3,14,0,0,0,3,0.44,0.4394,1.0,0.2239,12,27,39,39,1,Sore
1472,2011-03-06,0,3,15,0,0,0,3,0.44,0.4394,1.0,0.2239,3,4,7,7,1,Sore
1473,2011-03-06,0,3,16,0,0,0,3,0.36,0.3333,1.0,0.2836,3,8,11,11,1,Sore
1474,2011-03-06,0,3,17,0,0,0,3,0.34,0.303,1.0,0.2985,2,23,25,25,1,Sore
1475,2011-03-06,0,3,18,0,0,0,3,0.32,0.2879,1.0,0.3582,0,23,23,23,1,Sore
1476,2011-03-06,0,3,19,0,0,0,3,0.3,0.2576,1.0,0.4925,0,11,11,11,1,Malam
1477,2011-03-06,0,3,20,0,0,0,3,0.28,0.2424,1.0,0.4179,3,8,11,11,1,Malam
1478,2011-03-06,0,3,21,0,0,0,3,0.24,0.1818,0.93,0.6119,1,6,7,7,1,Malam
1479,2011-03-06,0,3,22,0,0,0,2,0.22,0.197,1.0,0.3881,0,10,10,10,1,Malam
1480,2011-03-06,0,3,23,0,0,0,2,0.22,0.197,1.0,0.4179,0,9,9,9,1,Malam
1481,2011-03-07,0,3,0,0,1,1,3,0.2,0.1818,1.0,0.3284,0,4,4,4,1,
1482,2011-03-07,0,3,1,0,1,1,3,0.2,0.1818,1.0,0.3284,0,2,2,2,1,Pagi
1483,2011-03-07,0,3,3,0,1,1,1,0.2,0.1515,0.8,0.5821,0,1,1,1,1,Pagi
1484,2011-03-07,0,3,4,0,1,1,1,0.2,0.1515,0.8,0.5224,1,0,1,1,1,Pagi
1485,2011-03-07,0,3,5,0,1,1,1,0.2,0.1818,0.75,0.3582,0,1,1,1,1,Pagi
1486,2011-03-07,0,3,6,0,1,1,1,0.2,0.1818,0.75,0.3881,3,31,34,34,1,Pagi
1487,2011-03-07,0,3,7,0,1,1,1,0.2,0.1667,0.75,0.4179,3,88,91,91,1,Siang
1488,2011-03-07,0,3,8,0,1,1,1,0.2,0.1818,0.75,0.3881,11,200,211,211,1,Siang
1489,2011-03-07,0,3,9,0,1,1,1,0.22,0.1818,0.64,0.4627,5,129,134,134,1,Siang
1490,2011-03-07,0,3,10,0,1,1,1,0.24,0.2121,0.6,0.2985,15,43,58,58,1,Siang
1491,2011-03-07,0,3,11,0,1,1,1,0.26,0.2121,0.48,0.4478,19,41,60,60,1,Siang
1492,2011-03-07,0,3,12,0,1,1,1,0.3,0.2727,0.42,0.4179,28,68,96,96,1,Siang
1493,2011-03-07,0,3,13,0,1,1,1,0.32,0.2879,0.36,0.3881,16,54,70,70,1,Sore
1494,2011-03-07,0,3,14,0,1,1,1,0.32,0.2879,0.36,0.4179,21,56,77,77,1,Sore
1495,2011-03-07,0,3,15,0,1,1,1,0.34,0.303,0.31,0.3881,32,64,96,96,1,Sore
1496,2011-03-07,0,3,16,0,1,1,1,0.34,0.303,0.31,0.3582,26,96,122,122,1,Sore
1497,2011-03-07,0,3,17,0,1,1,1,0.34,0.303,0.29,0.3582,27,206,233,233,1,Sore
1498,2011-03-07,0,3,18,0,1,1,1,0.32,0.303,0.31,0.2239,19,214,233,233,1,Sore
1499,2011-03-07,0,3,19,0,1,1,1,0.3,0.2879,0.33,0.2239,11,134,145,145,1,Malam
1500,2011-03-07,0,3,20,0,1,1,1,0.3,0.303,0.33,0.1642,5,87,92,92,1,Malam
1501,2011-03-07,0,3,21,0,1,1,1,0.28,0.2727,0.38,0.2239,1,53,54,54,1,Malam
1502,2011-03-07,0,3,22,0,1,1,1,0.26,0.2576,0.48,0.1642,1,34,35,35,1,Malam
1503,2011-03-07,0,3,23,0,1,1,1,0.28,0.3182,0.48,0.0,0,22,22,22,1,Malam
1504,2011-03-08,0,3,0,0,2,1,1,0.26,0.2879,0.48,0.0896,1,9,10,10,1,
1505,2011-03-08,0,3,1,0,2,1,1,0.24,0.2424,0.52,0.1343,0,4,4,4,1,Pagi
1506,2011-03-08,0,3,2,0,2,1,1,0.24,0.2424,0.52,0.1343,1,0,1,1,1,Pagi
1507,2011-03-08,0,3,3,0,2,1,1,0.24,0.2576,0.52,0.0896,5,2,7,7,1,Pagi
1508,2011-03-08,0,3,4,0,2,1,1,0.22,0.2727,0.64,0.0,0,2,2,2,1,Pagi
1509,2011-03-08,0,3,5,0,2,1,1,0.2,0.2273,0.69,0.1045,2,8,10,10,1,Pagi
1510,2011-03-08,0,3,6,0,2,1,1,0.2,0.2576,0.59,0.0,3,42,45,45,1,Pagi
1511,2011-03-08,0,3,7,0,2,1,1,0.18,0.197,0.64,0.1343,9,119,128,128,1,Siang
1512,2011-03-08,0,3,8,0,2,1,1,0.22,0.2273,0.55,0.194,10,247,257,257,1,Siang
1513,2011-03-08,0,3,9,0,2,1,1,0.26,0.2576,0.41,0.1642,11,140,151,151,1,Siang
1514,2011-03-08,0,3,10,0,2,1,2,0.3,0.2879,0.33,0.194,25,46,71,71,1,Siang
1515,2011-03-08,0,3,11,0,2,1,2,0.36,0.3485,0.25,0.1642,26,52,78,78,1,Siang
1516,2011-03-08,0,3,12,0,2,1,2,0.36,0.3788,0.23,0.0,29,70,99,99,1,Siang
1517,2011-03-08,0,3,13,0,2,1,2,0.38,0.3939,0.25,0.1045,25,73,98,98,1,Sore
1518,2011-03-08,0,3,14,0,2,1,2,0.38,0.3939,0.2,0.0,16,56,72,72,1,Sore
1519,2011-03-08,0,3,15,0,2,1,2,0.36,0.3788,0.18,0.0,35,77,112,112,1,Sore
1520,2011-03-08,0,3,16,0,2,1,1,0.38,0.3939,0.27,0.1642,26,82,108,108,1,Sore
1521,2011-03-08,0,3,17,0,2,1,1,0.36,0.3485,0.27,0.2239,39,209,248,248,1,Sore
1522,2011-03-08,0,3,18,0,2,1,1,0.34,0.3333,0.27,0.194,21,214,235,235,1,Sore
1523,2011-03-08,0,3,19,0,2,1,1,0.34,0.3485,0.31,0.1045,9,141,150,150,1,Malam
1524,2011-03-08,0,3,20,0,2,1,1,0.32,0.3333,0.39,0.0896,2,74,76,76,1,Malam
1525,2011-03-08,0,3,21,0,2,1,1,0.3,0.2879,0.49,0.194,7,68,75,75,1,Malam
1526,2011-03-08,0,3,22,0,2,1,1,0.3,0.2879,0.49,0.2239,11,44,55,55,1,Malam
1527,2011-03-08,0,3,23,0,2,1,1,0.28,0.2727,0.61,0.194,3,38,41,41,1,Malam
1528,2011-03-09,0,3,0,0,3,1,1,0.26,0.2879,0.65,0.0896,0,9,9,9,1,
1529,2011-03-09,0,3,1,0,3,1,1,0.26,0.2727,0.52,0.1343,0,4,4,4,1,Pagi
1530,2011-03-09,0,3,2,0,3,1,1,0.26,0.2727,0.52,0.1343,1,1,2,2,1,Pagi
1531,2011-03-09,0,3,3,0,3,1,1,0.24,0.2576,0.7,0.0896,1,2,3,3,1,Pagi
1532,2011-03-09,0,3,4,0,3,1,1,0.24,0.2576,0.75,0.1045,0,2,2,2,1,Pagi
1533,2011-03-09,0,3,5,0,3,1,2,0.24,0.2424,0.81,0.1343,1,7,8,8,1,Pagi
1534,2011-03-09,0,3,6,0,3,1,2,0.24,0.2576,0.85,0.1045,5,44,49,49,1,Pagi
1535,2011-03-09,0,3,7,0,3,1,2,0.24,0.2424,0.87,0.1642,18,123,141,141,1,Siang
1536,2011-03-09,0,3,8,0,3,1,2,0.24,0.2424,0.87,0.1343,11,238,249,249,1,Siang
1537,2011-03-09,0,3,9,0,3,1,2,0.26,0.2424,0.87,0.2537,5,136,141,141,1,Siang
1538,2011-03-09,0,3,10,0,3,1,2,0.3,0.2879,0.75,0.2537,8,49,57,57,1,Siang
1539,2011-03-09,0,3,11,0,3,1,2,0.32,0.2879,0.76,0.3881,15,44,59,59,1,Siang
1540,2011-03-09,0,3,12,0,3,1,2,0.32,0.303,0.76,0.2537,14,84,98,98,1,Siang
1541,2011-03-09,0,3,13,0,3,1,2,0.32,0.2879,0.76,0.3582,17,82,99,99,1,Sore
1542,2011-03-09,0,3,14,0,3,1,2,0.34,0.303,0.76,0.2985,10,61,71,71,1,Sore
1543,2011-03-09,0,3,15,0,3,1,2,0.36,0.3333,0.71,0.2985,15,64,79,79,1,Sore
1544,2011-03-09,0,3,16,0,3,1,2,0.34,0.303,0.76,0.3284,10,102,112,112,1,Sore
1545,2011-03-09,0,3,17,0,3,1,2,0.34,0.303,0.76,0.2985,18,176,194,194,1,Sore
1546,2011-03-09,0,3,18,0,3,1,2,0.34,0.3182,0.76,0.2537,12,176,188,188,1,Sore
1547,2011-03-09,0,3,19,0,3,1,2,0.34,0.303,0.76,0.3284,11,123,134,134,1,Malam
1548,2011-03-09,0,3,20,0,3,1,2,0.32,0.3182,0.87,0.194,4,87,91,91,1,Malam
1549,2011-03-09,0,3,21,0,3,1,2,0.32,0.303,0.93,0.3284,10,52,62,62,1,Malam
1550,2011-03-09,0,3,22,0,3,1,3,0.32,0.3182,0.93,0.1642,4,17,21,21,1,Malam
1551,2011-03-09,0,3,23,0,3,1,3,0.34,0.3333,0.93,0.194,1,17,18,18,1,Malam
1552,2011-03-10,0,3,0,0,4,1,3,0.34,0.3182,0.0,0.2537,3,0,3,3,1,
1553,2011-03-10,0,3,1,0,4,1,3,0.34,0.3182,0.0,0.2537,0,2,2,2,1,Pagi
1554,2011-03-10,0,3,2,0,4,1,3,0.34,0.3182,0.0,0.2537,0,1,1,1,1,Pagi
1555,2011-03-10,0,3,5,0,4,1,3,0.36,0.3485,0.0,0.194,1,2,3,3,1,Pagi
1556,2011-03-10,0,3,6,0,4,1,3,0.36,0.3333,0.0,0.3284,0,12,12,12,1,Pagi
1557,2011-03-10,0,3,7,0,4,1,3,0.38,0.3939,0.0,0.2239,1,36,37,37,1,Siang
1558,2011-03-10,0,3,8,0,4,1,3,0.38,0.3939,0.0,0.2836,1,43,44,44,1,Siang
1559,2011-03-10,0,3,9,0,4,1,3,0.4,0.4091,0.0,0.2239,1,23,24,24,1,Siang
1560,2011-03-10,0,3,10,0,4,1,3,0.4,0.4091,0.0,0.1642,0,17,17,17,1,Siang
1561,2011-03-10,0,3,11,0,4,1,3,0.4,0.4091,0.0,0.2537,6,5,11,11,1,Siang
1562,2011-03-10,0,3,12,0,4,1,3,0.42,0.4242,0.0,0.2239,4,30,34,34,1,Siang
1563,2011-03-10,0,3,13,0,4,1,3,0.42,0.4242,0.0,0.2239,1,11,12,12,1,Sore
1564,2011-03-10,0,3,14,0,4,1,3,0.44,0.4394,0.0,0.2985,0,12,12,12,1,Sore
1565,2011-03-10,0,3,15,0,4,1,3,0.44,0.4394,0.0,0.2239,3,11,14,14,1,Sore
1566,2011-03-10,0,3,16,0,4,1,3,0.42,0.4242,0.0,0.2537,1,20,21,21,1,Sore
1567,2011-03-10,0,3,17,0,4,1,2,0.44,0.4394,0.0,0.3881,2,109,111,111,1,Sore
1568,2011-03-10,0,3,18,0,4,1,3,0.44,0.4394,0.0,0.3582,2,80,82,82,1,Sore
1569,2011-03-10,0,3,19,0,4,1,3,0.44,0.4394,0.0,0.5821,5,51,56,56,1,Malam
1570,2011-03-10,0,3,20,0,4,1,3,0.36,0.3333,0.0,0.3284,9,29,38,38,1,Malam
1571,2011-03-10,0,3,21,0,4,1,3,0.36,0.3485,0.0,0.2239,1,27,28,28,1,Malam
1572,2011-03-10,0,3,22,0,4,1,2,0.34,0.3333,0.0,0.1343,4,30,34,34,1,Malam
1573,2011-03-10,0,3,23,0,4,1,3,0.34,0.3485,0.0,0.0896,1,26,27,27,1,Malam
1574,2011-03-11,0,3,0,0,5,1,2,0.34,0.3485,1.0,0.0896,0,6,6,6,1,
1575,2011-03-11,0,3,1,0,5,1,3,0.34,0.3485,1.0,0.1045,0,8,8,8,1,Pagi
1576,2011-03-11,0,3,2,0,5,1,3,0.34,0.3485,1.0,0.1045,2,3,5,5,1,Pagi
1577,2011-03-11,0,3,3,0,5,1,2,0.32,0.3333,0.93,0.0896,0,2,2,2,1,Pagi
1578,2011-03-11,0,3,5,0,5,1,1,0.3,0.2879,0.81,0.2239,1,6,7,7,1,Pagi
1579,2011-03-11,0,3,6,0,5,1,1,0.26,0.2424,0.81,0.2836,1,31,32,32,1,Pagi
1580,2011-03-11,0,3,7,0,5,1,1,0.26,0.2576,0.7,0.194,10,104,114,114,1,Siang
1581,2011-03-11,0,3,8,0,5,1,1,0.28,0.2727,0.7,0.2537,15,244,259,259,1,Siang
1582,2011-03-11,0,3,9,0,5,1,2,0.3,0.2879,0.61,0.2836,13,143,156,156,1,Siang
1583,2011-03-11,0,3,10,0,5,1,2,0.32,0.303,0.57,0.2985,18,60,78,78,1,Siang
1584,2011-03-11,0,3,11,0,5,1,2,0.32,0.303,0.57,0.2985,14,67,81,81,1,Siang
1585,2011-03-11,0,3,12,0,5,1,2,0.34,0.3182,0.53,0.2537,15,96,111,111,1,Siang
1586,2011-03-11,0,3,13,0,5,1,1,0.36,0.3333,0.53,0.2537,15,92,107,107,1,Sore
1587,2011-03-11,0,3,14,0,5,1,2,0.36,0.3333,0.5,0.3582,25,64,89,89,1,Sore
1588,2011-03-11,0,3,15,0,5,1,2,0.34,0.3182,0.53,0.2537,21,64,85,85,1,Sore
1589,2011-03-11,0,3,16,0,5,1,2,0.34,0.303,0.49,0.2985,18,95,113,113,1,Sore
1590,2011-03-11,0,3,17,0,5,1,1,0.34,0.3182,0.49,0.2239,23,200,223,223,1,Sore
1591,2011-03-11,0,3,18,0,5,1,1,0.32,0.303,0.49,0.3284,19,134,153,153,1,Sore
1592,2011-03-11,0,3,19,0,5,1,1,0.3,0.2727,0.56,0.3284,7,111,118,118,1,Malam
1593,2011-03-11,0,3,20,0,5,1,1,0.3,0.303,0.56,0.1642,6,70,76,76,1,Malam
1594,2011-03-11,0,3,21,0,5,1,2,0.3,0.2879,0.52,0.2537,10,43,53,53,1,Malam
1595,2011-03-11,0,3,22,0,5,1,1,0.3,0.303,0.52,0.1642,11,53,64,64,1,Malam
1596,2011-03-11,0,3,23,0,5,1,1,0.3,0.2879,0.52,0.2537,3,34,37,37,1,Malam
1597,2011-03-12,0,3,0,0,6,0,1,0.26,0.2727,0.6,0.1343,4,30,34,34,1,
1598,2011-03-12,0,3,1,0,6,0,1,0.24,0.2273,0.65,0.194,3,15,18,18,1,Pagi
1599,2011-03-12,0,3,2,0,6,0,1,0.24,0.2273,0.65,0.194,0,14,14,14,1,Pagi
1600,2011-03-12,0,3,3,0,6,0,1,0.24,0.2273,0.65,0.2537,1,6,7,7,1,Pagi
1601,2011-03-12,0,3,4,0,6,0,1,0.24,0.2273,0.65,0.2537,0,1,1,1,1,Pagi
1602,2011-03-12,0,3,5,0,6,0,1,0.22,0.2273,0.69,0.194,0,2,2,2,1,Pagi
1603,2011-03-12,0,3,6,0,6,0,1,0.22,0.2121,0.75,0.2537,2,2,4,4,1,Pagi
1604,2011-03-12,0,3,7,0,6,0,1,0.24,0.2273,0.7,0.194,4,19,23,23,1,Siang
1605,2011-03-12,0,3,8,0,6,0,1,0.26,0.2576,0.65,0.1642,9,44,53,53,1,Siang
1606,2011-03-12,0,3,9,0,6,0,1,0.28,0.2879,0.65,0.1045,25,76,101,101,1,Siang
1607,2011-03-12,0,3,10,0,6,0,1,0.32,0.303,0.66,0.2239,21,78,99,99,1,Siang
1608,2011-03-12,0,3,11,0,6,0,1,0.34,0.303,0.49,0.3284,36,83,119,119,1,Siang
1609,2011-03-12,0,3,12,0,6,0,1,0.34,0.3182,0.53,0.2836,51,107,158,158,1,Siang
1610,2011-03-12,0,3,13,0,6,0,1,0.36,0.3333,0.51,0.3582,62,95,157,157,1,Sore
1611,2011-03-12,0,3,14,0,6,0,1,0.4,0.4091,0.5,0.4478,70,96,166,166,1,Sore
1612,2011-03-12,0,3,15,0,6,0,1,0.42,0.4242,0.44,0.4925,81,101,182,182,1,Sore
1613,2011-03-12,0,3,16,0,6,0,1,0.46,0.4545,0.41,0.4478,100,144,244,244,1,Sore
1614,2011-03-12,0,3,17,0,6,0,1,0.46,0.4545,0.44,0.3284,99,114,213,213,1,Sore
1615,2011-03-12,0,3,18,0,6,0,1,0.42,0.4242,0.54,0.1642,54,91,145,145,1,Sore
1616,2011-03-12,0,3,19,0,6,0,1,0.42,0.4242,0.54,0.0896,26,86,112,112,1,Malam
1617,2011-03-12,0,3,20,0,6,0,1,0.4,0.4091,0.58,0.1045,22,64,86,86,1,Malam
1618,2011-03-12,0,3,21,0,6,0,1,0.38,0.3939,0.62,0.0,36,46,82,82,1,Malam
1619,2011-03-12,0,3,22,0,6,0,1,0.36,0.3788,0.71,0.0,7,56,63,63,1,Malam
1620,2011-03-12,0,3,23,0,6,0,1,0.38,0.3939,0.66,0.0896,11,38,49,49,1,Malam
1621,2011-03-13,0,3,0,0,0,0,1,0.38,0.3939,0.62,0.1045,3,35,38,38,1,
1622,2011-03-13,0,3,1,0,0,0,1,0.36,0.3485,0.66,0.1343,10,23,33,33,1,Pagi
1623,2011-03-13,0,3,3,0,0,0,1,0.34,0.3333,0.76,0.1343,6,17,23,23,1,Pagi
1624,2011-03-13,0,3,4,0,0,0,1,0.34,0.3333,0.66,0.1642,4,9,13,13,1,Pagi
1625,2011-03-13,0,3,5,0,0,0,1,0.36,0.3485,0.62,0.1343,0,3,3,3,1,Pagi
1626,2011-03-13,0,3,6,0,0,0,1,0.34,0.3636,0.66,0.0,0,2,2,2,1,Pagi
1627,2011-03-13,0,3,7,0,0,0,1,0.36,0.3485,0.62,0.194,2,8,10,10,1,Siang
1628,2011-03-13,0,3,8,0,0,0,1,0.4,0.4091,0.5,0.2985,11,23,34,34,1,Siang
1629,2011-03-13,0,3,9,0,0,0,1,0.4,0.4091,0.5,0.4179,8,36,44,44,1,Siang
1630,2011-03-13,0,3,10,0,0,0,1,0.42,0.4242,0.47,0.2537,36,86,122,122,1,Siang
1631,2011-03-13,0,3,11,0,0,0,1,0.44,0.4394,0.41,0.4179,88,93,181,181,1,Siang
1632,2011-03-13,0,3,12,0,0,0,1,0.46,0.4545,0.38,0.3881,74,120,194,194,1,Siang
1633,2011-03-13,0,3,13,0,0,0,1,0.46,0.4545,0.38,0.3881,97,124,221,221,1,Sore
1634,2011-03-13,0,3,14,0,0,0,1,0.46,0.4545,0.41,0.2985,144,106,250,250,1,Sore
1635,2011-03-13,0,3,15,0,0,0,1,0.48,0.4697,0.39,0.3284,149,155,304,304,1,Sore
1636,2011-03-13,0,3,16,0,0,0,1,0.46,0.4545,0.41,0.3881,124,132,256,256,1,Sore
1637,2011-03-13,0,3,17,0,0,0,1,0.44,0.4394,0.41,0.3582,98,143,241,241,1,Sore
1638,2011-03-13,0,3,18,0,0,0,1,0.4,0.4091,0.43,0.3582,55,92,147,147,1,Sore
1639,2011-03-13,0,3,19,0,0,0,1,0.36,0.3333,0.5,0.3582,28,73,101,101,1,Malam
1640,2011-03-13,0,3,20,0,0,0,1,0.32,0.303,0.57,0.2985,23,54,77,77,1,Malam
1641,2011-03-13,0,3,21,0,0,0,1,0.3,0.2879,0.56,0.2537,9,49,58,58,1,Malam
1642,2011-03-13,0,3,22,0,0,0,1,0.3,0.2727,0.56,0.3284,8,29,37,37,1,Malam
1643,2011-03-13,0,3,23,0,0,0,1,0.26,0.2576,0.65,0.2239,5,23,28,28,1,Malam
1644,2011-03-14,0,3,0,0,1,1,1,0.26,0.2727,0.65,0.1045,4,7,11,11,1,
1645,2011-03-14,0,3,1,0,1,1,1,0.26,0.2879,0.65,0.0896,0,1,1,1,1,Pagi
1646,2011-03-14,0,3,2,0,1,1,1,0.26,0.2879,0.65,0.0896,0,1,1,1,1,Pagi
1647,2011-03-14,0,3,3,0,1,1,1,0.26,0.2727,0.65,0.1343,0,3,3,3,1,Pagi
1648,2011-03-14,0,3,5,0,1,1,1,0.24,0.2424,0.7,0.1343,0,8,8,8,1,Pagi
1649,2011-03-14,0,3,6,0,1,1,1,0.26,0.2727,0.65,0.1343,1,27,28,28,1,Pagi
1650,2011-03-14,0,3,7,0,1,1,2,0.28,0.3182,0.61,0.0,4,84,88,88,1,Siang
1651,2011-03-14,0,3,8,0,1,1,2,0.3,0.303,0.56,0.1343,24,217,241,241,1,Siang
1652,2011-03-14,0,3,9,0,1,1,1,0.32,0.303,0.53,0.3284,13,127,140,140,1,Siang
1653,2011-03-14,0,3,10,0,1,1,1,0.34,0.3182,0.42,0.2537,27,57,84,84,1,Siang
1654,2011-03-14,0,3,11,0,1,1,1,0.36,0.3333,0.4,0.2537,26,45,71,71,1,Siang
1655,2011-03-14,0,3,12,0,1,1,1,0.38,0.3939,0.37,0.0,40,54,94,94,1,Siang
1656,2011-03-14,0,3,13,0,1,1,1,0.38,0.3939,0.36,0.3284,24,51,75,75,1,Sore
1657,2011-03-14,0,3,14,0,1,1,2,0.38,0.3939,0.34,0.0,27,52,79,79,1,Sore
1658,2011-03-14,0,3,15,0,1,1,1,0.38,0.3939,0.37,0.1642,24,77,101,101,1,Sore
1659,2011-03-14,0,3,16,0,1,1,1,0.4,0.4091,0.35,0.1045,27,80,107,107,1,Sore
1660,2011-03-14,0,3,17,0,1,1,1,0.38,0.3939,0.4,0.194,42,229,271,271,1,Sore
1661,2011-03-14,0,3,18,0,1,1,1,0.36,0.3636,0.4,0.1045,25,210,235,235,1,Sore
1662,2011-03-14,0,3,19,0,1,1,1,0.36,0.3485,0.43,0.1343,17,133,150,150,1,Malam
1663,2011-03-14,0,3,20,0,1,1,1,0.34,0.3182,0.46,0.2239,23,106,129,129,1,Malam
1664,2011-03-14,0,3,21,0,1,1,1,0.34,0.3333,0.46,0.1343,5,58,63,63,1,Malam
1665,2011-03-14,0,3,22,0,1,1,1,0.32,0.3333,0.49,0.1045,4,43,47,47,1,Malam
1666,2011-03-14,0,3,23,0,1,1,1,0.32,0.3485,0.53,0.0,2,17,19,19,1,Malam
1667,2011-03-15,0,3,0,0,2,1,1,0.32,0.3485,0.53,0.0,7,7,14,14,1,
1668,2011-03-15,0,3,1,0,2,1,1,0.3,0.303,0.62,0.0896,4,6,10,10,1,Pagi
1669,2011-03-15,0,3,2,0,2,1,1,0.3,0.303,0.62,0.0896,1,2,3,3,1,Pagi
1670,2011-03-15,0,3,4,0,2,1,1,0.24,0.2576,0.75,0.0896,1,1,2,2,1,Pagi
1671,2011-03-15,0,3,5,0,2,1,1,0.24,0.2273,0.75,0.194,0,11,11,11,1,Pagi
1672,2011-03-15,0,3,6,0,2,1,1,0.22,0.2273,0.8,0.194,3,32,35,35,1,Pagi
1673,2011-03-15,0,3,7,0,2,1,1,0.24,0.2424,0.75,0.1642,10,109,119,119,1,Siang
1674,2011-03-15,0,3,8,0,2,1,1,0.26,0.2879,0.7,0.0896,23,259,282,282,1,Siang
1675,2011-03-15,0,3,9,0,2,1,2,0.3,0.3333,0.7,0.0,10,147,157,157,1,Siang
1676,2011-03-15,0,3,10,0,2,1,2,0.32,0.3182,0.66,0.194,22,56,78,78,1,Siang
1677,2011-03-15,0,3,11,0,2,1,2,0.34,0.3182,0.57,0.2239,27,51,78,78,1,Siang
1678,2011-03-15,0,3,12,0,2,1,2,0.36,0.3485,0.5,0.2239,32,70,102,102,1,Siang
1679,2011-03-15,0,3,13,0,2,1,2,0.36,0.3333,0.57,0.2836,23,74,97,97,1,Sore
1680,2011-03-15,0,3,14,0,2,1,2,0.38,0.3939,0.46,0.2985,14,74,88,88,1,Sore
1681,2011-03-15,0,3,15,0,2,1,2,0.38,0.3939,0.43,0.2836,24,66,90,90,1,Sore
1682,2011-03-15,0,3,16,0,2,1,2,0.38,0.3939,0.46,0.3284,21,93,114,114,1,Sore
1683,2011-03-15,0,3,17,0,2,1,2,0.36,0.3485,0.62,0.194,22,195,217,217,1,Sore
1684,2011-03-15,0,3,18,0,2,1,2,0.36,0.3333,0.62,0.2985,18,207,225,225,1,Sore
1685,2011-03-15,0,3,19,0,2,1,2,0.34,0.3182,0.71,0.2836,14,138,152,152,1,Malam
1686,2011-03-15,0,3,20,0,2,1,2,0.34,0.3182,0.71,0.2836,9,79,88,88,1,Malam
1687,2011-03-15,0,3,21,0,2,1,3,0.32,0.3333,0.81,0.1045,2,53,55,55,1,Malam
1688,2011-03-15,0,3,22,0,2,1,2,0.32,0.3182,0.87,0.1642,1,20,21,21,1,Malam
1689,2011-03-15,0,3,23,0,2,1,2,0.32,0.3182,0.87,0.1642,1,17,18,18,1,Malam
1690,2011-03-16,0,3,0,0,3,1,3,0.3,0.2879,0.93,0.2537,0,8,8,8,1,
1691,2011-03-16,0,3,1,0,3,1,3,0.3,0.2727,1.0,0.2985,1,2,3,3,1,Pagi
1692,2011-03-16,0,3,3,0,3,1,2,0.28,0.2727,1.0,0.2239,1,2,3,3,1,Pagi
1693,2011-03-16,0,3,4,0,3,1,2,0.3,0.303,0.93,0.1642,0,1,1,1,1,Pagi
1694,2011-03-16,0,3,5,0,3,1,2,0.3,0.3182,0.93,0.1045,0,3,3,3,1,Pagi
1695,2011-03-16,0,3,6,0,3,1,2,0.3,0.3182,0.93,0.1045,1,30,31,31,1,Pagi
1696,2011-03-16,0,3,7,0,3,1,2,0.3,0.2879,0.93,0.194,10,101,111,111,1,Siang
1697,2011-03-16,0,3,8,0,3,1,2,0.32,0.3182,0.93,0.0,26,227,253,253,1,Siang
1698,2011-03-16,0,3,9,0,3,1,2,0.32,0.3333,0.93,0.1343,10,144,154,154,1,Siang
1699,2011-03-16,0,3,10,0,3,1,2,0.36,0.3485,0.81,0.1642,19,49,68,68,1,Siang
1700,2011-03-16,0,3,11,0,3,1,2,0.36,0.3485,0.81,0.1343,13,62,75,75,1,Siang
1701,2011-03-16,0,3,12,0,3,1,2,0.4,0.4091,0.71,0.1045,23,65,88,88,1,Siang
1702,2011-03-16,0,3,13,0,3,1,2,0.4,0.4091,0.76,0.1343,18,81,99,99,1,Sore
1703,2011-03-16,0,3,14,0,3,1,2,0.4,0.4091,0.76,0.2239,33,67,100,100,1,Sore
1704,2011-03-16,0,3,15,0,3,1,2,0.4,0.4091,0.76,0.2537,22,79,101,101,1,Sore
1705,2011-03-16,0,3,16,0,3,1,2,0.4,0.4091,0.76,0.1642,30,121,151,151,1,Sore
1706,2011-03-16,0,3,17,0,3,1,2,0.44,0.4394,0.54,0.2985,37,216,253,253,1,Sore
1707,2011-03-16,0,3,18,0,3,1,2,0.44,0.4394,0.54,0.2239,26,211,237,237,1,Sore
1708,2011-03-16,0,3,19,0,3,1,2,0.44,0.4394,0.51,0.3284,18,150,168,168,1,Malam
1709,2011-03-16,0,3,20,0,3,1,2,0.42,0.4242,0.54,0.2985,10,111,121,121,1,Malam
1710,2011-03-16,0,3,21,0,3,1,2,0.42,0.4242,0.58,0.2836,3,75,78,78,1,Malam
1711,2011-03-16,0,3,22,0,3,1,2,0.4,0.4091,0.62,0.3881,11,48,59,59,1,Malam
1712,2011-03-16,0,3,23,0,3,1,1,0.4,0.4091,0.65,0.194,9,18,27,27,1,Malam
1713,2011-03-17,0,3,0,0,4,1,1,0.38,0.3939,0.66,0.2537,4,19,23,23,1,
1714,2011-03-17,0,3,1,0,4,1,1,0.36,0.3485,0.71,0.2239,1,11,12,12,1,Pagi
1715,2011-03-17,0,3,2,0,4,1,1,0.34,0.303,0.71,0.2985,3,5,8,8,1,Pagi
1716,2011-03-17,0,3,3,0,4,1,1,0.34,0.3333,0.66,0.1642,1,1,2,2,1,Pagi
1717,2011-03-17,0,3,4,0,4,1,1,0.34,0.3333,0.71,0.194,0,3,3,3,1,Pagi
1718,2011-03-17,0,3,5,0,4,1,1,0.32,0.3333,0.76,0.1045,0,13,13,13,1,Pagi
1719,2011-03-17,0,3,6,0,4,1,1,0.32,0.3182,0.76,0.194,4,47,51,51,1,Pagi
1720,2011-03-17,0,3,7,0,4,1,1,0.32,0.3333,0.76,0.1343,12,128,140,140,1,Siang
1721,2011-03-17,0,3,8,0,4,1,1,0.36,0.3485,0.66,0.1343,17,282,299,299,1,Siang
1722,2011-03-17,0,3,9,0,4,1,1,0.4,0.4091,0.62,0.2537,23,162,185,185,1,Siang
1723,2011-03-17,0,3,10,0,4,1,1,0.44,0.4394,0.54,0.3284,9,69,78,78,1,Siang
1724,2011-03-17,0,3,11,0,4,1,1,0.44,0.4394,0.54,0.2836,20,66,86,86,1,Siang
1725,2011-03-17,0,3,12,0,4,1,1,0.5,0.4848,0.45,0.2239,24,81,105,105,1,Siang
1726,2011-03-17,0,3,13,0,4,1,2,0.52,0.5,0.42,0.0896,26,85,111,111,1,Sore
1727,2011-03-17,0,3,14,0,4,1,1,0.5,0.4848,0.45,0.1045,32,87,119,119,1,Sore
1728,2011-03-17,0,3,15,0,4,1,1,0.52,0.5,0.42,0.2537,30,95,125,125,1,Sore
1729,2011-03-17,0,3,16,0,4,1,1,0.5,0.4848,0.48,0.2836,34,108,142,142,1,Sore
1730,2011-03-17,0,3,17,0,4,1,1,0.5,0.4848,0.42,0.194,48,265,313,313,1,Sore
1731,2011-03-17,0,3,18,0,4,1,2,0.46,0.4545,0.59,0.1642,50,260,310,310,1,Sore
1732,2011-03-17,0,3,19,0,4,1,1,0.44,0.4394,0.58,0.194,18,189,207,207,1,Malam
1733,2011-03-17,0,3,20,0,4,1,1,0.42,0.4242,0.67,0.2239,25,112,137,137,1,Malam
1734,2011-03-17,0,3,21,0,4,1,1,0.42,0.4242,0.62,0.2239,19,119,138,138,1,Malam
1735,2011-03-17,0,3,22,0,4,1,1,0.4,0.4091,0.66,0.2239,17,70,87,87,1,Malam
1736,2011-03-17,0,3,23,0,4,1,1,0.42,0.4242,0.62,0.2836,7,43,50,50,1,Malam
1737,2011-03-18,0,3,0,0,5,1,1,0.42,0.4242,0.58,0.2836,5,24,29,29,1,
1738,2011-03-18,0,3,1,0,5,1,1,0.4,0.4091,0.62,0.2537,4,12,16,16,1,Pagi
1739,2011-03-18,0,3,2,0,5,1,1,0.4,0.4091,0.62,0.194,5,9,14,14,1,Pagi
1740,2011-03-18,0,3,3,0,5,1,1,0.36,0.3485,0.71,0.194,1,4,5,5,1,Pagi
1741,2011-03-18,0,3,5,0,5,1,1,0.38,0.3939,0.66,0.1642,2,8,10,10,1,Pagi
1742,2011-03-18,0,3,6,0,5,1,1,0.4,0.4091,0.66,0.194,1,35,36,36,1,Pagi
1743,2011-03-18,0,3,7,0,5,1,1,0.4,0.4091,0.66,0.194,11,112,123,123,1,Siang
1744,2011-03-18,0,3,8,0,5,1,1,0.42,0.4242,0.67,0.2537,24,256,280,280,1,Siang
1745,2011-03-18,0,3,9,0,5,1,1,0.46,0.4545,0.63,0.2239,18,192,210,210,1,Siang
1746,2011-03-18,0,3,10,0,5,1,1,0.52,0.5,0.53,0.2836,43,74,117,117,1,Siang
1747,2011-03-18,0,3,11,0,5,1,1,0.54,0.5152,0.52,0.2836,55,104,159,159,1,Siang
1748,2011-03-18,0,3,12,0,5,1,2,0.56,0.5303,0.49,0.3582,72,123,195,195,1,Siang
1749,2011-03-18,0,3,13,0,5,1,1,0.64,0.6212,0.41,0.2836,57,118,175,175,1,Sore
1750,2011-03-18,0,3,14,0,5,1,1,0.66,0.6212,0.39,0.2537,71,103,174,174,1,Sore
1751,2011-03-18,0,3,15,0,5,1,2,0.68,0.6364,0.39,0.3582,62,111,173,173,1,Sore
1752,2011-03-18,0,3,16,0,5,1,1,0.68,0.6364,0.39,0.2836,67,137,204,204,1,Sore
1753,2011-03-18,0,3,17,0,5,1,1,0.7,0.6364,0.37,0.3284,95,237,332,332,1,Sore
1754,2011-03-18,0,3,18,0,5,1,1,0.68,0.6364,0.39,0.1642,84,247,331,331,1,Sore
1755,2011-03-18,0,3,19,0,5,1,1,0.66,0.6212,0.44,0.1343,58,132,190,190,1,Malam
1756,2011-03-18,0,3,20,0,5,1,1,0.62,0.6212,0.46,0.1343,46,103,149,149,1,Malam
1757,2011-03-18,0,3,21,0,5,1,1,0.62,0.6212,0.46,0.1045,22,91,113,113,1,Malam
1758,2011-03-18,0,3,22,0,5,1,1,0.62,0.6212,0.5,0.1642,55,63,118,118,1,Malam
1759,2011-03-18,0,3,23,0,5,1,2,0.6,0.6212,0.53,0.2239,26,60,86,86,1,Malam
1760,2011-03-19,0,3,0,0,6,0,2,0.6,0.6212,0.53,0.2537,26,50,76,76,1,
1761,2011-03-19,0,3,1,0,6,0,2,0.58,0.5455,0.46,0.3582,16,35,51,51,1,Pagi
1762,2011-03-19,0,3,2,0,6,0,2,0.56,0.5303,0.43,0.2239,5,20,25,25,1,Pagi
1763,2011-03-19,0,3,3,0,6,0,2,0.54,0.5152,0.39,0.3284,1,7,8,8,1,Pagi
1764,2011-03-19,0,3,4,0,6,0,1,0.52,0.5,0.34,0.4179,1,2,3,3,1,Pagi
1765,2011-03-19,0,3,5,0,6,0,1,0.52,0.5,0.34,0.4179,0,2,2,2,1,Pagi
1766,2011-03-19,0,3,6,0,6,0,1,0.44,0.4394,0.44,0.4179,0,10,10,10,1,Pagi
1767,2011-03-19,0,3,7,0,6,0,1,0.4,0.4091,0.5,0.3284,4,9,13,13,1,Siang
1768,2011-03-19,0,3,8,0,6,0,1,0.42,0.4242,0.47,0.4925,11,37,48,48,1,Siang
1769,2011-03-19,0,3,9,0,6,0,1,0.42,0.4242,0.44,0.4627,35,41,76,76,1,Siang
1770,2011-03-19,0,3,10,0,6,0,1,0.44,0.4394,0.38,0.4179,55,85,140,140,1,Siang
1771,2011-03-19,0,3,11,0,6,0,1,0.46,0.4545,0.36,0.4478,90,106,196,196,1,Siang
1772,2011-03-19,0,3,12,0,6,0,1,0.46,0.4545,0.33,0.4179,126,141,267,267,1,Siang
1773,2011-03-19,0,3,13,0,6,0,1,0.5,0.4848,0.34,0.4627,174,127,301,301,1,Sore
1774,2011-03-19,0,3,14,0,6,0,1,0.5,0.4848,0.31,0.4925,168,144,312,312,1,Sore
1775,2011-03-19,0,3,15,0,6,0,1,0.5,0.4848,0.29,0.4179,170,143,313,313,1,Sore
1776,2011-03-19,0,3,16,0,6,0,1,0.5,0.4848,0.31,0.3881,175,129,304,304,1,Sore
1777,2011-03-19,0,3,17,0,6,0,1,0.48,0.4697,0.31,0.3284,138,140,278,278,1,Sore
1778,2011-03-19,0,3,18,0,6,0,1,0.46,0.4545,0.31,0.3284,92,125,217,217,1,Sore
1779,2011-03-19,0,3,19,0,6,0,1,0.44,0.4394,0.33,0.2836,38,116,154,154,1,Malam
1780,2011-03-19,0,3,20,0,6,0,1,0.42,0.4242,0.35,0.2239,39,69,108,108,1,Malam
1781,2011-03-19,0,3,21,0,6,0,1,0.4,0.4091,0.37,0.2985,20,73,93,93,1,Malam
1782,2011-03-19,0,3,22,0,6,0,1,0.4,0.4091,0.37,0.3284,27,45,72,72,1,Malam
1783,2011-03-19,0,3,23,0,6,0,1,0.38,0.3939,0.4,0.2985,13,37,50,50,1,Malam
1784,2011-03-20,0,3,0,0,0,0,1,0.34,0.303,0.49,0.4179,7,33,40,40,1,
1785,2011-03-20,0,3,1,0,0,0,1,0.32,0.2879,0.53,0.3582,2,22,24,24,1,Pagi
1786,2011-03-20,0,3,2,0,0,0,1,0.3,0.2879,0.52,0.2836,6,24,30,30,1,Pagi
1787,2011-03-20,0,3,3,0,0,0,1,0.28,0.2727,0.56,0.2537,1,11,12,12,1,Pagi
1788,2011-03-20,0,3,4,0,0,0,1,0.26,0.2576,0.56,0.2239,2,1,3,3,1,Pagi
1789,2011-03-20,0,3,5,0,0,0,1,0.26,0.2576,0.6,0.194,3,6,9,9,1,Pagi
1790,2011-03-20,0,3,6,0,0,0,1,0.26,0.2576,0.6,0.2239,1,3,4,4,1,Pagi
1791,2011-03-20,0,3,7,0,0,0,1,0.24,0.2273,0.6,0.2239,5,9,14,14,1,Siang
1792,2011-03-20,0,3,8,0,0,0,1,0.28,0.2727,0.56,0.1642,7,30,37,37,1,Siang
1793,2011-03-20,0,3,9,0,0,0,1,0.3,0.303,0.52,0.1343,35,43,78,78,1,Siang
1794,2011-03-20,0,3,10,0,0,0,2,0.32,0.3485,0.45,0.0,55,81,136,136,1,Siang
1795,2011-03-20,0,3,11,0,0,0,1,0.34,0.3485,0.39,0.1045,92,111,203,203,1,Siang
1796,2011-03-20,0,3,12,0,0,0,1,0.36,0.3636,0.4,0.1045,120,108,228,228,1,Siang
1797,2011-03-20,0,3,13,0,0,0,1,0.38,0.3939,0.34,0.0,88,115,203,203,1,Sore
1798,2011-03-20,0,3,14,0,0,0,1,0.4,0.4091,0.3,0.0,145,134,279,279,1,Sore
1799,2011-03-20,0,3,15,0,0,0,1,0.4,0.4091,0.32,0.0896,172,136,308,308,1,Sore
1800,2011-03-20,0,3,16,0,0,0,1,0.42,0.4242,0.32,0.0,92,132,224,224,1,Sore
1801,2011-03-20,0,3,17,0,0,0,1,0.4,0.4091,0.35,0.2836,83,143,226,226,1,Sore
1802,2011-03-20,0,3,18,0,0,0,1,0.38,0.3939,0.4,0.3582,58,98,156,156,1,Sore
1803,2011-03-20,0,3,19,0,0,0,1,0.36,0.3333,0.43,0.2836,21,58,79,79,1,Malam
1804,2011-03-20,0,3,20,0,0,0,1,0.36,0.3333,0.46,0.2836,21,46,67,67,1,Malam
1805,2011-03-20,0,3,21,0,0,0,2,0.34,0.3182,0.53,0.2836,10,39,49,49,1,Malam
1806,2011-03-20,0,3,22,0,0,0,2,0.34,0.303,0.53,0.3284,8,30,38,38,1,Malam
1807,2011-03-20,0,3,23,0,0,0,3,0.34,0.303,0.61,0.3881,13,11,24,24,1,Malam
1808,2011-03-21,0,3,0,0,1,1,3,0.34,0.303,0.66,0.3881,2,11,13,13,2,
1809,2011-03-21,0,3,1,0,1,1,2,0.34,0.303,0.71,0.3881,1,6,7,7,2,Pagi
1810,2011-03-21,0,3,2,0,1,1,2,0.34,0.303,0.71,0.3284,1,5,6,6,2,Pagi
1811,2011-03-21,0,3,3,0,1,1,2,0.34,0.303,0.71,0.3284,0,1,1,1,2,Pagi
1812,2011-03-21,0,3,5,0,1,1,1,0.32,0.303,0.81,0.2985,1,1,2,2,2,Pagi
1813,2011-03-21,0,3,6,0,1,1,3,0.32,0.303,0.76,0.2537,2,30,32,32,2,Pagi
1814,2011-03-21,0,3,7,0,1,1,3,0.3,0.2727,0.87,0.4179,3,15,18,18,2,Siang
1815,2011-03-21,0,3,8,0,1,1,2,0.3,0.2727,0.87,0.4179,3,95,98,98,2,Siang
1816,2011-03-21,0,3,9,0,1,1,2,0.34,0.303,0.81,0.3284,12,115,127,127,2,Siang
1817,2011-03-21,0,3,10,0,1,1,2,0.38,0.3939,0.76,0.3881,17,45,62,62,2,Siang
1818,2011-03-21,0,3,11,0,1,1,2,0.42,0.4242,0.71,0.2985,32,47,79,79,2,Siang
1819,2011-03-21,0,3,12,0,1,1,2,0.44,0.4394,0.77,0.2537,25,56,81,81,2,Siang
1820,2011-03-21,0,3,13,0,1,1,2,0.5,0.4848,0.63,0.2239,35,77,112,112,2,Sore
1821,2011-03-21,0,3,14,0,1,1,2,0.54,0.5152,0.64,0.2239,36,65,101,101,2,Sore
1822,2011-03-21,0,3,15,0,1,1,2,0.56,0.5303,0.6,0.2239,41,66,107,107,2,Sore
1823,2011-03-21,0,3,16,0,1,1,2,0.54,0.5152,0.64,0.2836,29,112,141,141,2,Sore
1824,2011-03-21,0,3,17,0,1,1,2,0.54,0.5152,0.64,0.2537,41,231,272,272,2,Sore
1825,2011-03-21,0,3,18,0,1,1,2,0.52,0.5,0.72,0.2239,44,232,276,276,2,Sore
1826,2011-03-21,0,3,19,0,1,1,1,0.58,0.5455,0.6,0.4179,22,199,221,221,2,Malam
1827,2011-03-21,0,3,20,0,1,1,1,0.56,0.5303,0.64,0.194,16,106,122,122,2,Malam
1828,2011-03-21,0,3,21,0,1,1,1,0.46,0.4545,0.94,0.194,12,79,91,91,2,Malam
1829,2011-03-21,0,3,22,0,1,1,1,0.46,0.4545,0.88,0.2239,18,60,78,78,2,Malam
1830,2011-03-21,0,3,23,0,1,1,1,0.46,0.4545,0.88,0.0896,8,22,30,30,2,Malam
1831,2011-03-22,0,3,0,0,2,1,1,0.46,0.4545,0.88,0.194,4,7,11,11,2,
1832,2011-03-22,0,3,1,0,2,1,1,0.42,0.4242,1.0,0.1343,6,13,19,19,2,Pagi
1833,2011-03-22,0,3,2,0,2,1,1,0.44,0.4394,0.94,0.0896,0,1,1,1,2,Pagi
1834,2011-03-22,0,3,3,0,2,1,1,0.44,0.4394,0.82,0.2239,3,2,5,5,2,Pagi
1835,2011-03-22,0,3,4,0,2,1,2,0.42,0.4242,0.82,0.1642,0,1,1,1,2,Pagi
1836,2011-03-22,0,3,5,0,2,1,2,0.4,0.4091,0.87,0.1343,1,11,12,12,2,Pagi
1837,2011-03-22,0,3,6,0,2,1,1,0.4,0.4091,0.87,0.2537,2,58,60,60,2,Pagi
1838,2011-03-22,0,3,7,0,2,1,2,0.4,0.4091,0.76,0.1045,4,132,136,136,2,Siang
1839,2011-03-22,0,3,8,0,2,1,2,0.4,0.4091,0.58,0.2985,24,312,336,336,2,Siang
1840,2011-03-22,0,3,9,0,2,1,2,0.4,0.4091,0.58,0.4627,19,159,178,178,2,Siang
1841,2011-03-22,0,3,10,0,2,1,2,0.44,0.4394,0.54,0.2985,29,95,124,124,2,Siang
1842,2011-03-22,0,3,11,0,2,1,1,0.44,0.4394,0.51,0.3284,22,64,86,86,2,Siang
1843,2011-03-22,0,3,12,0,2,1,1,0.46,0.4545,0.47,0.2537,35,86,121,121,2,Siang
1844,2011-03-22,0,3,13,0,2,1,1,0.5,0.4848,0.45,0.2239,21,85,106,106,2,Sore
1845,2011-03-22,0,3,14,0,2,1,1,0.5,0.4848,0.42,0.3284,30,71,101,101,2,Sore
1846,2011-03-22,0,3,15,0,2,1,1,0.5,0.4848,0.42,0.2239,55,79,134,134,2,Sore
1847,2011-03-22,0,3,16,0,2,1,1,0.5,0.4848,0.42,0.1045,40,125,165,165,2,Sore
1848,2011-03-22,0,3,17,0,2,1,1,0.5,0.4848,0.42,0.1045,42,265,307,307,2,Sore
1849,2011-03-22,0,3,18,0,2,1,1,0.48,0.4697,0.44,0.0896,41,271,312,312,2,Sore
1850,2011-03-22,0,3,19,0,2,1,2,0.44,0.4394,0.54,0.2537,22,142,164,164,2,Malam
1851,2011-03-22,0,3,20,0,2,1,2,0.44,0.4394,0.54,0.3582,19,116,135,135,2,Malam
1852,2011-03-22,0,3,21,0,2,1,2,0.42,0.4242,0.54,0.2836,24,63,87,87,2,Malam
1853,2011-03-22,0,3,22,0,2,1,2,0.4,0.4091,0.58,0.2537,13,57,70,70,2,Malam
1854,2011-03-22,0,3,23,0,2,1,2,0.4,0.4091,0.58,0.2537,4,28,32,32,2,Malam
1855,2011-03-23,0,3,0,0,3,1,3,0.36,0.3485,0.71,0.2239,3,8,11,11,2,
1856,2011-03-23,0,3,1,0,3,1,3,0.34,0.3182,0.76,0.2239,0,7,7,7,2,Pagi
1857,2011-03-23,0,3,2,0,3,1,3,0.34,0.3182,0.76,0.2239,1,1,2,2,2,Pagi
1858,2011-03-23,0,3,3,0,3,1,2,0.34,0.3182,0.76,0.2537,0,3,3,3,2,Pagi
1859,2011-03-23,0,3,5,0,3,1,3,0.32,0.3182,0.87,0.194,0,10,10,10,2,Pagi
1860,2011-03-23,0,3,6,0,3,1,2,0.34,0.3182,0.87,0.2537,1,43,44,44,2,Pagi
1861,2011-03-23,0,3,7,0,3,1,2,0.32,0.303,0.93,0.2239,7,111,118,118,2,Siang
1862,2011-03-23,0,3,8,0,3,1,2,0.32,0.3182,0.87,0.194,14,247,261,261,2,Siang
1863,2011-03-23,0,3,9,0,3,1,2,0.32,0.303,0.81,0.2537,8,174,182,182,2,Siang
1864,2011-03-23,0,3,10,0,3,1,2,0.34,0.3182,0.81,0.2836,15,60,75,75,2,Siang
1865,2011-03-23,0,3,11,0,3,1,2,0.34,0.3333,0.87,0.194,18,53,71,71,2,Siang
1866,2011-03-23,0,3,12,0,3,1,2,0.34,0.3182,0.87,0.2239,14,73,87,87,2,Siang
1867,2011-03-23,0,3,13,0,3,1,3,0.34,0.3333,0.87,0.1343,14,94,108,108,2,Sore
1868,2011-03-23,0,3,14,0,3,1,2,0.36,0.3636,0.87,0.1045,13,71,84,84,2,Sore
1869,2011-03-23,0,3,15,0,3,1,2,0.38,0.3939,0.82,0.2239,11,74,85,85,2,Sore
1870,2011-03-23,0,3,16,0,3,1,2,0.4,0.4091,0.76,0.2239,13,123,136,136,2,Sore
1871,2011-03-23,0,3,17,0,3,1,2,0.4,0.4091,0.76,0.2239,28,245,273,273,2,Sore
1872,2011-03-23,0,3,18,0,3,1,3,0.38,0.3939,0.82,0.2537,20,218,238,238,2,Sore
1873,2011-03-23,0,3,19,0,3,1,3,0.38,0.3939,0.82,0.2537,12,147,159,159,2,Malam
1874,2011-03-23,0,3,20,0,3,1,3,0.36,0.303,0.87,0.6418,3,72,75,75,2,Malam
1875,2011-03-23,0,3,21,0,3,1,3,0.32,0.2879,1.0,0.4179,0,22,22,22,2,Malam
1876,2011-03-23,0,3,22,0,3,1,2,0.32,0.3182,0.93,0.1642,6,38,44,44,2,Malam
1877,2011-03-23,0,3,23,0,3,1,3,0.32,0.3333,0.9,0.0,2,24,26,26,2,Malam
1878,2011-03-24,0,3,0,0,4,1,2,0.32,0.303,0.93,0.2239,0,11,11,11,2,
1879,2011-03-24,0,3,1,0,4,1,2,0.3,0.2879,1.0,0.2239,0,3,3,3,2,Pagi
1880,2011-03-24,0,3,2,0,4,1,2,0.3,0.2879,1.0,0.2537,0,6,6,6,2,Pagi
1881,2011-03-24,0,3,3,0,4,1,2,0.28,0.2727,1.0,0.194,1,0,1,1,2,Pagi
1882,2011-03-24,0,3,4,0,4,1,2,0.28,0.2727,1.0,0.194,0,1,1,1,2,Pagi
1883,2011-03-24,0,3,5,0,4,1,2,0.28,0.2727,0.93,0.2239,1,8,9,9,2,Pagi
1884,2011-03-24,0,3,6,0,4,1,2,0.28,0.2727,0.93,0.2239,0,41,41,41,2,Pagi
1885,2011-03-24,0,3,7,0,4,1,3,0.26,0.2576,1.0,0.2239,2,106,108,108,2,Siang
1886,2011-03-24,0,3,8,0,4,1,3,0.26,0.2273,1.0,0.2985,4,120,124,124,2,Siang
1887,2011-03-24,0,3,9,0,4,1,2,0.26,0.2576,0.93,0.2239,3,94,97,97,2,Siang
1888,2011-03-24,0,3,10,0,4,1,2,0.26,0.2273,0.93,0.3284,10,55,65,65,2,Siang
1889,2011-03-24,0,3,11,0,4,1,2,0.3,0.2727,0.81,0.2985,10,61,71,71,2,Siang
1890,2011-03-24,0,3,12,0,4,1,2,0.3,0.2727,0.7,0.3284,12,82,94,94,2,Siang
1891,2011-03-24,0,3,13,0,4,1,2,0.32,0.303,0.7,0.2239,11,90,101,101,2,Sore
1892,2011-03-24,0,3,14,0,4,1,2,0.3,0.303,0.7,0.1343,17,66,83,83,2,Sore
1893,2011-03-24,0,3,15,0,4,1,2,0.3,0.2879,0.7,0.2537,13,77,90,90,2,Sore
1894,2011-03-24,0,3,16,0,4,1,2,0.3,0.2879,0.65,0.2239,6,78,84,84,2,Sore
1895,2011-03-24,0,3,17,0,4,1,2,0.3,0.2879,0.7,0.2239,12,221,233,233,2,Sore
1896,2011-03-24,0,3,18,0,4,1,2,0.3,0.2727,0.61,0.2985,17,197,214,214,2,Sore
1897,2011-03-24,0,3,19,0,4,1,1,0.3,0.2727,0.56,0.3881,16,122,138,138,2,Malam
1898,2011-03-24,0,3,20,0,4,1,1,0.28,0.2576,0.61,0.2836,8,110,118,118,2,Malam
1899,2011-03-24,0,3,21,0,4,1,1,0.26,0.2576,0.65,0.2239,11,67,78,78,2,Malam
1900,2011-03-24,0,3,22,0,4,1,1,0.26,0.2576,0.65,0.1642,3,59,62,62,2,Malam
1901,2011-03-24,0,3,23,0,4,1,1,0.24,0.2273,0.65,0.194,9,24,33,33,2,Malam
1902,2011-03-25,0,3,0,0,5,1,1,0.24,0.2273,0.6,0.194,1,17,18,18,2,
1903,2011-03-25,0,3,1,0,5,1,1,0.2,0.2121,0.69,0.1642,0,5,5,5,2,Pagi
1904,2011-03-25,0,3,2,0,5,1,1,0.2,0.197,0.69,0.2239,0,5,5,5,2,Pagi
1905,2011-03-25,0,3,3,0,5,1,1,0.2,0.2273,0.69,0.1045,0,2,2,2,2,Pagi
1906,2011-03-25,0,3,4,0,5,1,1,0.18,0.2121,0.74,0.1045,3,2,5,5,2,Pagi
1907,2011-03-25,0,3,5,0,5,1,1,0.18,0.197,0.74,0.1642,0,9,9,9,2,Pagi
1908,2011-03-25,0,3,6,0,5,1,1,0.18,0.1818,0.74,0.2239,0,32,32,32,2,Pagi
1909,2011-03-25,0,3,7,0,5,1,1,0.2,0.1818,0.59,0.3582,4,100,104,104,2,Siang
1910,2011-03-25,0,3,8,0,5,1,1,0.22,0.2121,0.51,0.2836,9,228,237,237,2,Siang
1911,2011-03-25,0,3,9,0,5,1,1,0.24,0.2121,0.48,0.2985,16,150,166,166,2,Siang
1912,2011-03-25,0,3,10,0,5,1,1,0.26,0.2576,0.48,0.0,15,53,68,68,2,Siang
1913,2011-03-25,0,3,11,0,5,1,1,0.3,0.2879,0.45,0.2836,17,58,75,75,2,Siang
1914,2011-03-25,0,3,12,0,5,1,1,0.32,0.303,0.42,0.2537,37,108,145,145,2,Siang
1915,2011-03-25,0,3,13,0,5,1,1,0.32,0.3182,0.39,0.194,34,104,138,138,2,Sore
1916,2011-03-25,0,3,14,0,5,1,1,0.36,0.3333,0.32,0.3284,30,103,133,133,2,Sore
1917,2011-03-25,0,3,15,0,5,1,2,0.34,0.3182,0.36,0.2537,43,79,122,122,2,Sore
1918,2011-03-25,0,3,16,0,5,1,2,0.34,0.303,0.34,0.2985,23,127,150,150,2,Sore
1919,2011-03-25,0,3,17,0,5,1,2,0.32,0.2879,0.36,0.3582,23,202,225,225,2,Sore
1920,2011-03-25,0,3,18,0,5,1,1,0.3,0.2879,0.39,0.2537,8,190,198,198,2,Sore
1921,2011-03-25,0,3,19,0,5,1,2,0.3,0.2879,0.36,0.2836,9,126,135,135,2,Malam
1922,2011-03-25,0,3,20,0,5,1,2,0.3,0.303,0.39,0.1343,6,75,81,81,2,Malam
1923,2011-03-25,0,3,21,0,5,1,2,0.3,0.303,0.39,0.1642,11,64,75,75,2,Malam
1924,2011-03-25,0,3,22,0,5,1,2,0.28,0.2576,0.38,0.3284,3,40,43,43,2,Malam
1925,2011-03-25,0,3,23,0,5,1,2,0.26,0.2424,0.38,0.2836,8,31,39,39,2,Malam
1926,2011-03-26,0,3,0,0,6,0,2,0.26,0.2424,0.38,0.2836,3,25,28,28,2,
1927,2011-03-26,0,3,1,0,6,0,1,0.26,0.2273,0.38,0.2985,3,24,27,27,2,Pagi
1928,2011-03-26,0,3,2,0,6,0,1,0.22,0.2121,0.44,0.2239,4,21,25,25,2,Pagi
1929,2011-03-26,0,3,3,0,6,0,1,0.2,0.197,0.47,0.194,2,7,9,9,2,Pagi
1930,2011-03-26,0,3,4,0,6,0,1,0.22,0.2121,0.44,0.2239,2,4,6,6,2,Pagi
1931,2011-03-26,0,3,5,0,6,0,1,0.2,0.197,0.51,0.194,0,8,8,8,2,Pagi
1932,2011-03-26,0,3,6,0,6,0,1,0.18,0.1818,0.55,0.194,2,8,10,10,2,Pagi
1933,2011-03-26,0,3,7,0,6,0,1,0.2,0.197,0.51,0.194,18,23,41,41,2,Siang
1934,2011-03-26,0,3,8,0,6,0,1,0.22,0.2273,0.44,0.1343,24,42,66,66,2,Siang
1935,2011-03-26,0,3,9,0,6,0,1,0.24,0.2424,0.41,0.1343,32,68,100,100,2,Siang
1936,2011-03-26,0,3,10,0,6,0,1,0.26,0.2576,0.41,0.1642,32,93,125,125,2,Siang
1937,2011-03-26,0,3,11,0,6,0,1,0.28,0.2727,0.38,0.1642,75,93,168,168,2,Siang
1938,2011-03-26,0,3,12,0,6,0,1,0.3,0.2879,0.36,0.194,98,129,227,227,2,Siang
1939,2011-03-26,0,3,13,0,6,0,1,0.32,0.303,0.33,0.2239,94,145,239,239,2,Sore
1940,2011-03-26,0,3,14,0,6,0,1,0.34,0.3182,0.29,0.2239,93,123,216,216,2,Sore
1941,2011-03-26,0,3,15,0,6,0,1,0.34,0.3333,0.29,0.194,110,109,219,219,2,Sore
1942,2011-03-26,0,3,16,0,6,0,1,0.34,0.3333,0.23,0.194,118,130,248,248,2,Sore
1943,2011-03-26,0,3,17,0,6,0,1,0.32,0.303,0.24,0.2239,102,101,203,203,2,Sore
1944,2011-03-26,0,3,18,0,6,0,2,0.32,0.3182,0.21,0.1642,64,89,153,153,2,Sore
1945,2011-03-26,0,3,19,0,6,0,2,0.28,0.2727,0.45,0.2537,45,93,138,138,2,Malam
1946,2011-03-26,0,3,20,0,6,0,2,0.28,0.2727,0.45,0.2537,18,67,85,85,2,Malam
1947,2011-03-26,0,3,21,0,6,0,2,0.26,0.2576,0.44,0.194,15,36,51,51,2,Malam
1948,2011-03-26,0,3,22,0,6,0,2,0.28,0.2727,0.41,0.2239,17,46,63,63,2,Malam
1949,2011-03-26,0,3,23,0,6,0,2,0.26,0.2424,0.44,0.2836,10,31,41,41,2,Malam
1950,2011-03-27,0,3,0,0,0,0,2,0.26,0.2576,0.41,0.1642,5,26,31,31,2,
1951,2011-03-27,0,3,1,0,0,0,2,0.24,0.2273,0.52,0.194,3,17,20,20,2,Pagi
1952,2011-03-27,0,3,2,0,0,0,3,0.22,0.2273,0.55,0.194,6,15,21,21,2,Pagi
1953,2011-03-27,0,3,3,0,0,0,3,0.2,0.197,0.69,0.2239,0,14,14,14,2,Pagi
1954,2011-03-27,0,3,4,0,0,0,3,0.18,0.197,0.74,0.1642,1,5,6,6,2,Pagi
1955,2011-03-27,0,3,6,0,0,0,3,0.16,0.1818,0.86,0.1343,0,2,2,2,2,Pagi
1956,2011-03-27,0,3,7,0,0,0,3,0.16,0.1667,0.86,0.1642,0,7,7,7,2,Siang
1957,2011-03-27,0,3,8,0,0,0,1,0.2,0.197,0.69,0.2239,6,8,14,14,2,Siang
1958,2011-03-27,0,3,9,0,0,0,1,0.22,0.2273,0.55,0.1343,17,37,54,54,2,Siang
1959,2011-03-27,0,3,10,0,0,0,2,0.22,0.2121,0.55,0.2239,27,59,86,86,2,Siang
1960,2011-03-27,0,3,11,0,0,0,2,0.24,0.2424,0.48,0.1642,23,85,108,108,2,Siang
1961,2011-03-27,0,3,12,0,0,0,2,0.26,0.2576,0.44,0.2239,43,120,163,163,2,Siang
1962,2011-03-27,0,3,13,0,0,0,1,0.3,0.2879,0.39,0.2239,47,100,147,147,2,Sore
1963,2011-03-27,0,3,14,0,0,0,1,0.32,0.3182,0.36,0.1642,61,103,164,164,2,Sore
1964,2011-03-27,0,3,15,0,0,0,1,0.32,0.303,0.36,0.2836,61,111,172,172,2,Sore
1965,2011-03-27,0,3,16,0,0,0,1,0.34,0.3333,0.34,0.0,45,98,143,143,2,Sore
1966,2011-03-27,0,3,17,0,0,0,1,0.32,0.303,0.31,0.2537,50,109,159,159,2,Sore
1967,2011-03-27,0,3,18,0,0,0,1,0.3,0.2879,0.33,0.194,32,105,137,137,2,Sore
1968,2011-03-27,0,3,19,0,0,0,1,0.3,0.2879,0.31,0.2239,23,80,103,103,2,Malam
1969,2011-03-27,0,3,20,0,0,0,1,0.28,0.2727,0.36,0.1642,7,50,57,57,2,Malam
1970,2011-03-27,0,3,21,0,0,0,1,0.26,0.2576,0.41,0.1642,7,29,36,36,2,Malam
1971,2011-03-27,0,3,22,0,0,0,1,0.26,0.2576,0.41,0.1642,5,25,30,30,2,Malam
1972,2011-03-27,0,3,23,0,0,0,1,0.26,0.2576,0.44,0.194,3,16,19,19,2,Malam
1973,2011-03-28,0,3,0,0,1,1,1,0.22,0.2273,0.55,0.194,1,11,12,12,2,
1974,2011-03-28,0,3,1,0,1,1,1,0.22,0.2273,0.44,0.194,2,4,6,6,2,Pagi
1975,2011-03-28,0,3,2,0,1,1,1,0.22,0.2273,0.44,0.1642,0,5,5,5,2,Pagi
1976,2011-03-28,0,3,3,0,1,1,1,0.22,0.2273,0.44,0.1642,0,2,2,2,2,Pagi
1977,2011-03-28,0,3,5,0,1,1,1,0.18,0.1818,0.43,0.194,0,8,8,8,2,Pagi
1978,2011-03-28,0,3,6,0,1,1,1,0.18,0.1667,0.34,0.2836,0,40,40,40,2,Pagi
1979,2011-03-28,0,3,7,0,1,1,1,0.2,0.1818,0.32,0.3284,6,104,110,110,2,Siang
1980,2011-03-28,0,3,8,0,1,1,1,0.2,0.197,0.34,0.2239,15,239,254,254,2,Siang
1981,2011-03-28,0,3,9,0,1,1,2,0.22,0.2121,0.32,0.2239,12,109,121,121,2,Siang
1982,2011-03-28,0,3,10,0,1,1,1,0.24,0.2273,0.3,0.194,22,47,69,69,2,Siang
1983,2011-03-28,0,3,11,0,1,1,2,0.26,0.2424,0.3,0.2836,18,39,57,57,2,Siang
1984,2011-03-28,0,3,12,0,1,1,2,0.26,0.2727,0.25,0.0,8,71,79,79,2,Siang
1985,2011-03-28,0,3,13,0,1,1,2,0.3,0.2879,0.24,0.2239,14,69,83,83,2,Sore
1986,2011-03-28,0,3,14,0,1,1,1,0.32,0.303,0.22,0.2239,15,65,80,80,2,Sore
1987,2011-03-28,0,3,15,0,1,1,1,0.32,0.303,0.24,0.2836,19,53,72,72,2,Sore
1988,2011-03-28,0,3,16,0,1,1,1,0.34,0.3182,0.23,0.2239,15,117,132,132,2,Sore
1989,2011-03-28,0,3,17,0,1,1,1,0.34,0.303,0.23,0.2985,25,227,252,252,2,Sore
1990,2011-03-28,0,3,18,0,1,1,1,0.32,0.303,0.21,0.2836,21,220,241,241,2,Sore
1991,2011-03-28,0,3,19,0,1,1,1,0.3,0.303,0.22,0.1343,17,156,173,173,2,Malam
1992,2011-03-28,0,3,20,0,1,1,1,0.32,0.3333,0.22,0.1045,5,107,112,112,2,Malam
1993,2011-03-28,0,3,21,0,1,1,1,0.32,0.3333,0.21,0.1343,6,55,61,61,2,Malam
1994,2011-03-28,0,3,22,0,1,1,1,0.3,0.2879,0.22,0.2239,0,40,40,40,2,Malam
1995,2011-03-28,0,3,23,0,1,1,1,0.28,0.2576,0.24,0.2985,1,18,19,19,2,Malam
1996,2011-03-29,0,3,0,0,2,1,1,0.26,0.2273,0.28,0.3284,1,15,16,16,2,
1997,2011-03-29,0,3,1,0,2,1,1,0.24,0.2121,0.32,0.2985,0,4,4,4,2,Pagi
1998,2011-03-29,0,3,2,0,2,1,1,0.24,0.2121,0.32,0.2985,0,3,3,3,2,Pagi
1999,2011-03-29,0,3,3,0,2,1,1,0.24,0.2121,0.32,0.2985,2,1,3,3,2,Pagi
2000,2011-03-29,0,3,4,0,2,1,1,0.2,0.2121,0.44,0.1642,1,1,2,2,2,Pagi
2001,2011-03-29,0,3,5,0,2,1,1,0.22,0.2121,0.37,0.2537,0,8,8,8,2,Pagi
2002,2011-03-29,0,3,6,0,2,1,1,0.22,0.2121,0.41,0.2985,4,46,50,50,2,Pagi
2003,2011-03-29,0,3,7,0,2,1,1,0.22,0.197,0.41,0.3582,5,128,133,133,2,Siang
2004,2011-03-29,0,3,8,0,2,1,1,0.24,0.2121,0.35,0.3582,19,268,287,287,2,Siang
2005,2011-03-29,0,3,9,0,2,1,1,0.28,0.2576,0.28,0.3881,16,156,172,172,2,Siang
2006,2011-03-29,0,3,10,0,2,1,1,0.3,0.2727,0.24,0.2985,13,46,59,59,2,Siang
2007,2011-03-29,0,3,11,0,2,1,2,0.34,0.303,0.25,0.3881,18,63,81,81,2,Siang
2008,2011-03-29,0,3,12,0,2,1,1,0.34,0.3333,0.25,0.1642,29,77,106,106,2,Siang
2009,2011-03-29,0,3,13,0,2,1,1,0.34,0.303,0.25,0.2985,24,80,104,104,2,Sore
2010,2011-03-29,0,3,14,0,2,1,1,0.36,0.3333,0.25,0.2537,20,66,86,86,2,Sore
2011,2011-03-29,0,3,15,0,2,1,1,0.38,0.3939,0.25,0.2239,22,65,87,87,2,Sore
2012,2011-03-29,0,3,16,0,2,1,1,0.38,0.3939,0.22,0.1642,12,124,136,136,2,Sore
2013,2011-03-29,0,3,17,0,2,1,1,0.4,0.4091,0.2,0.1343,34,265,299,299,2,Sore
2014,2011-03-29,0,3,18,0,2,1,1,0.36,0.3636,0.21,0.0896,42,252,294,294,2,Sore
2015,2011-03-29,0,3,19,0,2,1,1,0.34,0.3333,0.23,0.194,20,170,190,190,2,Malam
2016,2011-03-29,0,3,20,0,2,1,1,0.36,0.3636,0.21,0.0896,13,119,132,132,2,Malam
2017,2011-03-29,0,3,21,0,2,1,1,0.34,0.3636,0.42,0.0,8,75,83,83,2,Malam
2018,2011-03-29,0,3,22,0,2,1,1,0.34,0.3636,0.49,0.0,6,49,55,55,2,Malam
2019,2011-03-29,0,3,23,0,2,1,2,0.32,0.3333,0.57,0.1045,8,27,35,35,2,Malam
2020,2011-03-30,0,3,0,0,3,1,2,0.32,0.3485,0.57,0.0,3,8,11,11,2,
2021,2011-03-30,0,3,1,0,3,1,1,0.32,0.3485,0.39,0.0,1,9,10,10,2,Pagi
2022,2011-03-30,0,3,2,0,3,1,2,0.32,0.3485,0.57,0.0,0,4,4,4,2,Pagi
2023,2011-03-30,0,3,3,0,3,1,2,0.32,0.3485,0.49,0.0,0,4,4,4,2,Pagi
2024,2011-03-30,0,3,4,0,3,1,2,0.32,0.3485,0.57,0.0,1,0,1,1,2,Pagi
2025,2011-03-30,0,3,5,0,3,1,2,0.3,0.2879,0.56,0.194,0,7,7,7,2,Pagi
2026,2011-03-30,0,3,6,0,3,1,2,0.3,0.303,0.49,0.1343,4,44,48,48,2,Pagi
2027,2011-03-30,0,3,7,0,3,1,2,0.32,0.3333,0.45,0.1045,8,128,136,136,2,Siang
2028,2011-03-30,0,3,8,0,3,1,2,0.32,0.3182,0.49,0.1642,16,247,263,263,2,Siang
2029,2011-03-30,0,3,9,0,3,1,2,0.32,0.303,0.45,0.2239,7,147,154,154,2,Siang
2030,2011-03-30,0,3,10,0,3,1,2,0.34,0.3182,0.46,0.2239,13,51,64,64,2,Siang
2031,2011-03-30,0,3,11,0,3,1,2,0.34,0.3182,0.46,0.2537,26,64,90,90,2,Siang
2032,2011-03-30,0,3,12,0,3,1,2,0.34,0.3333,0.46,0.1642,15,65,80,80,2,Siang
2033,2011-03-30,0,3,13,0,3,1,2,0.36,0.3485,0.46,0.2239,14,84,98,98,2,Sore
2034,2011-03-30,0,3,14,0,3,1,2,0.36,0.3333,0.46,0.2985,16,64,80,80,2,Sore
2035,2011-03-30,0,3,15,0,3,1,3,0.28,0.2576,0.81,0.2985,14,56,70,70,2,Sore
2036,2011-03-30,0,3,16,0,3,1,3,0.28,0.2727,0.87,0.2537,0,36,36,36,2,Sore
2037,2011-03-30,0,3,17,0,3,1,3,0.26,0.2727,0.93,0.1045,11,105,116,116,2,Sore
2038,2011-03-30,0,3,18,0,3,1,2,0.26,0.2576,0.93,0.2239,6,79,85,85,2,Sore
2039,2011-03-30,0,3,19,0,3,1,2,0.26,0.2576,0.93,0.2239,5,67,72,72,2,Malam
2040,2011-03-30,0,3,20,0,3,1,3,0.24,0.2121,0.93,0.2985,4,40,44,44,2,Malam
2041,2011-03-30,0,3,21,0,3,1,2,0.24,0.2273,0.93,0.2537,0,27,27,27,2,Malam
2042,2011-03-30,0,3,22,0,3,1,3,0.24,0.2273,0.93,0.2239,3,21,24,24,2,Malam
2043,2011-03-30,0,3,23,0,3,1,3,0.24,0.2121,0.93,0.2836,1,11,12,12,2,Malam
2044,2011-03-31,0,3,0,0,4,1,3,0.24,0.2273,0.93,0.2239,0,3,3,3,2,
2045,2011-03-31,0,3,1,0,4,1,3,0.24,0.2273,0.93,0.194,1,4,5,5,2,Pagi
2046,2011-03-31,0,3,2,0,4,1,3,0.24,0.2273,0.93,0.194,0,5,5,5,2,Pagi
2047,2011-03-31,0,3,3,0,4,1,3,0.24,0.2273,0.93,0.2239,0,1,1,1,2,Pagi
2048,2011-03-31,0,3,4,0,4,1,3,0.24,0.2273,0.93,0.2537,0,2,2,2,2,Pagi
2049,2011-03-31,0,3,5,0,4,1,3,0.24,0.2273,0.93,0.2239,0,8,8,8,2,Pagi
2050,2011-03-31,0,3,6,0,4,1,3,0.24,0.2121,0.93,0.2985,2,34,36,36,2,Pagi
2051,2011-03-31,0,3,7,0,4,1,3,0.24,0.2273,0.93,0.2537,5,87,92,92,2,Siang
2052,2011-03-31,0,3,8,0,4,1,2,0.24,0.2273,1.0,0.2537,7,185,192,192,2,Siang
2053,2011-03-31,0,3,9,0,4,1,3,0.26,0.2424,0.93,0.2537,6,126,132,132,2,Siang
2054,2011-03-31,0,3,10,0,4,1,3,0.26,0.2424,0.93,0.2537,15,54,69,69,2,Siang
2055,2011-03-31,0,3,11,0,4,1,3,0.28,0.2727,0.93,0.194,6,52,58,58,2,Siang
2056,2011-03-31,0,3,12,0,4,1,3,0.28,0.2727,0.93,0.194,17,73,90,90,2,Siang
2057,2011-03-31,0,3,13,0,4,1,3,0.3,0.303,0.87,0.1343,13,55,68,68,2,Sore
2058,2011-03-31,0,3,14,0,4,1,3,0.3,0.303,0.87,0.1343,27,49,76,76,2,Sore
2059,2011-03-31,0,3,15,0,4,1,3,0.3,0.2727,0.87,0.2985,4,61,65,65,2,Sore
2060,2011-03-31,0,3,16,0,4,1,2,0.3,0.2879,0.87,0.2537,13,72,85,85,2,Sore
2061,2011-03-31,0,3,17,0,4,1,2,0.3,0.2879,0.87,0.2537,15,153,168,168,2,Sore
2062,2011-03-31,0,3,18,0,4,1,2,0.3,0.303,0.87,0.1343,12,165,177,177,2,Sore
2063,2011-03-31,0,3,19,0,4,1,2,0.3,0.303,0.87,0.1343,12,118,130,130,2,Malam
2064,2011-03-31,0,3,20,0,4,1,3,0.28,0.2576,0.93,0.2836,6,79,85,85,2,Malam
2065,2011-03-31,0,3,21,0,4,1,2,0.28,0.2727,0.93,0.1642,7,53,60,60,2,Malam
2066,2011-03-31,0,3,22,0,4,1,3,0.28,0.2727,0.93,0.2537,7,44,51,51,2,Malam
2067,2011-03-31,0,3,23,0,4,1,3,0.26,0.2576,1.0,0.1642,4,23,27,27,2,Malam
2068,2011-04-01,0,4,0,0,5,1,3,0.26,0.2576,1.0,0.1642,0,6,6,6,2,
2069,2011-04-01,0,4,1,0,5,1,3,0.26,0.2576,1.0,0.1642,0,4,4,4,2,Pagi
2070,2011-04-01,0,4,2,0,5,1,3,0.26,0.2576,0.93,0.194,0,7,7,7,2,Pagi
2071,2011-04-01,0,4,3,0,5,1,2,0.24,0.2273,0.93,0.2537,0,4,4,4,2,Pagi
2072,2011-04-01,0,4,4,0,5,1,2,0.24,0.2273,0.93,0.2537,0,3,3,3,2,Pagi
2073,2011-04-01,0,4,5,0,5,1,3,0.24,0.2273,0.93,0.2239,1,11,12,12,2,Pagi
2074,2011-04-01,0,4,6,0,5,1,3,0.24,0.2273,0.93,0.2239,2,26,28,28,2,Pagi
2075,2011-04-01,0,4,7,0,5,1,3,0.24,0.2424,0.93,0.0,4,91,95,95,2,Siang
2076,2011-04-01,0,4,8,0,5,1,2,0.26,0.2424,0.87,0.2537,8,198,206,206,2,Siang
2077,2011-04-01,0,4,9,0,5,1,1,0.32,0.2879,0.7,0.3582,11,162,173,173,2,Siang
2078,2011-04-01,0,4,10,0,5,1,1,0.32,0.303,0.66,0.2836,12,63,75,75,2,Siang
2079,2011-04-01,0,4,11,0,5,1,1,0.32,0.2879,0.61,0.3582,17,72,89,89,2,Siang
2080,2011-04-01,0,4,12,0,5,1,1,0.34,0.303,0.53,0.3582,15,80,95,95,2,Siang
2081,2011-04-01,0,4,13,0,5,1,1,0.36,0.3333,0.5,0.3582,18,92,110,110,2,Sore
2082,2011-04-01,0,4,14,0,5,1,2,0.36,0.3333,0.46,0.3582,26,61,87,87,2,Sore
2083,2011-04-01,0,4,15,0,5,1,1,0.34,0.303,0.46,0.4179,30,81,111,111,2,Sore
2084,2011-04-01,0,4,16,0,5,1,1,0.34,0.303,0.46,0.4179,42,125,167,167,2,Sore
2085,2011-04-01,0,4,17,0,5,1,1,0.34,0.303,0.46,0.3284,36,245,281,281,2,Sore
2086,2011-04-01,0,4,18,0,5,1,1,0.34,0.303,0.46,0.3284,36,205,241,241,2,Sore
2087,2011-04-01,0,4,19,0,5,1,1,0.34,0.303,0.49,0.3284,16,120,136,136,2,Malam
2088,2011-04-01,0,4,20,0,5,1,1,0.32,0.3182,0.53,0.194,2,75,77,77,2,Malam
2089,2011-04-01,0,4,21,0,5,1,1,0.32,0.3333,0.53,0.1343,9,84,93,93,2,Malam
2090,2011-04-01,0,4,22,0,5,1,1,0.3,0.303,0.56,0.1642,10,64,74,74,2,Malam
2091,2011-04-01,0,4,23,0,5,1,1,0.3,0.3182,0.61,0.0896,12,41,53,53,2,Malam
2092,2011-04-02,0,4,0,0,6,0,2,0.3,0.3333,0.61,0.0,3,29,32,32,2,
2093,2011-04-02,0,4,1,0,6,0,1,0.26,0.2727,0.65,0.1343,4,28,32,32,2,Pagi
2094,2011-04-02,0,4,2,0,6,0,1,0.24,0.2424,0.75,0.1343,1,20,21,21,2,Pagi
2095,2011-04-02,0,4,3,0,6,0,1,0.24,0.2424,0.7,0.1642,1,8,9,9,2,Pagi
2096,2011-04-02,0,4,4,0,6,0,1,0.24,0.2424,0.7,0.1642,0,5,5,5,2,Pagi
2097,2011-04-02,0,4,5,0,6,0,2,0.24,0.2424,0.75,0.1642,1,4,5,5,2,Pagi
2098,2011-04-02,0,4,6,0,6,0,1,0.26,0.2727,0.7,0.1045,5,7,12,12,2,Pagi
2099,2011-04-02,0,4,7,0,6,0,2,0.26,0.2727,0.7,0.1045,2,16,18,18,2,Siang
2100,2011-04-02,0,4,8,0,6,0,1,0.3,0.3182,0.7,0.1045,10,45,55,55,2,Siang
2101,2011-04-02,0,4,9,0,6,0,2,0.34,0.3485,0.66,0.1045,22,65,87,87,2,Siang
2102,2011-04-02,0,4,10,0,6,0,2,0.36,0.3485,0.57,0.1642,41,113,154,154,2,Siang
2103,2011-04-02,0,4,11,0,6,0,2,0.4,0.4091,0.47,0.1642,72,126,198,198,2,Siang
2104,2011-04-02,0,4,12,0,6,0,3,0.32,0.3333,0.81,0.1343,84,100,184,184,2,Siang
2105,2011-04-02,0,4,13,0,6,0,1,0.34,0.3333,0.81,0.1343,56,81,137,137,2,Sore
2106,2011-04-02,0,4,14,0,6,0,3,0.32,0.303,0.76,0.3284,97,93,190,190,2,Sore
2107,2011-04-02,0,4,15,0,6,0,3,0.34,0.303,0.76,0.3881,72,64,136,136,2,Sore
2108,2011-04-02,0,4,16,0,6,0,1,0.38,0.3939,0.62,0.3284,111,85,196,196,2,Sore
2109,2011-04-02,0,4,17,0,6,0,1,0.38,0.3939,0.54,0.3582,89,95,184,184,2,Sore
2110,2011-04-02,0,4,18,0,6,0,1,0.38,0.3939,0.54,0.194,69,110,179,179,2,Sore
2111,2011-04-02,0,4,19,0,6,0,1,0.36,0.3333,0.53,0.3582,71,77,148,148,2,Malam
2112,2011-04-02,0,4,20,0,6,0,1,0.34,0.3182,0.53,0.2836,29,56,85,85,2,Malam
2113,2011-04-02,0,4,21,0,6,0,1,0.32,0.303,0.61,0.2537,24,53,77,77,2,Malam
2114,2011-04-02,0,4,22,0,6,0,1,0.32,0.303,0.61,0.2985,14,41,55,55,2,Malam
2115,2011-04-02,0,4,23,0,6,0,1,0.32,0.3182,0.61,0.1642,20,33,53,53,2,Malam
2116,2011-04-03,0,4,0,0,0,0,1,0.3,0.2879,0.65,0.194,8,31,39,39,2,
2117,2011-04-03,0,4,1,0,0,0,1,0.3,0.3182,0.61,0.1045,8,26,34,34,2,Pagi
2118,2011-04-03,0,4,2,0,0,0,1,0.26,0.2727,0.7,0.1343,5,19,24,24,2,Pagi
2119,2011-04-03,0,4,3,0,0,0,1,0.3,0.3333,0.61,0.0,3,8,11,11,2,Pagi
2120,2011-04-03,0,4,4,0,0,0,1,0.28,0.303,0.7,0.0896,3,0,3,3,2,Pagi
2121,2011-04-03,0,4,5,0,0,0,1,0.28,0.2727,0.65,0.2239,1,4,5,5,2,Pagi
2122,2011-04-03,0,4,6,0,0,0,1,0.28,0.2727,0.65,0.194,10,23,33,33,2,Pagi
2123,2011-04-03,0,4,7,0,0,0,1,0.32,0.303,0.57,0.2239,13,20,33,33,2,Siang
2124,2011-04-03,0,4,8,0,0,0,1,0.34,0.3333,0.57,0.1642,18,44,62,62,2,Siang
2125,2011-04-03,0,4,9,0,0,0,1,0.36,0.3182,0.5,0.4925,68,74,142,142,2,Siang
2126,2011-04-03,0,4,10,0,0,0,1,0.4,0.4091,0.43,0.4179,111,104,215,215,2,Siang
2127,2011-04-03,0,4,11,0,0,0,1,0.42,0.4242,0.41,0.2537,139,104,243,243,2,Siang
2128,2011-04-03,0,4,12,0,0,0,1,0.44,0.4394,0.38,0.2836,166,147,313,313,2,Siang
2129,2011-04-03,0,4,13,0,0,0,1,0.44,0.4394,0.33,0.2985,219,148,367,367,2,Sore
2130,2011-04-03,0,4,14,0,0,0,1,0.46,0.4545,0.31,0.1343,240,109,349,349,2,Sore
2131,2011-04-03,0,4,15,0,0,0,2,0.46,0.4545,0.33,0.0,174,118,292,292,2,Sore
2132,2011-04-03,0,4,16,0,0,0,2,0.46,0.4545,0.31,0.194,147,156,303,303,2,Sore
2133,2011-04-03,0,4,17,0,0,0,2,0.46,0.4545,0.28,0.1343,148,126,274,274,2,Sore
2134,2011-04-03,0,4,18,0,0,0,2,0.46,0.4545,0.31,0.0,71,101,172,172,2,Sore
2135,2011-04-03,0,4,19,0,0,0,2,0.42,0.4242,0.44,0.194,51,93,144,144,2,Malam
2136,2011-04-03,0,4,20,0,0,0,3,0.42,0.4242,0.41,0.2239,24,55,79,79,2,Malam
2137,2011-04-03,0,4,21,0,0,0,2,0.42,0.4242,0.44,0.2239,8,37,45,45,2,Malam
2138,2011-04-03,0,4,22,0,0,0,1,0.4,0.4091,0.43,0.1045,7,29,36,36,2,Malam
2139,2011-04-03,0,4,23,0,0,0,1,0.4,0.4091,0.5,0.0896,9,22,31,31,2,Malam
2140,2011-04-04,0,4,0,0,1,1,1,0.4,0.4091,0.5,0.2239,1,5,6,6,2,
2141,2011-04-04,0,4,1,0,1,1,1,0.4,0.4091,0.56,0.3582,7,4,11,11,2,Pagi
2142,2011-04-04,0,4,2,0,1,1,1,0.38,0.3939,0.66,0.2537,1,1,2,2,2,Pagi
2143,2011-04-04,0,4,3,0,1,1,1,0.38,0.3939,0.66,0.2836,1,0,1,1,2,Pagi
2144,2011-04-04,0,4,4,0,1,1,1,0.38,0.3939,0.71,0.2985,1,1,2,2,2,Pagi
2145,2011-04-04,0,4,5,0,1,1,1,0.4,0.4091,0.62,0.2537,0,7,7,7,2,Pagi
2146,2011-04-04,0,4,6,0,1,1,1,0.42,0.4242,0.58,0.2836,3,43,46,46,2,Pagi
2147,2011-04-04,0,4,7,0,1,1,2,0.44,0.4394,0.54,0.2537,7,150,157,157,2,Siang
2148,2011-04-04,0,4,8,0,1,1,2,0.46,0.4545,0.55,0.2985,31,308,339,339,2,Siang
2149,2011-04-04,0,4,9,0,1,1,2,0.5,0.4848,0.51,0.3881,24,134,158,158,2,Siang
2150,2011-04-04,0,4,10,0,1,1,2,0.54,0.5152,0.45,0.3582,35,55,90,90,2,Siang
2151,2011-04-04,0,4,11,0,1,1,1,0.6,0.6212,0.4,0.3881,58,66,124,124,2,Siang
2152,2011-04-04,0,4,12,0,1,1,1,0.64,0.6212,0.36,0.4627,59,98,157,157,2,Siang
2153,2011-04-04,0,4,13,0,1,1,1,0.68,0.6364,0.34,0.3284,47,92,139,139,2,Sore
2154,2011-04-04,0,4,14,0,1,1,2,0.74,0.6515,0.27,0.4925,47,76,123,123,2,Sore
2155,2011-04-04,0,4,15,0,1,1,1,0.76,0.6667,0.23,0.5522,47,96,143,143,2,Sore
2156,2011-04-04,0,4,16,0,1,1,1,0.76,0.6515,0.22,0.5224,59,130,189,189,2,Sore
2157,2011-04-04,0,4,17,0,1,1,1,0.74,0.6515,0.23,0.6119,83,283,366,366,2,Sore
2158,2011-04-04,0,4,18,0,1,1,2,0.72,0.6364,0.23,0.4925,78,308,386,386,2,Sore
2159,2011-04-04,0,4,19,0,1,1,1,0.7,0.6364,0.24,0.4627,51,227,278,278,2,Malam
2160,2011-04-04,0,4,20,0,1,1,2,0.7,0.6364,0.24,0.5522,40,133,173,173,2,Malam
2161,2011-04-04,0,4,21,0,1,1,2,0.7,0.6364,0.3,0.4478,19,76,95,95,2,Malam
2162,2011-04-04,0,4,22,0,1,1,2,0.68,0.6364,0.36,0.4627,17,58,75,75,2,Malam
2163,2011-04-04,0,4,23,0,1,1,2,0.64,0.6212,0.47,0.2239,18,30,48,48,2,Malam
2164,2011-04-05,0,4,0,0,2,1,1,0.62,0.6212,0.5,0.1045,10,12,22,22,2,
2165,2011-04-05,0,4,1,0,2,1,3,0.62,0.6212,0.57,0.4179,10,5,15,15,2,Pagi
2166,2011-04-05,0,4,2,0,2,1,2,0.54,0.5152,0.73,0.3284,0,5,5,5,2,Pagi
2167,2011-04-05,0,4,3,0,2,1,2,0.54,0.5152,0.73,0.3284,1,3,4,4,2,Pagi
2168,2011-04-05,0,4,4,0,2,1,3,0.5,0.4848,0.88,0.4925,0,2,2,2,2,Pagi
2169,2011-04-05,0,4,5,0,2,1,3,0.46,0.4545,0.94,0.2985,0,5,5,5,2,Pagi
2170,2011-04-05,0,4,6,0,2,1,2,0.48,0.4697,0.88,0.3284,2,36,38,38,2,Pagi
2171,2011-04-05,0,4,7,0,2,1,2,0.48,0.4697,0.88,0.3284,10,124,134,134,2,Siang
2172,2011-04-05,0,4,8,0,2,1,3,0.38,0.3939,0.87,0.5821,9,148,157,157,2,Siang
2173,2011-04-05,0,4,9,0,2,1,3,0.36,0.3182,0.87,0.4925,2,44,46,46,2,Siang
2174,2011-04-05,0,4,10,0,2,1,3,0.34,0.303,0.81,0.3881,3,25,28,28,2,Siang
2175,2011-04-05,0,4,11,0,2,1,3,0.32,0.2879,0.81,0.4478,1,18,19,19,2,Siang
2176,2011-04-05,0,4,12,0,2,1,2,0.34,0.303,0.71,0.3881,6,32,38,38,2,Siang
2177,2011-04-05,0,4,13,0,2,1,2,0.36,0.3333,0.63,0.4179,5,51,56,56,2,Sore
2178,2011-04-05,0,4,14,0,2,1,2,0.36,0.3182,0.57,0.4925,9,67,76,76,2,Sore
2179,2011-04-05,0,4,15,0,2,1,1,0.4,0.4091,0.46,0.4627,6,62,68,68,2,Sore
2180,2011-04-05,0,4,16,0,2,1,1,0.38,0.3939,0.46,0.4179,17,113,130,130,2,Sore
2181,2011-04-05,0,4,17,0,2,1,1,0.42,0.4242,0.38,0.4179,27,246,273,273,2,Sore
2182,2011-04-05,0,4,18,0,2,1,1,0.38,0.3939,0.4,0.4925,19,248,267,267,2,Sore
2183,2011-04-05,0,4,19,0,2,1,1,0.36,0.3333,0.43,0.2985,12,148,160,160,2,Malam
2184,2011-04-05,0,4,20,0,2,1,1,0.34,0.3182,0.46,0.2836,4,87,91,91,2,Malam
2185,2011-04-05,0,4,21,0,2,1,1,0.34,0.2879,0.46,0.5224,8,81,89,89,2,Malam
2186,2011-04-05,0,4,22,0,2,1,1,0.32,0.303,0.49,0.2985,3,43,46,46,2,Malam
2187,2011-04-05,0,4,23,0,2,1,1,0.3,0.2879,0.49,0.2836,3,23,26,26,2,Malam
2188,2011-04-06,0,4,0,0,3,1,1,0.3,0.3182,0.49,0.1045,0,15,15,15,2,
2189,2011-04-06,0,4,1,0,3,1,1,0.26,0.2727,0.6,0.1343,0,2,2,2,2,Pagi
2190,2011-04-06,0,4,2,0,3,1,1,0.24,0.2424,0.7,0.1343,0,5,5,5,2,Pagi
2191,2011-04-06,0,4,3,0,3,1,1,0.26,0.2727,0.6,0.1343,0,4,4,4,2,Pagi
2192,2011-04-06,0,4,4,0,3,1,1,0.24,0.2424,0.65,0.1343,0,1,1,1,2,Pagi
2193,2011-04-06,0,4,5,0,3,1,1,0.24,0.2576,0.7,0.1045,1,12,13,13,2,Pagi
2194,2011-04-06,0,4,6,0,3,1,1,0.24,0.2576,0.7,0.1045,4,52,56,56,2,Pagi
2195,2011-04-06,0,4,7,0,3,1,1,0.26,0.2727,0.65,0.1045,3,130,133,133,2,Siang
2196,2011-04-06,0,4,8,0,3,1,1,0.32,0.303,0.61,0.2239,17,308,325,325,2,Siang
2197,2011-04-06,0,4,9,0,3,1,1,0.36,0.3333,0.46,0.2537,8,157,165,165,2,Siang
2198,2011-04-06,0,4,10,0,3,1,1,0.4,0.4091,0.37,0.3881,21,48,69,69,2,Siang
2199,2011-04-06,0,4,11,0,3,1,1,0.42,0.4242,0.38,0.3881,23,70,93,93,2,Siang
2200,2011-04-06,0,4,12,0,3,1,1,0.44,0.4394,0.41,0.2537,22,112,134,134,2,Siang
2201,2011-04-06,0,4,13,0,3,1,1,0.46,0.4545,0.38,0.4925,29,83,112,112,2,Sore
2202,2011-04-06,0,4,14,0,3,1,1,0.5,0.4848,0.34,0.4179,35,80,115,115,2,Sore
2203,2011-04-06,0,4,15,0,3,1,1,0.52,0.5,0.32,0.3284,34,83,117,117,2,Sore
2204,2011-04-06,0,4,16,0,3,1,1,0.54,0.5152,0.28,0.4179,27,142,169,169,2,Sore
2205,2011-04-06,0,4,17,0,3,1,1,0.52,0.5,0.32,0.4478,53,303,356,356,2,Sore
2206,2011-04-06,0,4,18,0,3,1,1,0.52,0.5,0.29,0.3582,43,282,325,325,2,Sore
2207,2011-04-06,0,4,19,0,3,1,1,0.5,0.4848,0.31,0.2985,36,196,232,232,2,Malam
2208,2011-04-06,0,4,20,0,3,1,1,0.46,0.4545,0.51,0.2239,15,126,141,141,2,Malam
2209,2011-04-06,0,4,21,0,3,1,1,0.46,0.4545,0.41,0.2836,18,84,102,102,2,Malam
2210,2011-04-06,0,4,22,0,3,1,1,0.46,0.4545,0.41,0.2836,13,71,84,84,2,Malam
2211,2011-04-06,0,4,23,0,3,1,1,0.46,0.4545,0.41,0.2985,11,29,40,40,2,Malam
2212,2011-04-07,0,4,0,0,4,1,1,0.46,0.4545,0.41,0.2836,5,15,20,20,2,
2213,2011-04-07,0,4,1,0,4,1,1,0.42,0.4242,0.47,0.1343,2,11,13,13,2,Pagi
2214,2011-04-07,0,4,2,0,4,1,1,0.42,0.4242,0.54,0.0,0,7,7,7,2,Pagi
2215,2011-04-07,0,4,3,0,4,1,1,0.36,0.3485,0.66,0.194,0,3,3,3,2,Pagi
2216,2011-04-07,0,4,4,0,4,1,1,0.34,0.3333,0.76,0.194,0,1,1,1,2,Pagi
2217,2011-04-07,0,4,5,0,4,1,1,0.34,0.3182,0.76,0.2239,0,6,6,6,2,Pagi
2218,2011-04-07,0,4,6,0,4,1,1,0.32,0.303,0.81,0.2537,5,59,64,64,2,Pagi
2219,2011-04-07,0,4,7,0,4,1,2,0.34,0.3333,0.76,0.1642,8,152,160,160,2,Siang
2220,2011-04-07,0,4,8,0,4,1,1,0.36,0.3485,0.76,0.194,23,291,314,314,2,Siang
2221,2011-04-07,0,4,9,0,4,1,2,0.4,0.4091,0.66,0.1343,15,155,170,170,2,Siang
2222,2011-04-07,0,4,10,0,4,1,2,0.42,0.4242,0.67,0.1045,29,66,95,95,2,Siang
2223,2011-04-07,0,4,11,0,4,1,2,0.46,0.4545,0.55,0.0,36,86,122,122,2,Siang
2224,2011-04-07,0,4,12,0,4,1,2,0.46,0.4545,0.55,0.0,39,114,153,153,2,Siang
2225,2011-04-07,0,4,13,0,4,1,2,0.52,0.5,0.48,0.0896,36,99,135,135,2,Sore
2226,2011-04-07,0,4,14,0,4,1,1,0.56,0.5303,0.43,0.0896,46,111,157,157,2,Sore
2227,2011-04-07,0,4,15,0,4,1,1,0.6,0.6212,0.38,0.1045,27,133,160,160,2,Sore
2228,2011-04-07,0,4,16,0,4,1,1,0.6,0.6212,0.35,0.0,52,161,213,213,2,Sore
2229,2011-04-07,0,4,17,0,4,1,1,0.52,0.5,0.52,0.2836,63,280,343,343,2,Sore
2230,2011-04-07,0,4,18,0,4,1,1,0.48,0.4697,0.55,0.2537,68,265,333,333,2,Sore
2231,2011-04-07,0,4,19,0,4,1,1,0.46,0.4545,0.59,0.2985,34,192,226,226,2,Malam
2232,2011-04-07,0,4,20,0,4,1,1,0.44,0.4394,0.62,0.1642,37,166,203,203,2,Malam
2233,2011-04-07,0,4,21,0,4,1,2,0.44,0.4394,0.67,0.2836,19,89,108,108,2,Malam
2234,2011-04-07,0,4,22,0,4,1,2,0.4,0.4091,0.76,0.194,18,63,81,81,2,Malam
2235,2011-04-07,0,4,23,0,4,1,1,0.38,0.3939,0.76,0.2537,9,45,54,54,2,Malam
2236,2011-04-08,0,4,0,0,5,1,2,0.36,0.3485,0.76,0.2239,4,21,25,25,2,
2237,2011-04-08,0,4,1,0,5,1,2,0.34,0.3333,0.76,0.1343,3,6,9,9,2,Pagi
2238,2011-04-08,0,4,2,0,5,1,3,0.34,0.3333,0.76,0.1642,3,10,13,13,2,Pagi
2239,2011-04-08,0,4,3,0,5,1,3,0.34,0.3333,0.76,0.1642,0,1,1,1,2,Pagi
2240,2011-04-08,0,4,4,0,5,1,2,0.34,0.3333,0.86,0.1343,0,1,1,1,2,Pagi
2241,2011-04-08,0,4,5,0,5,1,2,0.32,0.3182,0.87,0.194,1,8,9,9,2,Pagi
2242,2011-04-08,0,4,6,0,5,1,2,0.34,0.3636,0.87,0.0,2,33,35,35,2,Pagi
2243,2011-04-08,0,4,7,0,5,1,3,0.34,0.3333,0.87,0.1642,4,109,113,113,2,Siang
2244,2011-04-08,0,4,8,0,5,1,3,0.34,0.3333,0.87,0.1642,13,208,221,221,2,Siang
2245,2011-04-08,0,4,9,0,5,1,2,0.36,0.3485,0.76,0.194,17,168,185,185,2,Siang
2246,2011-04-08,0,4,10,0,5,1,2,0.36,0.3333,0.71,0.2836,10,63,73,73,2,Siang
2247,2011-04-08,0,4,11,0,5,1,2,0.4,0.4091,0.62,0.3881,19,79,98,98,2,Siang
2248,2011-04-08,0,4,12,0,5,1,3,0.38,0.3939,0.66,0.2239,29,51,80,80,2,Siang
2249,2011-04-08,0,4,13,0,5,1,3,0.36,0.3333,0.76,0.2836,7,35,42,42,2,Sore
2250,2011-04-08,0,4,14,0,5,1,3,0.34,0.3182,0.87,0.2239,2,13,15,15,2,Sore
2251,2011-04-08,0,4,15,0,5,1,3,0.34,0.3182,0.87,0.2239,1,24,25,25,2,Sore
2252,2011-04-08,0,4,16,0,5,1,2,0.32,0.303,0.93,0.2537,2,58,60,60,2,Sore
2253,2011-04-08,0,4,17,0,5,1,3,0.32,0.303,0.93,0.2537,10,138,148,148,2,Sore
2254,2011-04-08,0,4,18,0,5,1,3,0.32,0.303,0.93,0.2537,8,54,62,62,2,Sore
2255,2011-04-08,0,4,19,0,5,1,3,0.3,0.2727,0.93,0.4179,1,52,53,53,2,Malam
2256,2011-04-08,0,4,20,0,5,1,2,0.3,0.2727,0.93,0.3284,12,51,63,63,2,Malam
2257,2011-04-08,0,4,21,0,5,1,2,0.3,0.2879,0.93,0.2537,11,43,54,54,2,Malam
2258,2011-04-08,0,4,22,0,5,1,2,0.3,0.2727,0.93,0.2985,9,42,51,51,2,Malam
2259,2011-04-08,0,4,23,0,5,1,2,0.3,0.2879,0.93,0.2239,4,31,35,35,2,Malam
2260,2011-04-09,0,4,0,0,6,0,2,0.3,0.2879,0.87,0.2239,5,26,31,31,2,
2261,2011-04-09,0,4,1,0,6,0,2,0.3,0.303,0.87,0.1343,3,17,20,20,2,Pagi
2262,2011-04-09,0,4,2,0,6,0,2,0.32,0.303,0.87,0.2239,2,15,17,17,2,Pagi
2263,2011-04-09,0,4,3,0,6,0,3,0.3,0.2879,1.0,0.2537,3,11,14,14,2,Pagi
2264,2011-04-09,0,4,4,0,6,0,3,0.3,0.2727,1.0,0.2537,0,3,3,3,2,Pagi
2265,2011-04-09,0,4,5,0,6,0,2,0.3,0.2879,0.93,0.2239,0,5,5,5,2,Pagi
2266,2011-04-09,0,4,6,0,6,0,2,0.3,0.2879,0.93,0.194,0,13,13,13,2,Pagi
2267,2011-04-09,0,4,7,0,6,0,2,0.3,0.303,0.93,0.1642,8,13,21,21,2,Siang
2268,2011-04-09,0,4,8,0,6,0,2,0.32,0.303,0.93,0.1642,7,47,54,54,2,Siang
2269,2011-04-09,0,4,9,0,6,0,2,0.34,0.3485,0.87,0.1045,27,71,98,98,2,Siang
2270,2011-04-09,0,4,10,0,6,0,2,0.34,0.3333,0.87,0.1343,43,90,133,133,2,Siang
2271,2011-04-09,0,4,11,0,6,0,2,0.36,0.3636,0.81,0.0,51,91,142,142,2,Siang
2272,2011-04-09,0,4,12,0,6,0,2,0.36,0.3485,0.81,0.1343,79,123,202,202,2,Siang
2273,2011-04-09,0,4,13,0,6,0,2,0.36,0.3788,0.81,0.0,114,108,222,222,2,Sore
2274,2011-04-09,0,4,14,0,6,0,2,0.36,0.3485,0.81,0.1343,94,118,212,212,2,Sore
2275,2011-04-09,0,4,15,0,6,0,2,0.36,0.3788,0.87,0.0,85,116,201,201,2,Sore
2276,2011-04-09,0,4,16,0,6,0,2,0.38,0.3939,0.82,0.0,73,118,191,191,2,Sore
2277,2011-04-09,0,4,17,0,6,0,2,0.38,0.3939,0.82,0.0896,128,129,257,257,2,Sore
2278,2011-04-09,0,4,18,0,6,0,2,0.38,0.3939,0.82,0.1045,48,129,177,177,2,Sore
2279,2011-04-09,0,4,19,0,6,0,2,0.38,0.3939,0.82,0.1343,47,83,130,130,2,Malam
2280,2011-04-09,0,4,20,0,6,0,2,0.38,0.3939,0.87,0.1642,19,74,93,93,2,Malam
2281,2011-04-09,0,4,21,0,6,0,2,0.36,0.3485,0.93,0.1343,10,65,75,75,2,Malam
2282,2011-04-09,0,4,22,0,6,0,2,0.36,0.3485,0.93,0.1343,21,66,87,87,2,Malam
2283,2011-04-09,0,4,23,0,6,0,2,0.38,0.3939,0.87,0.0896,12,45,57,57,2,Malam
2284,2011-04-10,0,4,0,0,0,0,2,0.38,0.3939,0.87,0.0896,5,48,53,53,2,
2285,2011-04-10,0,4,1,0,0,0,2,0.38,0.3939,0.87,0.1343,6,31,37,37,2,Pagi
2286,2011-04-10,0,4,2,0,0,0,2,0.38,0.3939,0.87,0.0896,12,24,36,36,2,Pagi
2287,2011-04-10,0,4,3,0,0,0,2,0.38,0.3939,0.87,0.1343,5,11,16,16,2,Pagi
2288,2011-04-10,0,4,4,0,0,0,2,0.36,0.3636,0.93,0.1045,3,2,5,5,2,Pagi
2289,2011-04-10,0,4,5,0,0,0,2,0.36,0.3636,0.93,0.0896,0,4,4,4,2,Pagi
2290,2011-04-10,0,4,6,0,0,0,2,0.36,0.3636,0.93,0.0896,0,4,4,4,2,Pagi
2291,2011-04-10,0,4,7,0,0,0,2,0.36,0.3636,1.0,0.0896,3,7,10,10,2,Siang
2292,2011-04-10,0,4,8,0,0,0,2,0.38,0.3939,0.94,0.0896,17,38,55,55,2,Siang
2293,2011-04-10,0,4,9,0,0,0,2,0.38,0.3939,0.94,0.1343,31,50,81,81,2,Siang
2294,2011-04-10,0,4,10,0,0,0,2,0.4,0.4091,0.87,0.0,69,81,150,150,2,Siang
2295,2011-04-10,0,4,11,0,0,0,2,0.4,0.4091,0.87,0.1343,93,109,202,202,2,Siang
2296,2011-04-10,0,4,12,0,0,0,2,0.42,0.4242,0.88,0.1343,94,136,230,230,2,Siang
2297,2011-04-10,0,4,13,0,0,0,1,0.46,0.4545,0.82,0.1045,121,142,263,263,2,Sore
2298,2011-04-10,0,4,14,0,0,0,1,0.5,0.4848,0.72,0.194,148,133,281,281,2,Sore
2299,2011-04-10,0,4,15,0,0,0,1,0.5,0.4848,0.77,0.2239,156,141,297,297,2,Sore
2300,2011-04-10,0,4,16,0,0,0,2,0.52,0.5,0.72,0.1642,135,153,288,288,2,Sore
2301,2011-04-10,0,4,17,0,0,0,2,0.52,0.5,0.72,0.194,84,152,236,236,2,Sore
2302,2011-04-10,0,4,18,0,0,0,1,0.5,0.4848,0.77,0.194,103,137,240,240,2,Sore
2303,2011-04-10,0,4,19,0,0,0,1,0.5,0.4848,0.77,0.194,47,84,131,131,2,Malam
2304,2011-04-10,0,4,20,0,0,0,1,0.46,0.4545,0.82,0.1343,21,71,92,92,2,Malam
2305,2011-04-10,0,4,21,0,0,0,1,0.44,0.4394,0.88,0.194,18,77,95,95,2,Malam
2306,2011-04-10,0,4,22,0,0,0,1,0.44,0.4394,0.94,0.2537,12,45,57,57,2,Malam
2307,2011-04-10,0,4,23,0,0,0,1,0.46,0.4545,0.88,0.3582,5,27,32,32,2,Malam
2308,2011-04-11,0,4,0,0,1,1,1,0.48,0.4697,0.88,0.3284,7,16,23,23,2,
2309,2011-04-11,0,4,1,0,1,1,1,0.46,0.4545,0.94,0.2836,1,3,4,4,2,Pagi
2310,2011-04-11,0,4,2,0,1,1,1,0.46,0.4545,0.94,0.2836,7,2,9,9,2,Pagi
2311,2011-04-11,0,4,4,0,1,1,1,0.46,0.4545,0.94,0.194,0,1,1,1,2,Pagi
2312,2011-04-11,0,4,5,0,1,1,1,0.46,0.4545,0.94,0.194,1,12,13,13,2,Pagi
2313,2011-04-11,0,4,6,0,1,1,2,0.46,0.4545,1.0,0.2239,2,59,61,61,2,Pagi
2314,2011-04-11,0,4,7,0,1,1,2,0.5,0.4848,0.88,0.2239,12,164,176,176,2,Siang
2315,2011-04-11,0,4,8,0,1,1,2,0.52,0.5,0.88,0.2836,28,286,314,314,2,Siang
2316,2011-04-11,0,4,9,0,1,1,2,0.56,0.5303,0.83,0.2836,33,132,165,165,2,Siang
2317,2011-04-11,0,4,10,0,1,1,2,0.56,0.5303,0.83,0.2985,41,55,96,96,2,Siang
2318,2011-04-11,0,4,11,0,1,1,2,0.6,0.5909,0.73,0.2985,45,59,104,104,2,Siang
2319,2011-04-11,0,4,12,0,1,1,2,0.6,0.5909,0.73,0.3284,37,97,134,134,2,Siang
2320,2011-04-11,0,4,13,0,1,1,2,0.64,0.6061,0.69,0.4179,62,77,139,139,2,Sore
2321,2011-04-11,0,4,14,0,1,1,2,0.72,0.6667,0.54,0.3582,60,85,145,145,2,Sore
2322,2011-04-11,0,4,15,0,1,1,1,0.74,0.6667,0.48,0.5224,56,85,141,141,2,Sore
2323,2011-04-11,0,4,16,0,1,1,1,0.74,0.6667,0.48,0.5224,73,162,235,235,2,Sore
2324,2011-04-11,0,4,17,0,1,1,1,0.74,0.6667,0.48,0.5224,100,352,452,452,2,Sore
2325,2011-04-11,0,4,18,0,1,1,1,0.72,0.6667,0.51,0.3881,93,290,383,383,2,Sore
2326,2011-04-11,0,4,19,0,1,1,1,0.72,0.6667,0.51,0.4478,73,211,284,284,2,Malam
2327,2011-04-11,0,4,20,0,1,1,1,0.68,0.6364,0.57,0.5224,44,122,166,166,2,Malam
2328,2011-04-11,0,4,21,0,1,1,1,0.66,0.6212,0.61,0.2537,39,119,158,158,2,Malam
2329,2011-04-11,0,4,22,0,1,1,2,0.64,0.6212,0.5,0.2836,25,66,91,91,2,Malam
2330,2011-04-11,0,4,23,0,1,1,3,0.58,0.5455,0.6,0.0,16,38,54,54,2,Malam
2331,2011-04-12,0,4,0,0,2,1,2,0.62,0.6212,0.5,0.1045,11,13,24,24,2,
2332,2011-04-12,0,4,1,0,2,1,2,0.62,0.6212,0.5,0.0896,6,7,13,13,2,Pagi
2333,2011-04-12,0,4,2,0,2,1,2,0.6,0.6212,0.53,0.1343,7,7,14,14,2,Pagi
2334,2011-04-12,0,4,3,0,2,1,2,0.58,0.5455,0.56,0.1343,0,1,1,1,2,Pagi
2335,2011-04-12,0,4,4,0,2,1,2,0.56,0.5303,0.64,0.1343,4,2,6,6,2,Pagi
2336,2011-04-12,0,4,5,0,2,1,2,0.54,0.5152,0.68,0.1343,1,15,16,16,2,Pagi
2337,2011-04-12,0,4,6,0,2,1,2,0.54,0.5152,0.68,0.2836,3,55,58,58,2,Pagi
2338,2011-04-12,0,4,7,0,2,1,2,0.54,0.5152,0.68,0.2239,12,177,189,189,2,Siang
2339,2011-04-12,0,4,8,0,2,1,3,0.48,0.4697,0.88,0.3881,15,211,226,226,2,Siang
2340,2011-04-12,0,4,9,0,2,1,3,0.46,0.4545,0.94,0.4925,4,50,54,54,2,Siang
2341,2011-04-12,0,4,10,0,2,1,3,0.5,0.4848,0.82,0.4179,6,34,40,40,2,Siang
2342,2011-04-12,0,4,11,0,2,1,1,0.52,0.5,0.77,0.3582,11,38,49,49,2,Siang
2343,2011-04-12,0,4,12,0,2,1,2,0.56,0.5303,0.64,0.4627,9,83,92,92,2,Siang
2344,2011-04-12,0,4,13,0,2,1,3,0.54,0.5152,0.68,0.2836,22,84,106,106,2,Sore
2345,2011-04-12,0,4,14,0,2,1,2,0.5,0.4848,0.82,0.2836,16,28,44,44,2,Sore
2346,2011-04-12,0,4,15,0,2,1,2,0.48,0.4697,0.77,0.5224,24,54,78,78,2,Sore
2347,2011-04-12,0,4,16,0,2,1,2,0.48,0.4697,0.77,0.3881,19,80,99,99,2,Sore
2348,2011-04-12,0,4,17,0,2,1,3,0.44,0.4394,0.77,0.2239,29,262,291,291,2,Sore
2349,2011-04-12,0,4,18,0,2,1,3,0.44,0.4394,0.77,0.2239,21,203,224,224,2,Sore
2350,2011-04-12,0,4,19,0,2,1,2,0.42,0.4242,0.82,0.2836,3,127,130,130,2,Malam
2351,2011-04-12,0,4,20,0,2,1,2,0.42,0.4242,0.82,0.2836,9,94,103,103,2,Malam
2352,2011-04-12,0,4,21,0,2,1,2,0.42,0.4242,0.82,0.194,10,74,84,84,2,Malam
2353,2011-04-12,0,4,22,0,2,1,2,0.4,0.4091,0.94,0.2985,7,47,54,54,2,Malam
2354,2011-04-12,0,4,23,0,2,1,2,0.4,0.4091,0.94,0.2537,8,31,39,39,2,Malam
2355,2011-04-13,0,4,0,0,3,1,2,0.4,0.4091,1.0,0.2985,3,12,15,15,2,
2356,2011-04-13,0,4,1,0,3,1,2,0.4,0.4091,1.0,0.2985,0,1,1,1,2,Pagi
2357,2011-04-13,0,4,2,0,3,1,3,0.4,0.4091,1.0,0.2985,0,2,2,2,2,Pagi
2358,2011-04-13,0,4,3,0,3,1,3,0.4,0.4091,0.94,0.3284,0,2,2,2,2,Pagi
2359,2011-04-13,0,4,4,0,3,1,3,0.4,0.4091,0.94,0.3284,1,2,3,3,2,Pagi
2360,2011-04-13,0,4,5,0,3,1,3,0.38,0.3939,0.94,0.2537,1,4,5,5,2,Pagi
2361,2011-04-13,0,4,6,0,3,1,3,0.38,0.3939,0.94,0.2239,1,33,34,34,2,Pagi
2362,2011-04-13,0,4,7,0,3,1,3,0.36,0.3485,1.0,0.2239,3,67,70,70,2,Siang
2363,2011-04-13,0,4,8,0,3,1,3,0.38,0.3939,0.94,0.194,6,158,164,164,2,Siang
2364,2011-04-13,0,4,9,0,3,1,2,0.38,0.3939,0.94,0.2239,2,63,65,65,2,Siang
2365,2011-04-13,0,4,10,0,3,1,2,0.4,0.4091,0.87,0.194,4,42,46,46,2,Siang
2366,2011-04-13,0,4,11,0,3,1,2,0.42,0.4242,0.82,0.194,4,57,61,61,2,Siang
2367,2011-04-13,0,4,12,0,3,1,3,0.42,0.4242,0.82,0.2537,12,83,95,95,2,Siang
2368,2011-04-13,0,4,13,0,3,1,2,0.44,0.4394,0.77,0.194,6,55,61,61,2,Sore
2369,2011-04-13,0,4,14,0,3,1,2,0.42,0.4242,0.77,0.2537,24,82,106,106,2,Sore
2370,2011-04-13,0,4,15,0,3,1,2,0.44,0.4394,0.72,0.2836,12,69,81,81,2,Sore
2371,2011-04-13,0,4,16,0,3,1,1,0.46,0.4545,0.67,0.2836,23,119,142,142,2,Sore
2372,2011-04-13,0,4,17,0,3,1,1,0.46,0.4545,0.67,0.2985,25,284,309,309,2,Sore
2373,2011-04-13,0,4,18,0,3,1,1,0.44,0.4394,0.62,0.3881,28,293,321,321,2,Sore
2374,2011-04-13,0,4,19,0,3,1,1,0.44,0.4394,0.62,0.2537,15,160,175,175,2,Malam
2375,2011-04-13,0,4,20,0,3,1,1,0.44,0.4394,0.62,0.2537,7,119,126,126,2,Malam
2376,2011-04-13,0,4,21,0,3,1,1,0.42,0.4242,0.67,0.1642,17,100,117,117,2,Malam
2377,2011-04-13,0,4,22,0,3,1,1,0.42,0.4242,0.67,0.194,10,89,99,99,2,Malam
2378,2011-04-13,0,4,23,0,3,1,1,0.4,0.4091,0.71,0.1343,5,57,62,62,2,Malam
2379,2011-04-14,0,4,0,0,4,1,1,0.38,0.3939,0.76,0.1343,3,18,21,21,2,
2380,2011-04-14,0,4,1,0,4,1,1,0.38,0.3939,0.76,0.2239,1,9,10,10,2,Pagi
2381,2011-04-14,0,4,2,0,4,1,1,0.36,0.3485,0.76,0.1343,0,3,3,3,2,Pagi
2382,2011-04-14,0,4,3,0,4,1,1,0.34,0.3333,0.81,0.1343,0,2,2,2,2,Pagi
2383,2011-04-14,0,4,4,0,4,1,1,0.34,0.3636,0.76,0.0,1,8,9,9,2,Pagi
2384,2011-04-14,0,4,5,0,4,1,1,0.34,0.3485,0.76,0.0896,2,12,14,14,2,Pagi
2385,2011-04-14,0,4,6,0,4,1,1,0.34,0.3485,0.76,0.1045,4,66,70,70,2,Pagi
2386,2011-04-14,0,4,7,0,4,1,1,0.38,0.3939,0.66,0.0,11,182,193,193,2,Siang
2387,2011-04-14,0,4,8,0,4,1,1,0.42,0.4242,0.58,0.1642,21,316,337,337,2,Siang
2388,2011-04-14,0,4,9,0,4,1,1,0.46,0.4545,0.51,0.1343,18,152,170,170,2,Siang
2389,2011-04-14,0,4,10,0,4,1,1,0.5,0.4848,0.51,0.194,21,68,89,89,2,Siang
2390,2011-04-14,0,4,11,0,4,1,1,0.52,0.5,0.45,0.1642,28,87,115,115,2,Siang
2391,2011-04-14,0,4,12,0,4,1,1,0.54,0.5152,0.42,0.1343,35,110,145,145,2,Siang
2392,2011-04-14,0,4,13,0,4,1,1,0.56,0.5303,0.37,0.2239,38,121,159,159,2,Sore
2393,2011-04-14,0,4,14,0,4,1,1,0.56,0.5303,0.35,0.0896,36,101,137,137,2,Sore
2394,2011-04-14,0,4,15,0,4,1,1,0.6,0.6212,0.31,0.0896,57,85,142,142,2,Sore
2395,2011-04-14,0,4,16,0,4,1,1,0.6,0.6061,0.26,0.1045,49,153,202,202,2,Sore
2396,2011-04-14,0,4,17,0,4,1,1,0.6,0.6061,0.28,0.0,50,338,388,388,2,Sore
2397,2011-04-14,0,4,18,0,4,1,1,0.56,0.5303,0.3,0.0,47,290,337,337,2,Sore
2398,2011-04-14,0,4,19,0,4,1,1,0.54,0.5152,0.32,0.0,37,222,259,259,2,Malam
2399,2011-04-14,0,4,20,0,4,1,1,0.5,0.4848,0.51,0.194,22,147,169,169,2,Malam
2400,2011-04-14,0,4,21,0,4,1,1,0.46,0.4545,0.63,0.1343,19,126,145,145,2,Malam
2401,2011-04-14,0,4,22,0,4,1,1,0.48,0.4697,0.55,0.1045,22,82,104,104,2,Malam
2402,2011-04-14,0,4,23,0,4,1,1,0.46,0.4545,0.59,0.1045,7,40,47,47,2,Malam
2403,2011-04-15,0,4,0,1,5,0,1,0.44,0.4394,0.67,0.0,6,21,27,27,2,
2404,2011-04-15,0,4,1,1,5,0,1,0.44,0.4394,0.62,0.0,6,9,15,15,2,Pagi
2405,2011-04-15,0,4,2,1,5,0,1,0.4,0.4091,0.76,0.0,8,10,18,18,2,Pagi
2406,2011-04-15,0,4,3,1,5,0,1,0.4,0.4091,0.76,0.0,0,3,3,3,2,Pagi
2407,2011-04-15,0,4,4,1,5,0,1,0.38,0.3939,0.82,0.0896,0,3,3,3,2,Pagi
2408,2011-04-15,0,4,5,1,5,0,1,0.36,0.3636,0.81,0.1045,2,11,13,13,2,Pagi
2409,2011-04-15,0,4,6,1,5,0,1,0.36,0.3636,0.81,0.0896,5,42,47,47,2,Pagi
2410,2011-04-15,0,4,7,1,5,0,1,0.4,0.4091,0.71,0.1642,10,139,149,149,2,Siang
2411,2011-04-15,0,4,8,1,5,0,1,0.44,0.4394,0.62,0.2985,21,279,300,300,2,Siang
2412,2011-04-15,0,4,9,1,5,0,1,0.5,0.4848,0.55,0.194,16,162,178,178,2,Siang
2413,2011-04-15,0,4,10,1,5,0,1,0.5,0.4848,0.55,0.194,31,91,122,122,2,Siang
2414,2011-04-15,0,4,11,1,5,0,1,0.52,0.5,0.55,0.194,41,95,136,136,2,Siang
2415,2011-04-15,0,4,12,1,5,0,1,0.52,0.5,0.55,0.2836,45,155,200,200,2,Siang
2416,2011-04-15,0,4,13,1,5,0,1,0.54,0.5152,0.52,0.2537,47,133,180,180,2,Sore
2417,2011-04-15,0,4,14,1,5,0,1,0.54,0.5152,0.52,0.2537,57,106,163,163,2,Sore
2418,2011-04-15,0,4,15,1,5,0,1,0.54,0.5152,0.52,0.4478,50,112,162,162,2,Sore
2419,2011-04-15,0,4,16,1,5,0,1,0.52,0.5,0.55,0.4925,70,173,243,243,2,Sore
2420,2011-04-15,0,4,17,1,5,0,2,0.5,0.4848,0.63,0.3881,64,267,331,331,2,Sore
2421,2011-04-15,0,4,18,1,5,0,2,0.46,0.4545,0.67,0.3881,47,216,263,263,2,Sore
2422,2011-04-15,0,4,19,1,5,0,1,0.42,0.4242,0.77,0.3881,41,168,209,209,2,Malam
2423,2011-04-15,0,4,20,1,5,0,2,0.4,0.4091,0.76,0.3284,26,92,118,118,2,Malam
2424,2011-04-15,0,4,21,1,5,0,2,0.4,0.4091,0.76,0.2985,25,77,102,102,2,Malam
2425,2011-04-15,0,4,22,1,5,0,2,0.38,0.3939,0.82,0.3881,16,64,80,80,2,Malam
2426,2011-04-15,0,4,23,1,5,0,2,0.36,0.3485,0.81,0.194,8,56,64,64,2,Malam
2427,2011-04-16,0,4,0,0,6,0,2,0.36,0.3485,0.81,0.2239,7,36,43,43,2,
2428,2011-04-16,0,4,1,0,6,0,2,0.36,0.3333,0.87,0.2836,5,28,33,33,2,Pagi
2429,2011-04-16,0,4,2,0,6,0,2,0.36,0.3485,0.87,0.1343,5,19,24,24,2,Pagi
2430,2011-04-16,0,4,3,0,6,0,2,0.36,0.3485,0.87,0.1642,5,9,14,14,2,Pagi
2431,2011-04-16,0,4,4,0,6,0,2,0.36,0.3485,0.87,0.2239,1,4,5,5,2,Pagi
2432,2011-04-16,0,4,5,0,6,0,2,0.38,0.3939,0.87,0.2836,1,3,4,4,2,Pagi
2433,2011-04-16,0,4,6,0,6,0,3,0.4,0.4091,0.82,0.3284,1,9,10,10,2,Pagi
2434,2011-04-16,0,4,7,0,6,0,2,0.4,0.4091,0.82,0.4179,3,18,21,21,2,Siang
2435,2011-04-16,0,4,8,0,6,0,3,0.4,0.4091,0.87,0.3582,7,38,45,45,2,Siang
2436,2011-04-16,0,4,9,0,6,0,3,0.4,0.4091,1.0,0.2985,2,27,29,29,2,Siang
2437,2011-04-16,0,4,10,0,6,0,3,0.42,0.4242,0.94,0.3881,1,21,22,22,2,Siang
2438,2011-04-16,0,4,11,0,6,0,3,0.42,0.4242,0.94,0.4478,4,27,31,31,2,Siang
2439,2011-04-16,0,4,12,0,6,0,2,0.46,0.4545,0.88,0.5821,6,26,32,32,2,Siang
2440,2011-04-16,0,4,13,0,6,0,3,0.46,0.4545,0.94,0.5224,9,49,58,58,2,Sore
2441,2011-04-16,0,4,14,0,6,0,3,0.52,0.5,0.83,0.5821,14,49,63,63,2,Sore
2442,2011-04-16,0,4,15,0,6,0,3,0.52,0.5,0.83,0.5821,16,62,78,78,2,Sore
2443,2011-04-16,0,4,16,0,6,0,3,0.5,0.4848,0.88,0.4627,6,27,33,33,2,Sore
2444,2011-04-16,0,4,17,0,6,0,3,0.5,0.4848,0.88,0.5821,1,14,15,15,2,Sore
2445,2011-04-16,0,4,18,0,6,0,2,0.5,0.4848,0.94,0.3881,6,32,38,38,2,Sore
2446,2011-04-16,0,4,19,0,6,0,2,0.52,0.5,0.94,0.4179,9,62,71,71,2,Malam
2447,2011-04-16,0,4,20,0,6,0,3,0.44,0.4394,0.94,0.2239,4,49,53,53,2,Malam
2448,2011-04-16,0,4,21,0,6,0,2,0.44,0.4394,0.94,0.0,1,13,14,14,2,Malam
2449,2011-04-16,0,4,22,0,6,0,3,0.42,0.4242,1.0,0.0,2,22,24,24,2,Malam
2450,2011-04-16,0,4,23,0,6,0,2,0.44,0.4394,0.77,0.2836,5,30,35,35,2,Malam
2451,2011-04-17,0,4,0,0,0,0,2,0.44,0.4394,0.77,0.2836,4,29,33,33,2,
2452,2011-04-17,0,4,1,0,0,0,1,0.42,0.4242,0.67,0.2239,6,25,31,31,2,Pagi
2453,2011-04-17,0,4,2,0,0,0,1,0.4,0.4091,0.62,0.194,4,25,29,29,2,Pagi
2454,2011-04-17,0,4,3,0,0,0,1,0.4,0.4091,0.66,0.1343,12,13,25,25,2,Pagi
2455,2011-04-17,0,4,4,0,0,0,1,0.36,0.3636,0.76,0.1045,2,5,7,7,2,Pagi
2456,2011-04-17,0,4,5,0,0,0,1,0.36,0.3485,0.71,0.1642,2,1,3,3,2,Pagi
2457,2011-04-17,0,4,6,0,0,0,1,0.36,0.3182,0.66,0.4478,3,5,8,8,2,Pagi
2458,2011-04-17,0,4,7,0,0,0,1,0.36,0.3333,0.5,0.3582,2,14,16,16,2,Siang
2459,2011-04-17,0,4,8,0,0,0,1,0.38,0.3939,0.46,0.3881,7,36,43,43,2,Siang
2460,2011-04-17,0,4,9,0,0,0,1,0.4,0.4091,0.43,0.2836,31,71,102,102,2,Siang
2461,2011-04-17,0,4,10,0,0,0,1,0.42,0.4242,0.44,0.4478,91,120,211,211,2,Siang
2462,2011-04-17,0,4,11,0,0,0,1,0.46,0.4545,0.41,0.4179,119,185,304,304,2,Siang
2463,2011-04-17,0,4,12,0,0,0,1,0.46,0.4545,0.38,0.3881,167,187,354,354,2,Siang
2464,2011-04-17,0,4,13,0,0,0,1,0.5,0.4848,0.34,0.3881,181,162,343,343,2,Sore
2465,2011-04-17,0,4,14,0,0,0,1,0.52,0.5,0.34,0.3881,170,191,361,361,2,Sore
2466,2011-04-17,0,4,15,0,0,0,1,0.54,0.5152,0.32,0.5224,179,209,388,388,2,Sore
2467,2011-04-17,0,4,16,0,0,0,1,0.54,0.5152,0.3,0.3582,161,182,343,343,2,Sore
2468,2011-04-17,0,4,17,0,0,0,1,0.56,0.5303,0.3,0.4478,143,163,306,306,2,Sore
2469,2011-04-17,0,4,18,0,0,0,1,0.56,0.5303,0.3,0.3881,102,175,277,277,2,Sore
2470,2011-04-17,0,4,19,0,0,0,1,0.56,0.5303,0.3,0.2985,75,135,210,210,2,Malam
2471,2011-04-17,0,4,20,0,0,0,1,0.52,0.5,0.36,0.194,44,97,141,141,2,Malam
2472,2011-04-17,0,4,21,0,0,0,1,0.5,0.4848,0.42,0.194,13,70,83,83,2,Malam
2473,2011-04-17,0,4,22,0,0,0,1,0.5,0.4848,0.39,0.1045,21,49,70,70,2,Malam
2474,2011-04-17,0,4,23,0,0,0,1,0.44,0.4394,0.67,0.1642,19,37,56,56,2,Malam
2475,2011-04-18,0,4,0,0,1,1,1,0.46,0.4545,0.47,0.0896,15,24,39,39,2,
2476,2011-04-18,0,4,1,0,1,1,1,0.46,0.4545,0.47,0.1343,11,8,19,19,2,Pagi
2477,2011-04-18,0,4,2,0,1,1,1,0.42,0.4242,0.67,0.1045,14,2,16,16,2,Pagi
2478,2011-04-18,0,4,3,0,1,1,1,0.42,0.4242,0.62,0.1045,6,1,7,7,2,Pagi
2479,2011-04-18,0,4,4,0,1,1,1,0.4,0.4091,0.87,0.1642,2,4,6,6,2,Pagi
2480,2011-04-18,0,4,5,0,1,1,1,0.4,0.4091,0.76,0.0896,0,16,16,16,2,Pagi
2481,2011-04-18,0,4,6,0,1,1,1,0.4,0.4091,0.82,0.0,3,51,54,54,2,Pagi
2482,2011-04-18,0,4,7,0,1,1,1,0.46,0.4545,0.63,0.0,12,156,168,168,2,Siang
2483,2011-04-18,0,4,8,0,1,1,1,0.46,0.4545,0.63,0.0,20,277,297,297,2,Siang
2484,2011-04-18,0,4,9,0,1,1,2,0.5,0.4848,0.55,0.1045,37,132,169,169,2,Siang
2485,2011-04-18,0,4,10,0,1,1,2,0.52,0.5,0.55,0.1045,41,68,109,109,2,Siang
2486,2011-04-18,0,4,11,0,1,1,2,0.54,0.5152,0.52,0.0896,36,87,123,123,2,Siang
2487,2011-04-18,0,4,12,0,1,1,2,0.56,0.5303,0.49,0.0896,60,124,184,184,2,Siang
2488,2011-04-18,0,4,13,0,1,1,2,0.56,0.5303,0.49,0.1642,41,128,169,169,2,Sore
2489,2011-04-18,0,4,14,0,1,1,2,0.58,0.5455,0.49,0.194,49,95,144,144,2,Sore
2490,2011-04-18,0,4,15,0,1,1,2,0.6,0.6212,0.43,0.194,64,112,176,176,2,Sore
2491,2011-04-18,0,4,16,0,1,1,1,0.6,0.6212,0.46,0.2836,40,165,205,205,2,Sore
2492,2011-04-18,0,4,17,0,1,1,1,0.58,0.5455,0.49,0.2836,66,362,428,428,2,Sore
2493,2011-04-18,0,4,18,0,1,1,1,0.64,0.6212,0.31,0.3582,41,321,362,362,2,Sore
2494,2011-04-18,0,4,19,0,1,1,1,0.56,0.5303,0.46,0.2537,42,244,286,286,2,Malam
2495,2011-04-18,0,4,20,0,1,1,1,0.6,0.6212,0.33,0.2985,29,136,165,165,2,Malam
2496,2011-04-18,0,4,21,0,1,1,1,0.56,0.5303,0.37,0.2836,20,131,151,151,2,Malam
2497,2011-04-18,0,4,22,0,1,1,1,0.52,0.5,0.55,0.2836,9,81,90,90,2,Malam
2498,2011-04-18,0,4,23,0,1,1,1,0.5,0.4848,0.59,0.2537,11,35,46,46,2,Malam
2499,2011-04-19,0,4,0,0,2,1,1,0.5,0.4848,0.55,0.2239,2,23,25,25,2,
2500,2011-04-19,0,4,1,0,2,1,1,0.46,0.4545,0.63,0.2239,5,2,7,7,2,Pagi
2501,2011-04-19,0,4,2,0,2,1,1,0.46,0.4545,0.67,0.2836,8,5,13,13,2,Pagi
2502,2011-04-19,0,4,3,0,2,1,1,0.48,0.4697,0.63,0.2239,0,3,3,3,2,Pagi
2503,2011-04-19,0,4,4,0,2,1,1,0.46,0.4545,0.67,0.0896,1,4,5,5,2,Pagi
2504,2011-04-19,0,4,5,0,2,1,2,0.46,0.4545,0.72,0.194,1,17,18,18,2,Pagi
2505,2011-04-19,0,4,6,0,2,1,2,0.48,0.4697,0.67,0.0,2,63,65,65,2,Pagi
2506,2011-04-19,0,4,7,0,2,1,2,0.52,0.5,0.55,0.0,22,166,188,188,2,Siang
2507,2011-04-19,0,4,8,0,2,1,2,0.5,0.4848,0.68,0.1343,20,331,351,351,2,Siang
2508,2011-04-19,0,4,9,0,2,1,3,0.52,0.5,0.63,0.0896,23,139,162,162,2,Siang
2509,2011-04-19,0,4,10,0,2,1,2,0.5,0.4848,0.72,0.2239,15,60,75,75,2,Siang
2510,2011-04-19,0,4,11,0,2,1,2,0.54,0.5152,0.68,0.1642,19,53,72,72,2,Siang
2511,2011-04-19,0,4,12,0,2,1,2,0.54,0.5152,0.64,0.0896,19,84,103,103,2,Siang
2512,2011-04-19,0,4,13,0,2,1,2,0.54,0.5152,0.68,0.2239,26,103,129,129,2,Sore
2513,2011-04-19,0,4,14,0,2,1,2,0.54,0.5152,0.64,0.194,19,88,107,107,2,Sore
2514,2011-04-19,0,4,15,0,2,1,2,0.54,0.5152,0.65,0.1642,44,83,127,127,2,Sore
2515,2011-04-19,0,4,16,0,2,1,1,0.56,0.5303,0.52,0.2985,30,162,192,192,2,Sore
2516,2011-04-19,0,4,17,0,2,1,1,0.56,0.5303,0.6,0.1045,39,372,411,411,2,Sore
2517,2011-04-19,0,4,18,0,2,1,2,0.54,0.5152,0.64,0.1343,44,377,421,421,2,Sore
2518,2011-04-19,0,4,19,0,2,1,2,0.5,0.4848,0.72,0.194,28,248,276,276,2,Malam
2519,2011-04-19,0,4,20,0,2,1,2,0.5,0.4848,0.72,0.2239,20,148,168,168,2,Malam
2520,2011-04-19,0,4,21,0,2,1,2,0.5,0.4848,0.72,0.1343,8,114,122,122,2,Malam
2521,2011-04-19,0,4,22,0,2,1,1,0.48,0.4697,0.77,0.0896,3,109,112,112,2,Malam
2522,2011-04-19,0,4,23,0,2,1,1,0.46,0.4545,0.88,0.0896,11,41,52,52,2,Malam
2523,2011-04-20,0,4,0,0,3,1,1,0.44,0.4394,0.88,0.1343,4,29,33,33,2,
2524,2011-04-20,0,4,1,0,3,1,1,0.42,0.4242,0.94,0.1642,2,5,7,7,2,Pagi
2525,2011-04-20,0,4,2,0,3,1,1,0.42,0.4242,0.94,0.1642,0,2,2,2,2,Pagi
2526,2011-04-20,0,4,3,0,3,1,1,0.42,0.4242,0.94,0.0,0,2,2,2,2,Pagi
2527,2011-04-20,0,4,4,0,3,1,1,0.4,0.4091,1.0,0.1045,5,4,9,9,2,Pagi
2528,2011-04-20,0,4,5,0,3,1,1,0.4,0.4091,0.94,0.194,1,14,15,15,2,Pagi
2529,2011-04-20,0,4,6,0,3,1,1,0.42,0.4242,0.94,0.1642,2,62,64,64,2,Pagi
2530,2011-04-20,0,4,7,0,3,1,1,0.44,0.4394,0.94,0.0,26,211,237,237,2,Siang
2531,2011-04-20,0,4,8,0,3,1,1,0.62,0.6061,0.69,0.4627,22,374,396,396,2,Siang
2532,2011-04-20,0,4,9,0,3,1,1,0.66,0.6212,0.61,0.2836,27,170,197,197,2,Siang
2533,2011-04-20,0,4,10,0,3,1,1,0.62,0.6061,0.69,0.0896,45,86,131,131,2,Siang
2534,2011-04-20,0,4,11,0,3,1,1,0.62,0.6061,0.69,0.0896,31,87,118,118,2,Siang
2535,2011-04-20,0,4,12,0,3,1,1,0.7,0.6515,0.48,0.3881,28,117,145,145,2,Siang
2536,2011-04-20,0,4,13,0,3,1,1,0.7,0.6515,0.48,0.3881,42,135,177,177,2,Sore
2537,2011-04-20,0,4,14,0,3,1,1,0.74,0.6515,0.4,0.4627,33,115,148,148,2,Sore
2538,2011-04-20,0,4,15,0,3,1,2,0.76,0.6667,0.35,0.3582,32,113,145,145,2,Sore
2539,2011-04-20,0,4,16,0,3,1,2,0.76,0.6667,0.35,0.3582,54,201,255,255,2,Sore
2540,2011-04-20,0,4,17,0,3,1,2,0.74,0.6515,0.37,0.4179,34,398,432,432,2,Sore
2541,2011-04-20,0,4,18,0,3,1,1,0.74,0.6515,0.3,0.3582,56,385,441,441,2,Sore
2542,2011-04-20,0,4,19,0,3,1,1,0.7,0.6364,0.32,0.2537,74,309,383,383,2,Malam
2543,2011-04-20,0,4,20,0,3,1,1,0.68,0.6212,0.32,0.1045,31,194,225,225,2,Malam
2544,2011-04-20,0,4,21,0,3,1,1,0.66,0.6212,0.36,0.2836,38,134,172,172,2,Malam
2545,2011-04-20,0,4,22,0,3,1,1,0.62,0.6212,0.41,0.2537,12,105,117,117,2,Malam
2546,2011-04-20,0,4,23,0,3,1,1,0.6,0.6212,0.4,0.3284,14,79,93,93,2,Malam
2547,2011-04-21,0,4,0,0,4,1,1,0.56,0.5303,0.43,0.3582,11,33,44,44,2,
2548,2011-04-21,0,4,1,0,4,1,1,0.52,0.5,0.45,0.2239,6,20,26,26,2,Pagi
2549,2011-04-21,0,4,2,0,4,1,1,0.5,0.4848,0.42,0.3881,3,10,13,13,2,Pagi
2550,2011-04-21,0,4,3,0,4,1,2,0.46,0.4545,0.51,0.4627,4,3,7,7,2,Pagi
2551,2011-04-21,0,4,4,0,4,1,2,0.44,0.4394,0.54,0.4478,2,4,6,6,2,Pagi
2552,2011-04-21,0,4,5,0,4,1,2,0.42,0.4242,0.54,0.5522,0,14,14,14,2,Pagi
2553,2011-04-21,0,4,6,0,4,1,2,0.4,0.4091,0.58,0.5821,2,73,75,75,2,Pagi
2554,2011-04-21,0,4,7,0,4,1,2,0.42,0.4242,0.47,0.4627,15,183,198,198,2,Siang
2555,2011-04-21,0,4,8,0,4,1,2,0.4,0.4091,0.5,0.4925,19,346,365,365,2,Siang
2556,2011-04-21,0,4,9,0,4,1,2,0.42,0.4242,0.47,0.2836,18,178,196,196,2,Siang
2557,2011-04-21,0,4,10,0,4,1,1,0.42,0.4242,0.44,0.3582,25,73,98,98,2,Siang
2558,2011-04-21,0,4,11,0,4,1,1,0.44,0.4394,0.41,0.2836,34,99,133,133,2,Siang
2559,2011-04-21,0,4,12,0,4,1,1,0.46,0.4545,0.38,0.1642,49,150,199,199,2,Siang
2560,2011-04-21,0,4,13,0,4,1,1,0.48,0.4697,0.33,0.3284,55,122,177,177,2,Sore
2561,2011-04-21,0,4,14,0,4,1,1,0.5,0.4848,0.34,0.3881,68,160,228,228,2,Sore
2562,2011-04-21,0,4,15,0,4,1,1,0.52,0.5,0.29,0.4179,69,166,235,235,2,Sore
2563,2011-04-21,0,4,16,0,4,1,1,0.52,0.5,0.27,0.3582,66,228,294,294,2,Sore
2564,2011-04-21,0,4,17,0,4,1,1,0.5,0.4848,0.29,0.1642,79,402,481,481,2,Sore
2565,2011-04-21,0,4,18,0,4,1,1,0.5,0.4848,0.25,0.2836,71,381,452,452,2,Sore
2566,2011-04-21,0,4,19,0,4,1,1,0.46,0.4545,0.28,0.2836,52,272,324,324,2,Malam
2567,2011-04-21,0,4,20,0,4,1,1,0.44,0.4394,0.3,0.1343,28,176,204,204,2,Malam
2568,2011-04-21,0,4,21,0,4,1,1,0.42,0.4242,0.47,0.194,25,159,184,184,2,Malam
2569,2011-04-21,0,4,22,0,4,1,1,0.42,0.4242,0.38,0.0896,31,106,137,137,2,Malam
2570,2011-04-21,0,4,23,0,4,1,1,0.4,0.4091,0.43,0.1045,13,86,99,99,2,Malam
2571,2011-04-22,0,4,0,0,5,1,1,0.36,0.3485,0.62,0.194,3,30,33,33,2,
2572,2011-04-22,0,4,1,0,5,1,1,0.36,0.3333,0.53,0.2537,2,22,24,24,2,Pagi
2573,2011-04-22,0,4,2,0,5,1,1,0.36,0.3333,0.53,0.2985,2,7,9,9,2,Pagi
2574,2011-04-22,0,4,3,0,5,1,1,0.36,0.3333,0.53,0.2985,0,2,2,2,2,Pagi
2575,2011-04-22,0,4,4,0,5,1,1,0.34,0.3182,0.53,0.2836,1,2,3,3,2,Pagi
2576,2011-04-22,0,4,5,0,5,1,1,0.34,0.3182,0.53,0.2239,0,16,16,16,2,Pagi
2577,2011-04-22,0,4,6,0,5,1,1,0.34,0.3182,0.53,0.2836,2,47,49,49,2,Pagi
2578,2011-04-22,0,4,7,0,5,1,2,0.34,0.3182,0.53,0.2836,5,175,180,180,2,Siang
2579,2011-04-22,0,4,8,0,5,1,2,0.34,0.3182,0.53,0.2537,15,331,346,346,2,Siang
2580,2011-04-22,0,4,9,0,5,1,3,0.34,0.303,0.61,0.2985,17,178,195,195,2,Siang
2581,2011-04-22,0,4,10,0,5,1,2,0.36,0.3485,0.62,0.194,32,104,136,136,2,Siang
2582,2011-04-22,0,4,11,0,5,1,3,0.34,0.3333,0.66,0.194,23,83,106,106,2,Siang
2583,2011-04-22,0,4,12,0,5,1,3,0.34,0.3333,0.76,0.1343,19,61,80,80,2,Siang
2584,2011-04-22,0,4,13,0,5,1,3,0.34,0.3333,0.87,0.194,3,37,40,40,2,Sore
2585,2011-04-22,0,4,14,0,5,1,3,0.34,0.3182,0.87,0.2537,3,33,36,36,2,Sore
2586,2011-04-22,0,4,15,0,5,1,3,0.34,0.3333,0.87,0.194,13,62,75,75,2,Sore
2587,2011-04-22,0,4,16,0,5,1,3,0.34,0.3333,0.87,0.1343,4,58,62,62,2,Sore
2588,2011-04-22,0,4,17,0,5,1,3,0.32,0.303,0.93,0.2239,6,63,69,69,2,Sore
2589,2011-04-22,0,4,18,0,5,1,3,0.32,0.303,0.93,0.2239,4,47,51,51,2,Sore
2590,2011-04-22,0,4,19,0,5,1,3,0.32,0.303,0.93,0.2239,7,48,55,55,2,Malam
2591,2011-04-22,0,4,20,0,5,1,3,0.32,0.303,0.87,0.2239,8,39,47,47,2,Malam
2592,2011-04-22,0,4,21,0,5,1,3,0.3,0.303,0.93,0.1642,5,23,28,28,2,Malam
2593,2011-04-22,0,4,22,0,5,1,3,0.3,0.303,1.0,0.1343,3,21,24,24,2,Malam
2594,2011-04-22,0,4,23,0,5,1,3,0.32,0.3333,0.93,0.1045,0,17,17,17,2,Malam
2595,2011-04-23,0,4,0,0,6,0,2,0.32,0.3182,1.0,0.194,0,18,18,18,2,
2596,2011-04-23,0,4,1,0,6,0,2,0.32,0.3182,1.0,0.194,5,11,16,16,2,Pagi
2597,2011-04-23,0,4,2,0,6,0,3,0.32,0.3333,1.0,0.1343,3,14,17,17,2,Pagi
2598,2011-04-23,0,4,3,0,6,0,3,0.32,0.3333,1.0,0.0896,0,4,4,4,2,Pagi
2599,2011-04-23,0,4,4,0,6,0,3,0.34,0.3636,1.0,0.0,2,3,5,5,2,Pagi
2600,2011-04-23,0,4,5,0,6,0,3,0.34,0.3636,1.0,0.0,1,6,7,7,2,Pagi
2601,2011-04-23,0,4,6,0,6,0,2,0.34,0.3333,1.0,0.1642,0,11,11,11,2,Pagi
2602,2011-04-23,0,4,7,0,6,0,3,0.34,0.3333,1.0,0.1642,2,17,19,19,2,Siang
2603,2011-04-23,0,4,8,0,6,0,2,0.36,0.3333,1.0,0.2537,15,32,47,47,2,Siang
2604,2011-04-23,0,4,9,0,6,0,2,0.38,0.3939,0.94,0.2985,13,55,68,68,2,Siang
2605,2011-04-23,0,4,10,0,6,0,2,0.42,0.4242,0.88,0.2239,36,93,129,129,2,Siang
2606,2011-04-23,0,4,11,0,6,0,2,0.46,0.4545,0.88,0.2239,68,164,232,232,2,Siang
2607,2011-04-23,0,4,12,0,6,0,1,0.52,0.5,0.83,0.4179,94,197,291,291,2,Siang
2608,2011-04-23,0,4,13,0,6,0,1,0.52,0.5,0.83,0.3881,126,186,312,312,2,Sore
2609,2011-04-23,0,4,14,0,6,0,1,0.58,0.5455,0.78,0.3582,182,209,391,391,2,Sore
2610,2011-04-23,0,4,15,0,6,0,1,0.6,0.5909,0.73,0.3881,171,226,397,397,2,Sore
2611,2011-04-23,0,4,16,0,6,0,1,0.6,0.5909,0.73,0.2836,180,246,426,426,2,Sore
2612,2011-04-23,0,4,17,0,6,0,1,0.6,0.5909,0.73,0.3284,168,215,383,383,2,Sore
2613,2011-04-23,0,4,18,0,6,0,1,0.58,0.5455,0.78,0.194,149,227,376,376,2,Sore
2614,2011-04-23,0,4,19,0,6,0,1,0.56,0.5303,0.83,0.2836,84,199,283,283,2,Malam
2615,2011-04-23,0,4,20,0,6,0,2,0.54,0.5152,0.88,0.2537,45,138,183,183,2,Malam
2616,2011-04-23,0,4,21,0,6,0,2,0.56,0.5303,0.83,0.2836,32,103,135,135,2,Malam
2617,2011-04-23,0,4,22,0,6,0,2,0.58,0.5455,0.78,0.2537,55,114,169,169,2,Malam
2618,2011-04-23,0,4,23,0,6,0,2,0.54,0.5152,0.88,0.1642,31,86,117,117,2,Malam
2619,2011-04-24,0,4,0,0,0,0,1,0.52,0.5,0.83,0.2239,30,66,96,96,2,
2620,2011-04-24,0,4,1,0,0,0,1,0.5,0.4848,0.88,0.194,14,40,54,54,2,Pagi
2621,2011-04-24,0,4,2,0,0,0,1,0.5,0.4848,0.88,0.194,27,45,72,72,2,Pagi
2622,2011-04-24,0,4,3,0,0,0,1,0.5,0.4848,0.94,0.0896,4,20,24,24,2,Pagi
2623,2011-04-24,0,4,4,0,0,0,1,0.5,0.4848,0.94,0.0896,0,5,5,5,2,Pagi
2624,2011-04-24,0,4,5,0,0,0,1,0.5,0.4848,0.94,0.0896,5,7,12,12,2,Pagi
2625,2011-04-24,0,4,6,0,0,0,2,0.5,0.4848,1.0,0.0,10,3,13,13,2,Pagi
2626,2011-04-24,0,4,7,0,0,0,2,0.5,0.4848,1.0,0.0,16,11,27,27,2,Siang
2627,2011-04-24,0,4,8,0,0,0,1,0.52,0.5,0.94,0.2239,38,42,80,80,2,Siang
2628,2011-04-24,0,4,9,0,0,0,1,0.56,0.5303,0.88,0.2537,73,104,177,177,2,Siang
2629,2011-04-24,0,4,10,0,0,0,1,0.6,0.5758,0.78,0.1642,118,171,289,289,2,Siang
2630,2011-04-24,0,4,11,0,0,0,1,0.66,0.6212,0.65,0.1343,124,193,317,317,2,Siang
2631,2011-04-24,0,4,12,0,0,0,1,0.68,0.6364,0.65,0.2537,168,220,388,388,2,Siang
2632,2011-04-24,0,4,13,0,0,0,1,0.7,0.6515,0.58,0.2836,205,236,441,441,2,Sore
2633,2011-04-24,0,4,14,0,0,0,1,0.7,0.6515,0.54,0.3284,197,223,420,420,2,Sore
2634,2011-04-24,0,4,15,0,0,0,1,0.66,0.6212,0.61,0.2537,167,202,369,369,2,Sore
2635,2011-04-24,0,4,16,0,0,0,1,0.74,0.6667,0.48,0.3881,162,197,359,359,2,Sore
2636,2011-04-24,0,4,17,0,0,0,1,0.66,0.6212,0.65,0.2985,142,189,331,331,2,Sore
2637,2011-04-24,0,4,18,0,0,0,1,0.64,0.6061,0.69,0.1642,96,174,270,270,2,Sore
2638,2011-04-24,0,4,19,0,0,0,3,0.6,0.5606,0.83,0.2836,62,132,194,194,2,Malam
2639,2011-04-24,0,4,20,0,0,0,3,0.6,0.5606,0.83,0.2836,34,71,105,105,2,Malam
2640,2011-04-24,0,4,21,0,0,0,3,0.54,0.5152,0.94,0.1642,8,53,61,61,2,Malam
2641,2011-04-24,0,4,22,0,0,0,3,0.54,0.5152,1.0,0.1642,5,40,45,45,2,Malam
2642,2011-04-24,0,4,23,0,0,0,3,0.54,0.5152,1.0,0.0896,5,37,42,42,2,Malam
2643,2011-04-25,0,4,0,0,1,1,3,0.52,0.5,1.0,0.0,2,10,12,12,2,
2644,2011-04-25,0,4,1,0,1,1,1,0.54,0.5152,1.0,0.0896,2,8,10,10,2,Pagi
2645,2011-04-25,0,4,2,0,1,1,1,0.54,0.5152,1.0,0.0896,1,9,10,10,2,Pagi
2646,2011-04-25,0,4,3,0,1,1,2,0.5,0.4848,1.0,0.1045,2,8,10,10,2,Pagi
2647,2011-04-25,0,4,4,0,1,1,2,0.52,0.5,1.0,0.0,1,4,5,5,2,Pagi
2648,2011-04-25,0,4,5,0,1,1,2,0.46,0.4545,1.0,0.0,3,14,17,17,2,Pagi
2649,2011-04-25,0,4,6,0,1,1,2,0.5,0.4848,1.0,0.0,7,59,66,66,2,Pagi
2650,2011-04-25,0,4,7,0,1,1,2,0.52,0.5,1.0,0.0896,13,183,196,196,2,Siang
2651,2011-04-25,0,4,8,0,1,1,1,0.56,0.5303,0.88,0.1045,27,326,353,353,2,Siang
2652,2011-04-25,0,4,9,0,1,1,1,0.6,0.5606,0.83,0.1343,27,147,174,174,2,Siang
2653,2011-04-25,0,4,10,0,1,1,1,0.64,0.6061,0.73,0.2239,61,64,125,125,2,Siang
2654,2011-04-25,0,4,11,0,1,1,1,0.64,0.6061,0.73,0.2239,53,94,147,147,2,Siang
2655,2011-04-25,0,4,12,0,1,1,1,0.66,0.6212,0.74,0.2537,48,140,188,188,2,Siang
2656,2011-04-25,0,4,13,0,1,1,1,0.7,0.6515,0.65,0.2239,57,146,203,203,2,Sore
2657,2011-04-25,0,4,14,0,1,1,1,0.72,0.6667,0.54,0.2239,47,99,146,146,2,Sore
2658,2011-04-25,0,4,15,0,1,1,1,0.74,0.6667,0.51,0.2239,50,125,175,175,2,Sore
2659,2011-04-25,0,4,16,0,1,1,1,0.7,0.6515,0.54,0.3582,41,198,239,239,2,Sore
2660,2011-04-25,0,4,17,0,1,1,1,0.7,0.6515,0.54,0.2985,80,441,521,521,2,Sore
2661,2011-04-25,0,4,18,0,1,1,1,0.68,0.6364,0.57,0.3582,74,425,499,499,2,Sore
2662,2011-04-25,0,4,19,0,1,1,1,0.66,0.6212,0.57,0.3284,62,320,382,382,2,Malam
2663,2011-04-25,0,4,20,0,1,1,1,0.66,0.6212,0.61,0.2836,42,195,237,237,2,Malam
2664,2011-04-25,0,4,21,0,1,1,1,0.62,0.6061,0.69,0.2537,41,149,190,190,2,Malam
2665,2011-04-25,0,4,22,0,1,1,1,0.6,0.5909,0.73,0.2985,23,83,106,106,2,Malam
2666,2011-04-25,0,4,23,0,1,1,1,0.58,0.5455,0.78,0.2836,9,53,62,62,2,Malam
2667,2011-04-26,0,4,0,0,2,1,1,0.62,0.6061,0.69,0.2836,10,17,27,27,2,
2668,2011-04-26,0,4,1,0,2,1,1,0.62,0.5909,0.73,0.2836,16,5,21,21,2,Pagi
2669,2011-04-26,0,4,2,0,2,1,1,0.56,0.5303,0.83,0.3284,17,9,26,26,2,Pagi
2670,2011-04-26,0,4,3,0,2,1,1,0.54,0.5152,0.88,0.2836,17,4,21,21,2,Pagi
2671,2011-04-26,0,4,4,0,2,1,1,0.56,0.5303,0.83,0.2537,2,4,6,6,2,Pagi
2672,2011-04-26,0,4,5,0,2,1,1,0.54,0.5152,0.88,0.2537,0,16,16,16,2,Pagi
2673,2011-04-26,0,4,6,0,2,1,1,0.56,0.5303,0.88,0.2239,0,80,80,80,2,Pagi
2674,2011-04-26,0,4,7,0,2,1,1,0.58,0.5455,0.83,0.2985,16,254,270,270,2,Siang
2675,2011-04-26,0,4,8,0,2,1,1,0.58,0.5455,0.83,0.2985,32,417,449,449,2,Siang
2676,2011-04-26,0,4,9,0,2,1,1,0.64,0.6061,0.73,0.3582,35,164,199,199,2,Siang
2677,2011-04-26,0,4,10,0,2,1,1,0.66,0.6212,0.69,0.3582,22,98,120,120,2,Siang
2678,2011-04-26,0,4,11,0,2,1,1,0.68,0.6364,0.65,0.3881,40,132,172,172,2,Siang
2679,2011-04-26,0,4,12,0,2,1,1,0.7,0.6515,0.61,0.4179,40,146,186,186,2,Siang
2680,2011-04-26,0,4,13,0,2,1,1,0.74,0.6667,0.51,0.4478,37,139,176,176,2,Sore
2681,2011-04-26,0,4,14,0,2,1,1,0.72,0.6667,0.58,0.3284,40,115,155,155,2,Sore
2682,2011-04-26,0,4,15,0,2,1,1,0.7,0.6515,0.61,0.3582,34,119,153,153,2,Sore
2683,2011-04-26,0,4,16,0,2,1,1,0.7,0.6515,0.58,0.3881,40,251,291,291,2,Sore
2684,2011-04-26,0,4,17,0,2,1,1,0.68,0.6364,0.61,0.3582,66,455,521,521,2,Sore
2685,2011-04-26,0,4,18,0,2,1,1,0.68,0.6364,0.65,0.4478,65,463,528,528,2,Sore
2686,2011-04-26,0,4,19,0,2,1,1,0.64,0.6061,0.73,0.4179,42,286,328,328,2,Malam
2687,2011-04-26,0,4,20,0,2,1,1,0.64,0.6061,0.73,0.3582,35,199,234,234,2,Malam
2688,2011-04-26,0,4,21,0,2,1,1,0.62,0.5909,0.78,0.2836,33,162,195,195,2,Malam
2689,2011-04-26,0,4,22,0,2,1,2,0.6,0.5606,0.83,0.194,32,116,148,148,2,Malam
2690,2011-04-26,0,4,23,0,2,1,2,0.6,0.5606,0.83,0.2239,7,71,78,78,2,Malam
2691,2011-04-27,0,4,0,0,3,1,1,0.6,0.5606,0.83,0.2239,3,24,27,27,2,
2692,2011-04-27,0,4,1,0,3,1,1,0.6,0.5606,0.83,0.2537,2,15,17,17,2,Pagi
2693,2011-04-27,0,4,2,0,3,1,1,0.58,0.5455,0.88,0.2537,0,5,5,5,2,Pagi
2694,2011-04-27,0,4,3,0,3,1,2,0.58,0.5455,0.88,0.2836,3,4,7,7,2,Pagi
2695,2011-04-27,0,4,4,0,3,1,1,0.56,0.5303,0.94,0.2239,0,6,6,6,2,Pagi
2696,2011-04-27,0,4,5,0,3,1,2,0.56,0.5303,0.94,0.2537,1,16,17,17,2,Pagi
2697,2011-04-27,0,4,6,0,3,1,1,0.56,0.5303,0.94,0.2537,5,79,84,84,2,Pagi
2698,2011-04-27,0,4,7,0,3,1,2,0.58,0.5455,0.88,0.2836,17,229,246,246,2,Siang
2699,2011-04-27,0,4,8,0,3,1,2,0.58,0.5455,0.88,0.3284,31,413,444,444,2,Siang
2700,2011-04-27,0,4,9,0,3,1,2,0.6,0.5455,0.88,0.4179,20,161,181,181,2,Siang
2701,2011-04-27,0,4,10,0,3,1,2,0.62,0.5758,0.83,0.2836,26,66,92,92,2,Siang
2702,2011-04-27,0,4,11,0,3,1,2,0.64,0.5909,0.78,0.2836,53,103,156,156,2,Siang
2703,2011-04-27,0,4,12,0,3,1,1,0.66,0.6061,0.78,0.3284,38,135,173,173,2,Siang
2704,2011-04-27,0,4,13,0,3,1,1,0.64,0.5909,0.78,0.2985,31,119,150,150,2,Sore
2705,2011-04-27,0,4,14,0,3,1,1,0.68,0.6364,0.74,0.2836,29,119,148,148,2,Sore
2706,2011-04-27,0,4,15,0,3,1,1,0.7,0.6515,0.65,0.4925,18,120,138,138,2,Sore
2707,2011-04-27,0,4,16,0,3,1,1,0.7,0.6515,0.7,0.3881,29,189,218,218,2,Sore
2708,2011-04-27,0,4,17,0,3,1,3,0.66,0.6061,0.83,0.3881,63,458,521,521,2,Sore
2709,2011-04-27,0,4,18,0,3,1,3,0.66,0.6061,0.83,0.3881,46,366,412,412,2,Sore
2710,2011-04-27,0,4,19,0,3,1,1,0.62,0.5909,0.78,0.2836,40,220,260,260,2,Malam
2711,2011-04-27,0,4,20,0,3,1,1,0.64,0.5758,0.83,0.3284,30,188,218,218,2,Malam
2712,2011-04-27,0,4,21,0,3,1,1,0.62,0.5606,0.88,0.2836,19,126,145,145,2,Malam
2713,2011-04-27,0,4,22,0,3,1,2,0.62,0.5606,0.88,0.3284,18,111,129,129,2,Malam
2714,2011-04-27,0,4,23,0,3,1,2,0.62,0.5606,0.88,0.3582,25,53,78,78,2,Malam
2715,2011-04-28,0,4,0,0,4,1,1,0.64,0.5909,0.78,0.3582,13,41,54,54,2,
2716,2011-04-28,0,4,1,0,4,1,2,0.62,0.5758,0.83,0.3881,8,12,20,20,2,Pagi
2717,2011-04-28,0,4,2,0,4,1,2,0.62,0.5758,0.83,0.4478,14,7,21,21,2,Pagi
2718,2011-04-28,0,4,3,0,4,1,2,0.64,0.5909,0.78,0.3881,2,1,3,3,2,Pagi
2719,2011-04-28,0,4,4,0,4,1,2,0.62,0.5758,0.83,0.4179,4,5,9,9,2,Pagi
2720,2011-04-28,0,4,5,0,4,1,2,0.62,0.5758,0.83,0.3881,0,13,13,13,2,Pagi
2721,2011-04-28,0,4,6,0,4,1,2,0.64,0.5909,0.78,0.4627,7,79,86,86,2,Pagi
2722,2011-04-28,0,4,7,0,4,1,2,0.64,0.5909,0.78,0.4478,14,201,215,215,2,Siang
2723,2011-04-28,0,4,8,0,4,1,2,0.66,0.6061,0.78,0.4478,31,367,398,398,2,Siang
2724,2011-04-28,0,4,9,0,4,1,3,0.62,0.5606,0.88,0.3284,18,165,183,183,2,Siang
2725,2011-04-28,0,4,10,0,4,1,2,0.62,0.5606,0.88,0.2836,9,45,54,54,2,Siang
2726,2011-04-28,0,4,11,0,4,1,2,0.62,0.5758,0.83,0.2836,10,74,84,84,2,Siang
2727,2011-04-28,0,4,12,0,4,1,2,0.62,0.5909,0.78,0.2537,23,84,107,107,2,Siang
2728,2011-04-28,0,4,13,0,4,1,2,0.62,0.5758,0.83,0.2985,18,103,121,121,2,Sore
2729,2011-04-28,0,4,14,0,4,1,1,0.62,0.5758,0.83,0.2985,21,121,142,142,2,Sore
2730,2011-04-28,0,4,15,0,4,1,1,0.66,0.6212,0.69,0.3284,46,117,163,163,2,Sore
2731,2011-04-28,0,4,16,0,4,1,1,0.62,0.5909,0.78,0.2537,42,228,270,270,2,Sore
2732,2011-04-28,0,4,17,0,4,1,1,0.64,0.6212,0.47,0.3582,49,406,455,455,2,Sore
2733,2011-04-28,0,4,18,0,4,1,1,0.64,0.6212,0.47,0.3582,44,486,530,530,2,Sore
2734,2011-04-28,0,4,19,0,4,1,1,0.62,0.6212,0.43,0.2985,57,347,404,404,2,Malam
2735,2011-04-28,0,4,20,0,4,1,1,0.58,0.5455,0.43,0.2239,49,220,269,269,2,Malam
2736,2011-04-28,0,4,21,0,4,1,1,0.56,0.5303,0.46,0.1343,27,167,194,194,2,Malam
2737,2011-04-28,0,4,22,0,4,1,1,0.54,0.5152,0.45,0.1642,34,119,153,153,2,Malam
2738,2011-04-28,0,4,23,0,4,1,1,0.54,0.5152,0.39,0.0896,29,81,110,110,2,Malam
2739,2011-04-29,0,4,0,0,5,1,1,0.52,0.5,0.39,0.2836,11,37,48,48,2,
2740,2011-04-29,0,4,1,0,5,1,1,0.5,0.4848,0.45,0.0896,10,21,31,31,2,Pagi
2741,2011-04-29,0,4,2,0,5,1,1,0.46,0.4545,0.63,0.1045,2,8,10,10,2,Pagi
2742,2011-04-29,0,4,3,0,5,1,1,0.46,0.4545,0.59,0.0896,1,4,5,5,2,Pagi
2743,2011-04-29,0,4,4,0,5,1,1,0.46,0.4545,0.51,0.1343,0,6,6,6,2,Pagi
2744,2011-04-29,0,4,5,0,5,1,1,0.46,0.4545,0.47,0.1343,0,25,25,25,2,Pagi
2745,2011-04-29,0,4,6,0,5,1,1,0.5,0.4848,0.45,0.2836,4,67,71,71,2,Pagi
2746,2011-04-29,0,4,7,0,5,1,1,0.52,0.5,0.42,0.194,18,222,240,240,2,Siang
2747,2011-04-29,0,4,8,0,5,1,1,0.54,0.5152,0.39,0.2985,35,386,421,421,2,Siang
2748,2011-04-29,0,4,9,0,5,1,1,0.54,0.5152,0.39,0.3284,45,185,230,230,2,Siang
2749,2011-04-29,0,4,10,0,5,1,1,0.56,0.5303,0.4,0.2836,57,99,156,156,2,Siang
2750,2011-04-29,0,4,11,0,5,1,1,0.6,0.6212,0.38,0.2239,49,108,157,157,2,Siang
2751,2011-04-29,0,4,12,0,5,1,1,0.56,0.5303,0.37,0.2836,63,160,223,223,2,Siang
2752,2011-04-29,0,4,13,0,5,1,1,0.56,0.5303,0.37,0.2985,74,234,308,308,2,Sore
2753,2011-04-29,0,4,14,0,5,1,1,0.6,0.6212,0.35,0.3284,58,190,248,248,2,Sore
2754,2011-04-29,0,4,15,0,5,1,2,0.56,0.5303,0.4,0.2985,77,175,252,252,2,Sore
2755,2011-04-29,0,4,16,0,5,1,2,0.54,0.5152,0.42,0.3582,59,240,299,299,2,Sore
2756,2011-04-29,0,4,17,0,5,1,2,0.52,0.5,0.45,0.3881,75,433,508,508,2,Sore
2757,2011-04-29,0,4,18,0,5,1,1,0.52,0.5,0.48,0.3582,55,384,439,439,2,Sore
2758,2011-04-29,0,4,19,0,5,1,1,0.46,0.4545,0.55,0.3284,40,230,270,270,2,Malam
2759,2011-04-29,0,4,20,0,5,1,1,0.48,0.4697,0.48,0.2239,34,160,194,194,2,Malam
2760,2011-04-29,0,4,21,0,5,1,1,0.46,0.4545,0.51,0.194,50,145,195,195,2,Malam
2761,2011-04-29,0,4,22,0,5,1,1,0.42,0.4242,0.58,0.1642,36,110,146,146,2,Malam
2762,2011-04-29,0,4,23,0,5,1,2,0.44,0.4394,0.54,0.0896,25,88,113,113,2,Malam
2763,2011-04-30,0,4,0,0,6,0,2,0.44,0.4394,0.54,0.2537,33,73,106,106,2,
2764,2011-04-30,0,4,1,0,6,0,2,0.44,0.4394,0.54,0.1642,15,59,74,74,2,Pagi
2765,2011-04-30,0,4,2,0,6,0,2,0.44,0.4394,0.54,0.2239,12,53,65,65,2,Pagi
2766,2011-04-30,0,4,3,0,6,0,2,0.42,0.4242,0.54,0.194,4,13,17,17,2,Pagi
2767,2011-04-30,0,4,4,0,6,0,2,0.42,0.4242,0.54,0.2239,2,5,7,7,2,Pagi
2768,2011-04-30,0,4,5,0,6,0,1,0.42,0.4242,0.54,0.3881,3,4,7,7,2,Pagi
2769,2011-04-30,0,4,6,0,6,0,1,0.4,0.4091,0.58,0.2836,10,11,21,21,2,Pagi
2770,2011-04-30,0,4,7,0,6,0,1,0.4,0.4091,0.54,0.3881,21,27,48,48,2,Siang
2771,2011-04-30,0,4,8,0,6,0,1,0.4,0.4091,0.54,0.2985,21,70,91,91,2,Siang
2772,2011-04-30,0,4,9,0,6,0,1,0.44,0.4394,0.51,0.3582,35,121,156,156,2,Siang
2773,2011-04-30,0,4,10,0,6,0,1,0.48,0.4697,0.44,0.3881,94,185,279,279,2,Siang
2774,2011-04-30,0,4,11,0,6,0,1,0.5,0.4848,0.42,0.3582,120,201,321,321,2,Siang
2775,2011-04-30,0,4,12,0,6,0,1,0.52,0.5,0.42,0.3881,178,238,416,416,2,Siang
2776,2011-04-30,0,4,13,0,6,0,1,0.54,0.5152,0.39,0.2985,185,270,455,455,2,Sore
2777,2011-04-30,0,4,14,0,6,0,1,0.54,0.5152,0.39,0.2239,184,268,452,452,2,Sore
2778,2011-04-30,0,4,15,0,6,0,1,0.56,0.5303,0.37,0.1343,217,282,499,499,2,Sore
2779,2011-04-30,0,4,16,0,6,0,1,0.58,0.5455,0.37,0.194,191,273,464,464,2,Sore
2780,2011-04-30,0,4,17,0,6,0,1,0.56,0.5303,0.43,0.1343,162,245,407,407,2,Sore
2781,2011-04-30,0,4,18,0,6,0,1,0.54,0.5152,0.43,0.1343,134,237,371,371,2,Sore
2782,2011-04-30,0,4,19,0,6,0,1,0.54,0.5152,0.43,0.1343,150,237,387,387,2,Malam
2783,2011-04-30,0,4,20,0,6,0,1,0.44,0.4394,0.62,0.1343,65,159,224,224,2,Malam
2784,2011-04-30,0,4,21,0,6,0,1,0.44,0.4394,0.62,0.1343,58,119,177,177,2,Malam
2785,2011-04-30,0,4,22,0,6,0,1,0.44,0.4394,0.67,0.1045,37,106,143,143,2,Malam
2786,2011-04-30,0,4,23,0,6,0,1,0.44,0.4394,0.67,0.1045,34,91,125,125,2,Malam
2787,2011-05-01,0,5,0,0,0,0,1,0.42,0.4242,0.67,0.0896,19,77,96,96,2,
2788,2011-05-01,0,5,1,0,0,0,1,0.42,0.4242,0.69,0.1045,9,50,59,59,2,Pagi
2789,2011-05-01,0,5,2,0,0,0,1,0.42,0.4242,0.77,0.1045,7,43,50,50,2,Pagi
2790,2011-05-01,0,5,3,0,0,0,1,0.4,0.4091,0.82,0.1045,8,15,23,23,2,Pagi
2791,2011-05-01,0,5,4,0,0,0,1,0.4,0.4091,0.76,0.1045,6,11,17,17,2,Pagi
2792,2011-05-01,0,5,5,0,0,0,1,0.4,0.4091,0.82,0.0896,0,10,10,10,2,Pagi
2793,2011-05-01,0,5,6,0,0,0,2,0.4,0.4091,0.82,0.0896,4,9,13,13,2,Pagi
2794,2011-05-01,0,5,7,0,0,0,2,0.42,0.4242,0.77,0.0896,7,26,33,33,2,Siang
2795,2011-05-01,0,5,8,0,0,0,2,0.44,0.4394,0.77,0.1343,16,43,59,59,2,Siang
2796,2011-05-01,0,5,9,0,0,0,2,0.46,0.4545,0.72,0.1343,45,96,141,141,2,Siang
2797,2011-05-01,0,5,10,0,0,0,2,0.48,0.4697,0.63,0.194,109,155,264,264,2,Siang
2798,2011-05-01,0,5,11,0,0,0,1,0.46,0.4545,0.82,0.1045,109,141,250,250,2,Siang
2799,2011-05-01,0,5,12,0,0,0,2,0.48,0.4697,0.77,0.1045,109,172,281,281,2,Siang
2800,2011-05-01,0,5,13,0,0,0,2,0.5,0.4848,0.63,0.1642,123,209,332,332,2,Sore
2801,2011-05-01,0,5,14,0,0,0,2,0.5,0.4848,0.68,0.1045,85,153,238,238,2,Sore
2802,2011-05-01,0,5,15,0,0,0,2,0.5,0.4848,0.72,0.0,113,153,266,266,2,Sore
2803,2011-05-01,0,5,16,0,0,0,2,0.5,0.4848,0.72,0.194,75,139,214,214,2,Sore
2804,2011-05-01,0,5,17,0,0,0,2,0.48,0.4697,0.82,0.2537,60,136,196,196,2,Sore
2805,2011-05-01,0,5,18,0,0,0,2,0.46,0.4545,0.82,0.0896,33,126,159,159,2,Sore
2806,2011-05-01,0,5,19,0,0,0,2,0.46,0.4545,0.84,0.1045,47,131,178,178,2,Malam
2807,2011-05-01,0,5,20,0,0,0,2,0.46,0.4545,0.82,0.0,35,86,121,121,2,Malam
2808,2011-05-01,0,5,21,0,0,0,2,0.46,0.4545,0.82,0.0,23,82,105,105,2,Malam
2809,2011-05-01,0,5,22,0,0,0,2,0.46,0.4545,0.82,0.0,32,68,100,100,2,Malam
2810,2011-05-01,0,5,23,0,0,0,1,0.46,0.4545,0.77,0.194,64,82,146,146,2,Malam
2811,2011-05-02,0,5,0,0,1,1,1,0.46,0.4545,0.72,0.1343,68,109,177,177,2,
2812,2011-05-02,0,5,1,0,1,1,1,0.46,0.4545,0.72,0.1343,41,73,114,114,2,Pagi
2813,2011-05-02,0,5,2,0,1,1,2,0.44,0.4394,0.77,0.2239,16,19,35,35,2,Pagi
2814,2011-05-02,0,5,3,0,1,1,1,0.44,0.4394,0.77,0.1343,9,7,16,16,2,Pagi
2815,2011-05-02,0,5,4,0,1,1,1,0.44,0.4394,0.77,0.1642,9,8,17,17,2,Pagi
2816,2011-05-02,0,5,5,0,1,1,2,0.44,0.4394,0.77,0.1343,4,16,20,20,2,Pagi
2817,2011-05-02,0,5,6,0,1,1,1,0.44,0.4394,0.88,0.1045,3,59,62,62,2,Pagi
2818,2011-05-02,0,5,7,0,1,1,2,0.46,0.4545,0.82,0.3284,16,193,209,209,2,Siang
2819,2011-05-02,0,5,8,0,1,1,2,0.48,0.4697,0.77,0.2239,21,350,371,371,2,Siang
2820,2011-05-02,0,5,9,0,1,1,2,0.5,0.4848,0.77,0.2836,41,131,172,172,2,Siang
2821,2011-05-02,0,5,10,0,1,1,2,0.54,0.5152,0.77,0.2239,31,77,108,108,2,Siang
2822,2011-05-02,0,5,11,0,1,1,1,0.58,0.5455,0.73,0.2985,34,96,130,130,2,Siang
2823,2011-05-02,0,5,12,0,1,1,1,0.62,0.6061,0.69,0.2239,40,147,187,187,2,Siang
2824,2011-05-02,0,5,13,0,1,1,2,0.62,0.6061,0.69,0.194,51,119,170,170,2,Sore
2825,2011-05-02,0,5,14,0,1,1,1,0.64,0.6061,0.69,0.2239,48,133,181,181,2,Sore
2826,2011-05-02,0,5,15,0,1,1,1,0.66,0.6212,0.61,0.194,45,110,155,155,2,Sore
2827,2011-05-02,0,5,16,0,1,1,1,0.66,0.6212,0.61,0.2239,49,220,269,269,2,Sore
2828,2011-05-02,0,5,17,0,1,1,1,0.66,0.6212,0.65,0.194,65,472,537,537,2,Sore
2829,2011-05-02,0,5,18,0,1,1,2,0.64,0.6061,0.65,0.194,68,450,518,518,2,Sore
2830,2011-05-02,0,5,19,0,1,1,2,0.62,0.6061,0.69,0.1343,46,268,314,314,2,Malam
2831,2011-05-02,0,5,20,0,1,1,2,0.62,0.6061,0.69,0.1343,44,174,218,218,2,Malam
2832,2011-05-02,0,5,21,0,1,1,2,0.6,0.5909,0.73,0.1045,54,178,232,232,2,Malam
2833,2011-05-02,0,5,22,0,1,1,2,0.6,0.5909,0.73,0.0,28,97,125,125,2,Malam
2834,2011-05-02,0,5,23,0,1,1,2,0.56,0.5303,0.83,0.194,16,48,64,64,2,Malam
2835,2011-05-03,0,5,0,0,2,1,2,0.56,0.5303,0.83,0.2239,0,16,16,16,2,
2836,2011-05-03,0,5,1,0,2,1,2,0.56,0.5303,0.78,0.2537,0,14,14,14,2,Pagi
2837,2011-05-03,0,5,2,0,2,1,2,0.56,0.5303,0.78,0.2537,0,5,5,5,2,Pagi
2838,2011-05-03,0,5,3,0,2,1,1,0.54,0.5152,0.83,0.2836,0,2,2,2,2,Pagi
2839,2011-05-03,0,5,4,0,2,1,1,0.52,0.5,0.88,0.2239,3,1,4,4,2,Pagi
2840,2011-05-03,0,5,5,0,2,1,1,0.52,0.5,0.88,0.1343,0,14,14,14,2,Pagi
2841,2011-05-03,0,5,6,0,2,1,2,0.52,0.5,0.94,0.1642,7,102,109,109,2,Pagi
2842,2011-05-03,0,5,7,0,2,1,2,0.54,0.5152,0.88,0.2239,17,248,265,265,2,Siang
2843,2011-05-03,0,5,8,0,2,1,2,0.56,0.5303,0.83,0.2836,24,435,459,459,2,Siang
2844,2011-05-03,0,5,9,0,2,1,2,0.6,0.5758,0.78,0.3582,29,157,186,186,2,Siang
2845,2011-05-03,0,5,10,0,2,1,2,0.64,0.6061,0.69,0.3582,36,91,127,127,2,Siang
2846,2011-05-03,0,5,11,0,2,1,2,0.66,0.6212,0.65,0.3284,20,120,140,140,2,Siang
2847,2011-05-03,0,5,12,0,2,1,2,0.68,0.6364,0.61,0.4925,48,169,217,217,2,Siang
2848,2011-05-03,0,5,13,0,2,1,2,0.7,0.6515,0.58,0.6119,50,144,194,194,2,Sore
2849,2011-05-03,0,5,14,0,2,1,2,0.7,0.6515,0.58,0.5224,36,122,158,158,2,Sore
2850,2011-05-03,0,5,15,0,2,1,2,0.7,0.6515,0.58,0.4478,37,117,154,154,2,Sore
2851,2011-05-03,0,5,16,0,2,1,1,0.72,0.6667,0.54,0.4627,46,225,271,271,2,Sore
2852,2011-05-03,0,5,17,0,2,1,1,0.7,0.6515,0.54,0.4627,53,464,517,517,2,Sore
2853,2011-05-03,0,5,18,0,2,1,1,0.7,0.6515,0.48,0.4179,59,485,544,544,2,Sore
2854,2011-05-03,0,5,19,0,2,1,1,0.68,0.6364,0.57,0.3582,42,323,365,365,2,Malam
2855,2011-05-03,0,5,20,0,2,1,1,0.66,0.6212,0.61,0.194,28,262,290,290,2,Malam
2856,2011-05-03,0,5,21,0,2,1,2,0.64,0.6212,0.61,0.4478,42,183,225,225,2,Malam
2857,2011-05-03,0,5,22,0,2,1,2,0.58,0.5455,0.6,0.3881,14,99,113,113,2,Malam
2858,2011-05-03,0,5,23,0,2,1,2,0.56,0.5303,0.68,0.3284,12,50,62,62,2,Malam
2859,2011-05-04,0,5,0,0,3,1,3,0.52,0.5,0.77,0.1642,5,22,27,27,2,
2860,2011-05-04,0,5,1,0,3,1,3,0.5,0.4848,0.82,0.2836,1,6,7,7,2,Pagi
2861,2011-05-04,0,5,2,0,3,1,3,0.5,0.4848,0.82,0.2836,0,4,4,4,2,Pagi
2862,2011-05-04,0,5,3,0,3,1,3,0.42,0.4242,0.88,0.5224,0,1,1,1,2,Pagi
2863,2011-05-04,0,5,4,0,3,1,3,0.38,0.3939,0.94,0.3284,1,2,3,3,2,Pagi
2864,2011-05-04,0,5,5,0,3,1,3,0.36,0.3333,0.87,0.3284,1,8,9,9,2,Pagi
2865,2011-05-04,0,5,6,0,3,1,3,0.34,0.303,0.93,0.3881,0,21,21,21,2,Pagi
2866,2011-05-04,0,5,7,0,3,1,3,0.34,0.303,0.93,0.3582,6,46,52,52,2,Siang
2867,2011-05-04,0,5,8,0,3,1,3,0.34,0.303,0.93,0.3881,5,74,79,79,2,Siang
2868,2011-05-04,0,5,9,0,3,1,3,0.34,0.303,0.93,0.3582,5,35,40,40,2,Siang
2869,2011-05-04,0,5,10,0,3,1,2,0.34,0.3182,0.93,0.2836,5,26,31,31,2,Siang
2870,2011-05-04,0,5,11,0,3,1,1,0.4,0.4091,0.82,0.3284,3,69,72,72,2,Siang
2871,2011-05-04,0,5,12,0,3,1,2,0.44,0.4394,0.62,0.3582,19,105,124,124,2,Siang
2872,2011-05-04,0,5,13,0,3,1,2,0.46,0.4545,0.59,0.4478,15,128,143,143,2,Sore
2873,2011-05-04,0,5,14,0,3,1,1,0.5,0.4848,0.51,0.3881,13,94,107,107,2,Sore
2874,2011-05-04,0,5,15,0,3,1,1,0.48,0.4697,0.51,0.4179,22,107,129,129,2,Sore
2875,2011-05-04,0,5,16,0,3,1,1,0.5,0.4848,0.45,0.4627,22,173,195,195,2,Sore
2876,2011-05-04,0,5,17,0,3,1,1,0.4,0.4091,0.71,0.2537,22,388,410,410,2,Sore
2877,2011-05-04,0,5,18,0,3,1,1,0.42,0.4242,0.67,0.2537,29,367,396,396,2,Sore
2878,2011-05-04,0,5,19,0,3,1,1,0.42,0.4242,0.58,0.3582,30,266,296,296,2,Malam
2879,2011-05-04,0,5,20,0,3,1,1,0.4,0.4091,0.62,0.3284,17,174,191,191,2,Malam
2880,2011-05-04,0,5,21,0,3,1,1,0.4,0.4091,0.62,0.1642,17,133,150,150,2,Malam
2881,2011-05-04,0,5,22,0,3,1,1,0.38,0.3939,0.62,0.2239,9,80,89,89,2,Malam
2882,2011-05-04,0,5,23,0,3,1,1,0.36,0.3485,0.62,0.2239,8,49,57,57,2,Malam
2883,2011-05-05,0,5,0,0,4,1,1,0.36,0.3485,0.66,0.194,4,23,27,27,2,
2884,2011-05-05,0,5,1,0,4,1,1,0.34,0.3333,0.71,0.194,4,6,10,10,2,Pagi
2885,2011-05-05,0,5,2,0,4,1,1,0.34,0.3182,0.66,0.2239,1,4,5,5,2,Pagi
2886,2011-05-05,0,5,3,0,4,1,1,0.34,0.3182,0.66,0.2537,0,4,4,4,2,Pagi
2887,2011-05-05,0,5,4,0,4,1,1,0.34,0.3182,0.66,0.2537,4,3,7,7,2,Pagi
2888,2011-05-05,0,5,5,0,4,1,1,0.34,0.3182,0.66,0.2537,1,29,30,30,2,Pagi
2889,2011-05-05,0,5,6,0,4,1,1,0.34,0.3182,0.66,0.2537,3,86,89,89,2,Pagi
2890,2011-05-05,0,5,7,0,4,1,1,0.38,0.3939,0.58,0.2537,16,255,271,271,2,Siang
2891,2011-05-05,0,5,8,0,4,1,1,0.42,0.4242,0.5,0.2537,25,415,440,440,2,Siang
2892,2011-05-05,0,5,9,0,4,1,1,0.46,0.4545,0.44,0.2836,20,164,184,184,2,Siang
2893,2011-05-05,0,5,10,0,4,1,1,0.5,0.4848,0.39,0.2836,30,98,128,128,2,Siang
2894,2011-05-05,0,5,11,0,4,1,1,0.52,0.5,0.36,0.4478,43,105,148,148,2,Siang
2895,2011-05-05,0,5,12,0,4,1,1,0.52,0.5,0.34,0.3582,27,169,196,196,2,Siang
2896,2011-05-05,0,5,13,0,4,1,1,0.54,0.5152,0.3,0.5821,50,142,192,192,2,Sore
2897,2011-05-05,0,5,14,0,4,1,1,0.54,0.5152,0.28,0.4478,19,135,154,154,2,Sore
2898,2011-05-05,0,5,15,0,4,1,1,0.56,0.5303,0.26,0.4925,27,120,147,147,2,Sore
2899,2011-05-05,0,5,16,0,4,1,1,0.58,0.5455,0.24,0.4179,36,233,269,269,2,Sore
2900,2011-05-05,0,5,17,0,4,1,1,0.56,0.5303,0.26,0.3881,66,467,533,533,2,Sore
2901,2011-05-05,0,5,18,0,4,1,1,0.56,0.5303,0.26,0.2836,64,456,520,520,2,Sore
2902,2011-05-05,0,5,19,0,4,1,1,0.54,0.5152,0.28,0.2239,56,305,361,361,2,Malam
2903,2011-05-05,0,5,20,0,4,1,1,0.5,0.4848,0.34,0.1642,33,225,258,258,2,Malam
2904,2011-05-05,0,5,21,0,4,1,1,0.5,0.4848,0.36,0.194,39,141,180,180,2,Malam
2905,2011-05-05,0,5,22,0,4,1,1,0.48,0.4697,0.39,0.194,30,135,165,165,2,Malam
2906,2011-05-05,0,5,23,0,4,1,1,0.46,0.4545,0.41,0.194,16,99,115,115,2,Malam
2907,2011-05-06,0,5,0,0,5,1,1,0.44,0.4394,0.44,0.1642,13,43,56,56,2,
2908,2011-05-06,0,5,1,0,5,1,1,0.4,0.4091,0.62,0.1642,8,24,32,32,2,Pagi
2909,2011-05-06,0,5,2,0,5,1,1,0.38,0.3939,0.62,0.1045,1,15,16,16,2,Pagi
2910,2011-05-06,0,5,3,0,5,1,1,0.36,0.3636,0.71,0.1045,3,6,9,9,2,Pagi
2911,2011-05-06,0,5,4,0,5,1,1,0.36,0.3636,0.71,0.1045,0,1,1,1,2,Pagi
2912,2011-05-06,0,5,5,0,5,1,1,0.34,0.3485,0.81,0.1045,0,16,16,16,2,Pagi
2913,2011-05-06,0,5,6,0,5,1,1,0.36,0.3636,0.81,0.0896,8,74,82,82,2,Pagi
2914,2011-05-06,0,5,7,0,5,1,1,0.4,0.4091,0.82,0.0,20,202,222,222,2,Siang
2915,2011-05-06,0,5,8,0,5,1,1,0.42,0.4242,0.77,0.2537,35,415,450,450,2,Siang
2916,2011-05-06,0,5,9,0,5,1,1,0.46,0.4545,0.67,0.2836,27,161,188,188,2,Siang
2917,2011-05-06,0,5,10,0,5,1,2,0.54,0.5152,0.49,0.3284,30,97,127,127,2,Siang
2918,2011-05-06,0,5,11,0,5,1,2,0.54,0.5152,0.49,0.3284,42,123,165,165,2,Siang
2919,2011-05-06,0,5,12,0,5,1,1,0.56,0.5303,0.49,0.3582,48,198,246,246,2,Siang
2920,2011-05-06,0,5,13,0,5,1,1,0.58,0.5455,0.4,0.3284,71,182,253,253,2,Sore
2921,2011-05-06,0,5,14,0,5,1,1,0.6,0.6212,0.4,0.4478,86,127,213,213,2,Sore
2922,2011-05-06,0,5,15,0,5,1,1,0.6,0.6212,0.38,0.3881,89,171,260,260,2,Sore
2923,2011-05-06,0,5,16,0,5,1,1,0.6,0.6212,0.4,0.2537,82,262,344,344,2,Sore
2924,2011-05-06,0,5,17,0,5,1,1,0.58,0.5455,0.4,0.3582,83,470,553,553,2,Sore
2925,2011-05-06,0,5,18,0,5,1,3,0.54,0.5152,0.52,0.3582,85,385,470,470,2,Sore
2926,2011-05-06,0,5,19,0,5,1,3,0.54,0.5152,0.52,0.3582,39,253,292,292,2,Malam
2927,2011-05-06,0,5,20,0,5,1,1,0.52,0.5,0.48,0.1045,29,161,190,190,2,Malam
2928,2011-05-06,0,5,21,0,5,1,1,0.48,0.4697,0.67,0.1343,22,130,152,152,2,Malam
2929,2011-05-06,0,5,22,0,5,1,1,0.46,0.4545,0.72,0.2239,46,105,151,151,2,Malam
2930,2011-05-06,0,5,23,0,5,1,1,0.44,0.4394,0.82,0.1343,27,93,120,120,2,Malam
2931,2011-05-07,0,5,0,0,6,0,1,0.42,0.4242,0.82,0.1343,10,76,86,86,2,
2932,2011-05-07,0,5,1,0,6,0,1,0.42,0.4242,0.82,0.1045,8,50,58,58,2,Pagi
2933,2011-05-07,0,5,2,0,6,0,1,0.42,0.4242,0.82,0.0896,5,47,52,52,2,Pagi
2934,2011-05-07,0,5,3,0,6,0,1,0.42,0.4242,0.77,0.0896,9,9,18,18,2,Pagi
2935,2011-05-07,0,5,4,0,6,0,1,0.4,0.4091,0.82,0.1045,1,4,5,5,2,Pagi
2936,2011-05-07,0,5,5,0,6,0,1,0.46,0.4545,0.59,0.1343,4,3,7,7,2,Pagi
2937,2011-05-07,0,5,6,0,6,0,1,0.42,0.4242,0.77,0.0896,1,12,13,13,2,Pagi
2938,2011-05-07,0,5,7,0,6,0,1,0.48,0.4697,0.59,0.0,8,32,40,40,2,Siang
2939,2011-05-07,0,5,8,0,6,0,1,0.52,0.5,0.52,0.194,19,96,115,115,2,Siang
2940,2011-05-07,0,5,9,0,6,0,1,0.54,0.5152,0.49,0.2836,54,164,218,218,2,Siang
2941,2011-05-07,0,5,10,0,6,0,1,0.56,0.5303,0.49,0.2985,90,208,298,298,2,Siang
2942,2011-05-07,0,5,11,0,6,0,1,0.56,0.5303,0.43,0.0,132,215,347,347,2,Siang
2943,2011-05-07,0,5,12,0,6,0,1,0.6,0.6212,0.4,0.194,129,244,373,373,2,Siang
2944,2011-05-07,0,5,13,0,6,0,1,0.6,0.6212,0.35,0.2836,196,240,436,436,2,Sore
2945,2011-05-07,0,5,14,0,6,0,3,0.6,0.6212,0.35,0.1642,143,235,378,378,2,Sore
2946,2011-05-07,0,5,15,0,6,0,1,0.6,0.6212,0.38,0.2537,148,230,378,378,2,Sore
2947,2011-05-07,0,5,16,0,6,0,1,0.6,0.6212,0.38,0.194,119,223,342,342,2,Sore
2948,2011-05-07,0,5,17,0,6,0,1,0.58,0.5455,0.4,0.2239,138,216,354,354,2,Sore
2949,2011-05-07,0,5,18,0,6,0,1,0.58,0.5455,0.37,0.1642,114,175,289,289,2,Sore
2950,2011-05-07,0,5,19,0,6,0,1,0.56,0.5303,0.43,0.194,88,179,267,267,2,Malam
2951,2011-05-07,0,5,20,0,6,0,1,0.56,0.5303,0.43,0.1343,82,137,219,219,2,Malam
2952,2011-05-07,0,5,21,0,6,0,1,0.54,0.5152,0.49,0.2239,58,124,182,182,2,Malam
2953,2011-05-07,0,5,22,0,6,0,1,0.54,0.5152,0.49,0.194,26,94,120,120,2,Malam
2954,2011-05-07,0,5,23,0,6,0,1,0.5,0.4848,0.59,0.1045,30,89,119,119,2,Malam
2955,2011-05-08,0,5,0,0,0,0,2,0.5,0.4848,0.59,0.1045,22,78,100,100,2,
2956,2011-05-08,0,5,1,0,0,0,2,0.52,0.5,0.55,0.0,8,56,64,64,2,Pagi
2957,2011-05-08,0,5,2,0,0,0,1,0.48,0.4697,0.63,0.0,17,42,59,59,2,Pagi
2958,2011-05-08,0,5,3,0,0,0,1,0.46,0.4545,0.72,0.0896,10,21,31,31,2,Pagi
2959,2011-05-08,0,5,4,0,0,0,1,0.42,0.4242,0.82,0.0,2,8,10,10,2,Pagi
2960,2011-05-08,0,5,5,0,0,0,2,0.44,0.4394,0.77,0.0,0,5,5,5,2,Pagi
2961,2011-05-08,0,5,6,0,0,0,2,0.44,0.4394,0.82,0.0,2,4,6,6,2,Pagi
2962,2011-05-08,0,5,7,0,0,0,2,0.46,0.4545,0.82,0.0,8,15,23,23,2,Siang
2963,2011-05-08,0,5,8,0,0,0,1,0.52,0.5,0.63,0.1343,28,58,86,86,2,Siang
2964,2011-05-08,0,5,9,0,0,0,1,0.56,0.5303,0.52,0.2239,48,112,160,160,2,Siang
2965,2011-05-08,0,5,10,0,0,0,1,0.58,0.5455,0.49,0.1343,91,153,244,244,2,Siang
2966,2011-05-08,0,5,11,0,0,0,1,0.58,0.5455,0.49,0.0896,142,198,340,340,2,Siang
2967,2011-05-08,0,5,12,0,0,0,1,0.6,0.6212,0.46,0.0896,139,243,382,382,2,Siang
2968,2011-05-08,0,5,13,0,0,0,1,0.6,0.6212,0.49,0.1343,166,224,390,390,2,Sore
2969,2011-05-08,0,5,14,0,0,0,1,0.6,0.6212,0.49,0.0,126,240,366,366,2,Sore
2970,2011-05-08,0,5,15,0,0,0,1,0.6,0.6212,0.49,0.0,128,230,358,358,2,Sore
2971,2011-05-08,0,5,16,0,0,0,1,0.6,0.6212,0.46,0.1045,122,263,385,385,2,Sore
2972,2011-05-08,0,5,17,0,0,0,3,0.58,0.5455,0.49,0.2836,106,245,351,351,2,Sore
2973,2011-05-08,0,5,18,0,0,0,1,0.58,0.5455,0.49,0.0,63,205,268,268,2,Sore
2974,2011-05-08,0,5,19,0,0,0,1,0.56,0.5303,0.64,0.0,61,178,239,239,2,Malam
2975,2011-05-08,0,5,20,0,0,0,1,0.52,0.5,0.77,0.1343,42,132,174,174,2,Malam
2976,2011-05-08,0,5,21,0,0,0,1,0.52,0.5,0.77,0.0896,32,95,127,127,2,Malam
2977,2011-05-08,0,5,22,0,0,0,1,0.5,0.4848,0.88,0.0896,29,86,115,115,2,Malam
2978,2011-05-08,0,5,23,0,0,0,1,0.46,0.4545,0.88,0.0896,9,41,50,50,2,Malam
2979,2011-05-09,0,5,0,0,1,1,1,0.46,0.4545,0.82,0.0896,31,22,53,53,2,
2980,2011-05-09,0,5,1,0,1,1,1,0.44,0.4394,0.88,0.0,25,8,33,33,2,Pagi
2981,2011-05-09,0,5,2,0,1,1,1,0.44,0.4394,0.94,0.0,6,2,8,8,2,Pagi
2982,2011-05-09,0,5,3,0,1,1,1,0.46,0.4545,0.82,0.0896,0,7,7,7,2,Pagi
2983,2011-05-09,0,5,4,0,1,1,1,0.42,0.4242,0.82,0.1642,0,4,4,4,2,Pagi
2984,2011-05-09,0,5,5,0,1,1,1,0.42,0.4242,0.77,0.1642,0,23,23,23,2,Pagi
2985,2011-05-09,0,5,6,0,1,1,1,0.44,0.4394,0.72,0.2537,2,87,89,89,2,Pagi
2986,2011-05-09,0,5,7,0,1,1,1,0.48,0.4697,0.63,0.2537,16,221,237,237,2,Siang
2987,2011-05-09,0,5,8,0,1,1,1,0.52,0.5,0.55,0.2239,23,351,374,374,2,Siang
2988,2011-05-09,0,5,9,0,1,1,1,0.54,0.5152,0.56,0.1642,36,142,178,178,2,Siang
2989,2011-05-09,0,5,10,0,1,1,1,0.56,0.5303,0.52,0.194,24,95,119,119,2,Siang
2990,2011-05-09,0,5,11,0,1,1,1,0.6,0.6212,0.46,0.2239,26,99,125,125,2,Siang
2991,2011-05-09,0,5,12,0,1,1,1,0.6,0.6212,0.43,0.194,35,160,195,195,2,Siang
2992,2011-05-09,0,5,13,0,1,1,1,0.62,0.6212,0.38,0.2836,36,138,174,174,2,Sore
2993,2011-05-09,0,5,14,0,1,1,1,0.62,0.6212,0.41,0.2239,44,118,162,162,2,Sore
2994,2011-05-09,0,5,15,0,1,1,1,0.62,0.6212,0.41,0.2239,51,148,199,199,2,Sore
2995,2011-05-09,0,5,16,0,1,1,1,0.64,0.6212,0.38,0.2239,49,255,304,304,2,Sore
2996,2011-05-09,0,5,17,0,1,1,1,0.62,0.6212,0.38,0.2537,59,539,598,598,2,Sore
2997,2011-05-09,0,5,18,0,1,1,1,0.62,0.6212,0.38,0.2985,66,458,524,524,2,Sore
2998,2011-05-09,0,5,19,0,1,1,1,0.58,0.5455,0.43,0.194,45,339,384,384,2,Malam
2999,2011-05-09,0,5,20,0,1,1,1,0.54,0.5152,0.49,0.194,25,214,239,239,2,Malam
3000,2011-05-09,0,5,21,0,1,1,1,0.52,0.5,0.59,0.1343,28,128,156,156,2,Malam
3001,2011-05-09,0,5,22,0,1,1,1,0.52,0.5,0.68,0.0896,21,95,116,116,2,Malam
3002,2011-05-09,0,5,23,0,1,1,1,0.5,0.4848,0.68,0.0896,16,45,61,61,2,Malam
3003,2011-05-10,0,5,0,0,2,1,1,0.48,0.4697,0.63,0.0,6,12,18,18,2,
3004,2011-05-10,0,5,1,0,2,1,1,0.46,0.4545,0.59,0.0896,3,12,15,15,2,Pagi
3005,2011-05-10,0,5,2,0,2,1,1,0.44,0.4394,0.58,0.1343,1,4,5,5,2,Pagi
3006,2011-05-10,0,5,3,0,2,1,1,0.44,0.4394,0.54,0.194,1,3,4,4,2,Pagi
3007,2011-05-10,0,5,4,0,2,1,1,0.42,0.4242,0.62,0.2537,0,2,2,2,2,Pagi
3008,2011-05-10,0,5,5,0,2,1,1,0.4,0.4091,0.66,0.2239,1,28,29,29,2,Pagi
3009,2011-05-10,0,5,6,0,2,1,1,0.42,0.4242,0.67,0.1343,9,103,112,112,2,Pagi
3010,2011-05-10,0,5,7,0,2,1,2,0.44,0.4394,0.62,0.1343,13,301,314,314,2,Siang
3011,2011-05-10,0,5,8,0,2,1,2,0.5,0.4848,0.51,0.1045,28,397,425,425,2,Siang
3012,2011-05-10,0,5,9,0,2,1,2,0.52,0.5,0.48,0.1045,29,176,205,205,2,Siang
3013,2011-05-10,0,5,10,0,2,1,2,0.56,0.5303,0.37,0.0896,27,100,127,127,2,Siang
3014,2011-05-10,0,5,11,0,2,1,2,0.56,0.5303,0.43,0.1343,17,108,125,125,2,Siang
3015,2011-05-10,0,5,12,0,2,1,2,0.6,0.6212,0.38,0.0,47,170,217,217,2,Siang
3016,2011-05-10,0,5,13,0,2,1,2,0.62,0.6212,0.38,0.2537,50,152,202,202,2,Sore
3017,2011-05-10,0,5,14,0,2,1,2,0.62,0.6212,0.33,0.0,42,134,176,176,2,Sore
3018,2011-05-10,0,5,15,0,2,1,2,0.64,0.6212,0.33,0.0896,28,152,180,180,2,Sore
3019,2011-05-10,0,5,16,0,2,1,1,0.66,0.6212,0.31,0.1045,56,271,327,327,2,Sore
3020,2011-05-10,0,5,17,0,2,1,1,0.64,0.6212,0.33,0.0,79,532,611,611,2,Sore
3021,2011-05-10,0,5,18,0,2,1,1,0.64,0.6212,0.29,0.1343,70,480,550,550,2,Sore
3022,2011-05-10,0,5,19,0,2,1,1,0.6,0.6212,0.43,0.2239,69,365,434,434,2,Malam
3023,2011-05-10,0,5,20,0,2,1,1,0.54,0.5152,0.6,0.1343,50,241,291,291,2,Malam
3024,2011-05-10,0,5,21,0,2,1,1,0.54,0.5152,0.52,0.0,30,173,203,203,2,Malam
3025,2011-05-10,0,5,22,0,2,1,1,0.52,0.5,0.55,0.1045,29,121,150,150,2,Malam
3026,2011-05-10,0,5,23,0,2,1,2,0.52,0.5,0.59,0.1343,9,72,81,81,2,Malam
3027,2011-05-11,0,5,0,0,3,1,2,0.52,0.5,0.55,0.1343,8,30,38,38,2,
3028,2011-05-11,0,5,1,0,3,1,2,0.5,0.4848,0.59,0.1045,4,16,20,20,2,Pagi
3029,2011-05-11,0,5,2,0,3,1,1,0.52,0.5,0.59,0.0,6,4,10,10,2,Pagi
3030,2011-05-11,0,5,3,0,3,1,1,0.5,0.4848,0.63,0.2239,0,3,3,3,2,Pagi
3031,2011-05-11,0,5,4,0,3,1,2,0.48,0.4697,0.88,0.1343,0,2,2,2,2,Pagi
3032,2011-05-11,0,5,5,0,3,1,1,0.46,0.4545,0.88,0.1343,0,20,20,20,2,Pagi
3033,2011-05-11,0,5,6,0,3,1,1,0.46,0.4545,0.82,0.1343,6,93,99,99,2,Pagi
3034,2011-05-11,0,5,7,0,3,1,1,0.48,0.4697,0.72,0.194,25,293,318,318,2,Siang
3035,2011-05-11,0,5,8,0,3,1,1,0.48,0.4697,0.77,0.2537,21,421,442,442,2,Siang
3036,2011-05-11,0,5,9,0,3,1,1,0.52,0.5,0.72,0.1343,21,182,203,203,2,Siang
3037,2011-05-11,0,5,10,0,3,1,1,0.54,0.5152,0.68,0.0896,30,124,154,154,2,Siang
3038,2011-05-11,0,5,11,0,3,1,1,0.56,0.5303,0.64,0.0896,18,123,141,141,2,Siang
3039,2011-05-11,0,5,12,0,3,1,1,0.6,0.6212,0.56,0.0,41,185,226,226,2,Siang
3040,2011-05-11,0,5,13,0,3,1,1,0.62,0.6212,0.5,0.0,36,157,193,193,2,Sore
3041,2011-05-11,0,5,14,0,3,1,1,0.62,0.6212,0.53,0.0896,36,141,177,177,2,Sore
3042,2011-05-11,0,5,15,0,3,1,1,0.64,0.6212,0.41,0.0,48,131,179,179,2,Sore
3043,2011-05-11,0,5,16,0,3,1,1,0.66,0.6212,0.39,0.0,49,240,289,289,2,Sore
3044,2011-05-11,0,5,17,0,3,1,1,0.64,0.6212,0.47,0.1045,17,242,259,259,2,Sore
3045,2011-05-11,0,5,18,0,3,1,1,0.62,0.6212,0.5,0.2985,40,234,274,274,2,Sore
3046,2011-05-11,0,5,19,0,3,1,1,0.56,0.5303,0.52,0.1343,60,341,401,401,2,Malam
3047,2011-05-11,0,5,20,0,3,1,1,0.54,0.5152,0.64,0.1343,28,245,273,273,2,Malam
3048,2011-05-11,0,5,21,0,3,1,1,0.54,0.5152,0.6,0.0,32,202,234,234,2,Malam
3049,2011-05-11,0,5,22,0,3,1,1,0.5,0.4848,0.72,0.2537,12,134,146,146,2,Malam
3050,2011-05-11,0,5,23,0,3,1,1,0.46,0.4545,0.88,0.2537,12,69,81,81,2,Malam
3051,2011-05-12,0,5,0,0,4,1,2,0.46,0.4545,0.88,0.2239,5,39,44,44,2,
3052,2011-05-12,0,5,1,0,4,1,1,0.46,0.4545,0.88,0.2239,1,16,17,17,2,Pagi
3053,2011-05-12,0,5,2,0,4,1,1,0.44,0.4394,0.94,0.194,1,14,15,15,2,Pagi
3054,2011-05-12,0,5,3,0,4,1,1,0.44,0.4394,0.88,0.1343,0,5,5,5,2,Pagi
3055,2011-05-12,0,5,4,0,4,1,1,0.42,0.4242,0.94,0.0,1,5,6,6,2,Pagi
3056,2011-05-12,0,5,5,0,4,1,1,0.42,0.4242,0.94,0.1343,2,27,29,29,2,Pagi
3057,2011-05-12,0,5,6,0,4,1,1,0.44,0.4394,0.88,0.0,9,103,112,112,2,Pagi
3058,2011-05-12,0,5,7,0,4,1,1,0.46,0.4545,0.88,0.1343,14,283,297,297,2,Siang
3059,2011-05-12,0,5,8,0,4,1,1,0.48,0.4697,0.82,0.194,27,394,421,421,2,Siang
3060,2011-05-12,0,5,9,0,4,1,2,0.5,0.4848,0.77,0.2836,21,191,212,212,2,Siang
3061,2011-05-12,0,5,10,0,4,1,2,0.54,0.5152,0.68,0.2239,28,119,147,147,2,Siang
3062,2011-05-12,0,5,11,0,4,1,1,0.58,0.5455,0.6,0.2239,43,136,179,179,2,Siang
3063,2011-05-12,0,5,12,0,4,1,1,0.58,0.5455,0.6,0.2239,43,164,207,207,2,Siang
3064,2011-05-12,0,5,13,0,4,1,2,0.62,0.6212,0.57,0.2985,48,170,218,218,2,Sore
3065,2011-05-12,0,5,14,0,4,1,2,0.62,0.6061,0.61,0.2239,43,148,191,191,2,Sore
3066,2011-05-12,0,5,15,0,4,1,2,0.64,0.6212,0.53,0.2537,54,163,217,217,2,Sore
3067,2011-05-12,0,5,16,0,4,1,2,0.64,0.6212,0.57,0.2537,50,238,288,288,2,Sore
3068,2011-05-12,0,5,17,0,4,1,2,0.64,0.6212,0.57,0.194,54,540,594,594,2,Sore
3069,2011-05-12,0,5,18,0,4,1,1,0.62,0.6061,0.69,0.2239,64,463,527,527,2,Sore
3070,2011-05-12,0,5,19,0,4,1,2,0.6,0.6061,0.64,0.194,59,305,364,364,2,Malam
3071,2011-05-12,0,5,20,0,4,1,1,0.6,0.6061,0.64,0.194,56,220,276,276,2,Malam
3072,2011-05-12,0,5,21,0,4,1,1,0.56,0.5303,0.83,0.1343,31,192,223,223,2,Malam
3073,2011-05-12,0,5,22,0,4,1,1,0.54,0.5152,0.83,0.194,25,147,172,172,2,Malam
3074,2011-05-12,0,5,23,0,4,1,2,0.54,0.5152,0.77,0.194,16,87,103,103,2,Malam
3075,2011-05-13,0,5,0,0,5,1,2,0.52,0.5,0.83,0.1642,6,46,52,52,2,
3076,2011-05-13,0,5,1,0,5,1,1,0.52,0.5,0.83,0.1642,5,15,20,20,2,Pagi
3077,2011-05-13,0,5,2,0,5,1,2,0.5,0.4848,0.88,0.1343,3,8,11,11,2,Pagi
3078,2011-05-13,0,5,3,0,5,1,2,0.5,0.4848,0.88,0.1343,2,2,4,4,2,Pagi
3079,2011-05-13,0,5,4,0,5,1,3,0.5,0.4848,0.88,0.1642,2,3,5,5,2,Pagi
3080,2011-05-13,0,5,5,0,5,1,2,0.5,0.4848,0.88,0.194,1,24,25,25,2,Pagi
3081,2011-05-13,0,5,6,0,5,1,3,0.5,0.4848,0.88,0.1343,6,76,82,82,2,Pagi
3082,2011-05-13,0,5,7,0,5,1,3,0.5,0.4848,0.88,0.1642,16,141,157,157,2,Siang
3083,2011-05-13,0,5,8,0,5,1,2,0.5,0.4848,0.88,0.194,26,361,387,387,2,Siang
3084,2011-05-13,0,5,9,0,5,1,2,0.5,0.4848,0.88,0.194,18,215,233,233,2,Siang
3085,2011-05-13,0,5,10,0,5,1,2,0.52,0.5,0.83,0.1343,31,99,130,130,2,Siang
3086,2011-05-13,0,5,11,0,5,1,2,0.52,0.5,0.83,0.1642,56,90,146,146,2,Siang
3087,2011-05-13,0,5,12,0,5,1,2,0.52,0.5,0.88,0.194,53,170,223,223,2,Siang
3088,2011-05-13,0,5,13,0,5,1,2,0.52,0.5,0.88,0.3881,69,157,226,226,2,Sore
3089,2011-05-13,0,5,14,0,5,1,2,0.52,0.5,0.87,0.2836,70,120,190,190,2,Sore
3090,2011-05-13,0,5,15,0,5,1,2,0.52,0.5,0.88,0.1642,56,142,198,198,2,Sore
3091,2011-05-13,0,5,16,0,5,1,2,0.52,0.5,0.88,0.1343,44,256,300,300,2,Sore
3092,2011-05-13,0,5,17,0,5,1,3,0.52,0.5,0.88,0.1642,62,429,491,491,2,Sore
3093,2011-05-13,0,5,18,0,5,1,3,0.52,0.5,0.88,0.1642,39,359,398,398,2,Sore
3094,2011-05-13,0,5,19,0,5,1,2,0.52,0.5,0.83,0.194,25,245,270,270,2,Malam
3095,2011-05-13,0,5,20,0,5,1,2,0.52,0.5,0.83,0.1343,22,130,152,152,2,Malam
3096,2011-05-13,0,5,21,0,5,1,2,0.52,0.5,0.84,0.1642,24,130,154,154,2,Malam
3097,2011-05-13,0,5,22,0,5,1,2,0.52,0.5,0.83,0.2239,25,107,132,132,2,Malam
3098,2011-05-13,0,5,23,0,5,1,3,0.5,0.4848,0.88,0.1642,31,88,119,119,2,Malam
3099,2011-05-14,0,5,0,0,6,0,2,0.5,0.4848,0.88,0.1343,24,78,102,102,2,
3100,2011-05-14,0,5,1,0,6,0,2,0.5,0.4848,0.88,0.1343,18,64,82,82,2,Pagi
3101,2011-05-14,0,5,2,0,6,0,2,0.5,0.4848,0.88,0.1343,15,37,52,52,2,Pagi
3102,2011-05-14,0,5,3,0,6,0,2,0.5,0.4848,0.88,0.1343,5,30,35,35,2,Pagi
3103,2011-05-14,0,5,4,0,6,0,2,0.5,0.4848,0.82,0.1642,1,4,5,5,2,Pagi
3104,2011-05-14,0,5,5,0,6,0,2,0.5,0.4848,0.82,0.1045,7,7,14,14,2,Pagi
3105,2011-05-14,0,5,6,0,6,0,2,0.5,0.4848,0.88,0.1045,2,9,11,11,2,Pagi
3106,2011-05-14,0,5,7,0,6,0,3,0.48,0.4697,1.0,0.0,4,28,32,32,2,Siang
3107,2011-05-14,0,5,8,0,6,0,3,0.5,0.4848,0.94,0.0,16,72,88,88,2,Siang
3108,2011-05-14,0,5,9,0,6,0,2,0.52,0.5,0.94,0.0896,14,86,100,100,2,Siang
3109,2011-05-14,0,5,10,0,6,0,2,0.52,0.5,0.94,0.1642,34,133,167,167,2,Siang
3110,2011-05-14,0,5,11,0,6,0,2,0.52,0.5,0.94,0.1343,72,207,279,279,2,Siang
3111,2011-05-14,0,5,12,0,6,0,3,0.52,0.5,1.0,0.0896,75,204,279,279,2,Siang
3112,2011-05-14,0,5,13,0,6,0,3,0.52,0.5,1.0,0.0896,68,180,248,248,2,Sore
3113,2011-05-14,0,5,14,0,6,0,2,0.54,0.5152,0.94,0.1343,57,159,216,216,2,Sore
3114,2011-05-14,0,5,15,0,6,0,2,0.54,0.5152,0.94,0.1642,73,221,294,294,2,Sore
3115,2011-05-14,0,5,16,0,6,0,2,0.54,0.5152,0.94,0.194,107,188,295,295,2,Sore
3116,2011-05-14,0,5,17,0,6,0,2,0.56,0.5303,0.88,0.194,78,194,272,272,2,Sore
3117,2011-05-14,0,5,18,0,6,0,2,0.56,0.5303,0.88,0.2239,88,216,304,304,2,Sore
3118,2011-05-14,0,5,19,0,6,0,3,0.54,0.5152,0.94,0.1343,69,179,248,248,2,Malam
3119,2011-05-14,0,5,20,0,6,0,3,0.54,0.5152,0.94,0.1343,42,115,157,157,2,Malam
3120,2011-05-14,0,5,21,0,6,0,3,0.54,0.5152,0.94,0.2239,15,44,59,59,2,Malam
3121,2011-05-14,0,5,22,0,6,0,3,0.54,0.5152,0.94,0.1642,7,19,26,26,2,Malam
3122,2011-05-14,0,5,23,0,6,0,3,0.52,0.5,1.0,0.194,11,33,44,44,2,Malam
3123,2011-05-15,0,5,0,0,0,0,2,0.52,0.5,1.0,0.0,5,34,39,39,2,
3124,2011-05-15,0,5,1,0,0,0,2,0.52,0.5,1.0,0.1045,4,43,47,47,2,Pagi
3125,2011-05-15,0,5,2,0,0,0,2,0.52,0.5,1.0,0.1343,13,37,50,50,2,Pagi
3126,2011-05-15,0,5,3,0,0,0,2,0.52,0.5,1.0,0.0,11,21,32,32,2,Pagi
3127,2011-05-15,0,5,4,0,0,0,2,0.52,0.5,1.0,0.0,5,8,13,13,2,Pagi
3128,2011-05-15,0,5,5,0,0,0,3,0.52,0.5,1.0,0.1045,3,11,14,14,2,Pagi
3129,2011-05-15,0,5,6,0,0,0,2,0.52,0.5,1.0,0.1343,3,14,17,17,2,Pagi
3130,2011-05-15,0,5,7,0,0,0,2,0.52,0.5,1.0,0.1343,4,38,42,42,2,Siang
3131,2011-05-15,0,5,8,0,0,0,2,0.54,0.5152,0.94,0.1343,24,46,70,70,2,Siang
3132,2011-05-15,0,5,9,0,0,0,1,0.58,0.5455,0.83,0.2537,36,98,134,134,2,Siang
3133,2011-05-15,0,5,10,0,0,0,1,0.58,0.5455,0.83,0.2239,73,153,226,226,2,Siang
3134,2011-05-15,0,5,11,0,0,0,1,0.6,0.5758,0.78,0.2239,120,202,322,322,2,Siang
3135,2011-05-15,0,5,12,0,0,0,1,0.62,0.5909,0.73,0.2985,120,247,367,367,2,Siang
3136,2011-05-15,0,5,13,0,0,0,1,0.62,0.5909,0.73,0.2836,195,261,456,456,2,Sore
3137,2011-05-15,0,5,14,0,0,0,1,0.64,0.6061,0.73,0.194,183,254,437,437,2,Sore
3138,2011-05-15,0,5,15,0,0,0,1,0.66,0.6212,0.69,0.2537,206,253,459,459,2,Sore
3139,2011-05-15,0,5,16,0,0,0,1,0.64,0.6061,0.69,0.2537,158,282,440,440,2,Sore
3140,2011-05-15,0,5,17,0,0,0,3,0.56,0.5303,0.78,0.3582,137,255,392,392,2,Sore
3141,2011-05-15,0,5,18,0,0,0,1,0.56,0.5303,0.78,0.2537,60,177,237,237,2,Sore
3142,2011-05-15,0,5,19,0,0,0,1,0.56,0.5303,0.83,0.1045,78,153,231,231,2,Malam
3143,2011-05-15,0,5,20,0,0,0,1,0.54,0.5152,0.88,0.0,53,138,191,191,2,Malam
3144,2011-05-15,0,5,21,0,0,0,1,0.54,0.5152,0.88,0.0,44,107,151,151,2,Malam
3145,2011-05-15,0,5,22,0,0,0,1,0.56,0.5303,0.83,0.0,29,88,117,117,2,Malam
3146,2011-05-15,0,5,23,0,0,0,1,0.54,0.5152,0.88,0.2239,18,51,69,69,2,Malam
3147,2011-05-16,0,5,0,0,1,1,1,0.52,0.5,0.94,0.1045,17,21,38,38,2,
3148,2011-05-16,0,5,1,0,1,1,1,0.52,0.5,0.94,0.1343,6,8,14,14,2,Pagi
3149,2011-05-16,0,5,2,0,1,1,1,0.5,0.4848,1.0,0.0896,4,9,13,13,2,Pagi
3150,2011-05-16,0,5,3,0,1,1,1,0.5,0.4848,0.94,0.1642,1,3,4,4,2,Pagi
3151,2011-05-16,0,5,4,0,1,1,1,0.5,0.4848,1.0,0.1343,1,5,6,6,2,Pagi
3152,2011-05-16,0,5,5,0,1,1,1,0.5,0.4848,0.93,0.194,1,20,21,21,2,Pagi
3153,2011-05-16,0,5,6,0,1,1,1,0.52,0.5,0.88,0.1642,11,93,104,104,2,Pagi
3154,2011-05-16,0,5,7,0,1,1,1,0.52,0.5,0.83,0.2836,27,245,272,272,2,Siang
3155,2011-05-16,0,5,8,0,1,1,1,0.56,0.5303,0.73,0.2985,28,366,394,394,2,Siang
3156,2011-05-16,0,5,9,0,1,1,1,0.6,0.5909,0.69,0.194,38,156,194,194,2,Siang
3157,2011-05-16,0,5,10,0,1,1,1,0.62,0.6061,0.65,0.0896,37,75,112,112,2,Siang
3158,2011-05-16,0,5,11,0,1,1,1,0.64,0.6212,0.57,0.0,56,129,185,185,2,Siang
3159,2011-05-16,0,5,12,0,1,1,1,0.66,0.6212,0.54,0.0896,72,137,209,209,2,Siang
3160,2011-05-16,0,5,13,0,1,1,1,0.68,0.6364,0.51,0.0,61,153,214,214,2,Sore
3161,2011-05-16,0,5,14,0,1,1,1,0.68,0.6364,0.51,0.0,76,117,193,193,2,Sore
3162,2011-05-16,0,5,15,0,1,1,1,0.72,0.6667,0.51,0.0,55,110,165,165,2,Sore
3163,2011-05-16,0,5,16,0,1,1,3,0.6,0.5758,0.78,0.2537,45,181,226,226,2,Sore
3164,2011-05-16,0,5,17,0,1,1,1,0.58,0.5455,0.88,0.2239,47,227,274,274,2,Sore
3165,2011-05-16,0,5,18,0,1,1,3,0.58,0.5455,0.83,0.194,55,398,453,453,2,Sore
3166,2011-05-16,0,5,19,0,1,1,1,0.58,0.5455,0.83,0.2537,36,272,308,308,2,Malam
3167,2011-05-16,0,5,20,0,1,1,1,0.58,0.5455,0.83,0.0,31,167,198,198,2,Malam
3168,2011-05-16,0,5,21,0,1,1,1,0.58,0.5455,0.83,0.0,28,149,177,177,2,Malam
3169,2011-05-16,0,5,22,0,1,1,1,0.56,0.5303,0.88,0.0896,22,105,127,127,2,Malam
3170,2011-05-16,0,5,23,0,1,1,1,0.56,0.5303,0.88,0.0896,18,39,57,57,2,Malam
3171,2011-05-17,0,5,0,0,2,1,2,0.56,0.5303,0.88,0.0,13,18,31,31,2,
3172,2011-05-17,0,5,1,0,2,1,3,0.56,0.5303,0.88,0.0,7,6,13,13,2,Pagi
3173,2011-05-17,0,5,2,0,2,1,3,0.56,0.5303,0.88,0.0,4,4,8,8,2,Pagi
3174,2011-05-17,0,5,3,0,2,1,3,0.54,0.5152,0.94,0.2537,1,3,4,4,2,Pagi
3175,2011-05-17,0,5,4,0,2,1,3,0.54,0.5152,0.94,0.2537,2,2,4,4,2,Pagi
3176,2011-05-17,0,5,5,0,2,1,3,0.52,0.5,0.94,0.2537,0,22,22,22,2,Pagi
3177,2011-05-17,0,5,6,0,2,1,3,0.52,0.5,0.94,0.2537,0,49,49,49,2,Pagi
3178,2011-05-17,0,5,7,0,2,1,2,0.52,0.5,0.94,0.2537,13,138,151,151,2,Siang
3179,2011-05-17,0,5,8,0,2,1,2,0.52,0.5,0.94,0.2985,22,325,347,347,2,Siang
3180,2011-05-17,0,5,9,0,2,1,2,0.54,0.5152,0.88,0.2537,17,190,207,207,2,Siang
3181,2011-05-17,0,5,10,0,2,1,3,0.54,0.5152,0.88,0.2537,31,73,104,104,2,Siang
3182,2011-05-17,0,5,11,0,2,1,2,0.56,0.5303,0.83,0.4179,26,104,130,130,2,Siang
3183,2011-05-17,0,5,12,0,2,1,3,0.56,0.5303,0.83,0.4179,38,115,153,153,2,Siang
3184,2011-05-17,0,5,13,0,2,1,2,0.56,0.5303,0.88,0.3284,31,141,172,172,2,Sore
3185,2011-05-17,0,5,14,0,2,1,1,0.62,0.5909,0.73,0.4627,61,123,184,184,2,Sore
3186,2011-05-17,0,5,15,0,2,1,1,0.62,0.6061,0.69,0.4478,79,131,210,210,2,Sore
3187,2011-05-17,0,5,16,0,2,1,1,0.62,0.6061,0.61,0.3284,73,217,290,290,2,Sore
3188,2011-05-17,0,5,17,0,2,1,1,0.62,0.6061,0.65,0.4179,83,521,604,604,2,Sore
3189,2011-05-17,0,5,18,0,2,1,1,0.6,0.5909,0.69,0.2985,54,426,480,480,2,Sore
3190,2011-05-17,0,5,19,0,2,1,1,0.6,0.5909,0.69,0.2537,51,298,349,349,2,Malam
3191,2011-05-17,0,5,20,0,2,1,1,0.58,0.5455,0.83,0.4179,30,253,283,283,2,Malam
3192,2011-05-17,0,5,21,0,2,1,1,0.54,0.5152,0.88,0.2537,23,151,174,174,2,Malam
3193,2011-05-17,0,5,22,0,2,1,2,0.54,0.5152,0.88,0.2836,12,86,98,98,2,Malam
3194,2011-05-17,0,5,23,0,2,1,2,0.54,0.5152,0.88,0.2537,7,49,56,56,2,Malam
3195,2011-05-18,0,5,0,0,3,1,2,0.54,0.5152,0.88,0.2239,8,15,23,23,2,
3196,2011-05-18,0,5,1,0,3,1,2,0.54,0.5152,0.88,0.2537,3,9,12,12,2,Pagi
3197,2011-05-18,0,5,2,0,3,1,3,0.52,0.5,0.94,0.2239,1,5,6,6,2,Pagi
3198,2011-05-18,0,5,3,0,3,1,3,0.52,0.5,0.94,0.2985,6,3,9,9,2,Pagi
3199,2011-05-18,0,5,4,0,3,1,3,0.52,0.5,0.94,0.2985,1,2,3,3,2,Pagi
3200,2011-05-18,0,5,5,0,3,1,1,0.52,0.5,1.0,0.2239,0,9,9,9,2,Pagi
3201,2011-05-18,0,5,6,0,3,1,1,0.52,0.5,1.0,0.1343,2,99,101,101,2,Pagi
3202,2011-05-18,0,5,7,0,3,1,1,0.54,0.5152,0.88,0.194,14,260,274,274,2,Siang
3203,2011-05-18,0,5,8,0,3,1,1,0.56,0.5303,0.88,0.2836,25,428,453,453,2,Siang
3204,2011-05-18,0,5,9,0,3,1,3,0.56,0.5303,0.83,0.2537,26,176,202,202,2,Siang
3205,2011-05-18,0,5,10,0,3,1,3,0.54,0.5152,0.88,0.2836,33,73,106,106,2,Siang
3206,2011-05-18,0,5,11,0,3,1,2,0.54,0.5152,0.94,0.0896,6,17,23,23,2,Siang
3207,2011-05-18,0,5,12,0,3,1,1,0.56,0.5303,0.94,0.2985,12,42,54,54,2,Siang
3208,2011-05-18,0,5,13,0,3,1,2,0.56,0.5303,0.83,0.3284,30,92,122,122,2,Sore
3209,2011-05-18,0,5,14,0,3,1,2,0.58,0.5455,0.78,0.2836,44,94,138,138,2,Sore
3210,2011-05-18,0,5,15,0,3,1,1,0.6,0.5758,0.78,0.2537,34,133,167,167,2,Sore
3211,2011-05-18,0,5,16,0,3,1,1,0.6,0.5909,0.73,0.194,53,241,294,294,2,Sore
3212,2011-05-18,0,5,17,0,3,1,1,0.6,0.5909,0.69,0.1343,78,487,565,565,2,Sore
3213,2011-05-18,0,5,18,0,3,1,1,0.6,0.5909,0.73,0.2239,58,431,489,489,2,Sore
3214,2011-05-18,0,5,19,0,3,1,3,0.56,0.5303,0.88,0.1343,43,288,331,331,2,Malam
3215,2011-05-18,0,5,20,0,3,1,3,0.56,0.5303,0.88,0.1343,24,189,213,213,2,Malam
3216,2011-05-18,0,5,21,0,3,1,1,0.52,0.5,0.88,0.0,11,74,85,85,2,Malam
3217,2011-05-18,0,5,22,0,3,1,1,0.52,0.5,0.83,0.0,14,103,117,117,2,Malam
3218,2011-05-18,0,5,23,0,3,1,1,0.52,0.5,0.94,0.0896,10,49,59,59,2,Malam
3219,2011-05-19,0,5,0,0,4,1,1,0.52,0.5,0.94,0.1045,6,23,29,29,2,
3220,2011-05-19,0,5,1,0,4,1,1,0.5,0.4848,0.94,0.0,2,4,6,6,2,Pagi
3221,2011-05-19,0,5,2,0,4,1,1,0.5,0.4848,0.94,0.0,3,12,15,15,2,Pagi
3222,2011-05-19,0,5,3,0,4,1,1,0.48,0.4697,1.0,0.0,1,3,4,4,2,Pagi
3223,2011-05-19,0,5,4,0,4,1,1,0.48,0.4697,0.94,0.0,2,3,5,5,2,Pagi
3224,2011-05-19,0,5,5,0,4,1,1,0.48,0.4697,0.94,0.0,2,24,26,26,2,Pagi
3225,2011-05-19,0,5,6,0,4,1,2,0.5,0.4848,0.94,0.0,17,86,103,103,2,Pagi
3226,2011-05-19,0,5,7,0,4,1,2,0.5,0.4848,1.0,0.0,18,239,257,257,2,Siang
3227,2011-05-19,0,5,8,0,4,1,2,0.52,0.5,0.88,0.0,34,453,487,487,2,Siang
3228,2011-05-19,0,5,9,0,4,1,2,0.54,0.5152,0.88,0.0896,40,176,216,216,2,Siang
3229,2011-05-19,0,5,10,0,4,1,2,0.54,0.5152,0.83,0.0,35,95,130,130,2,Siang
3230,2011-05-19,0,5,11,0,4,1,3,0.54,0.5152,0.88,0.1642,53,111,164,164,2,Siang
3231,2011-05-19,0,5,12,0,4,1,2,0.58,0.5455,0.78,0.1045,38,130,168,168,2,Siang
3232,2011-05-19,0,5,13,0,4,1,3,0.58,0.5455,0.64,0.2537,44,139,183,183,2,Sore
3233,2011-05-19,0,5,14,0,4,1,3,0.54,0.5152,0.73,0.194,43,137,180,180,2,Sore
3234,2011-05-19,0,5,15,0,4,1,1,0.56,0.5303,0.78,0.1642,63,125,188,188,2,Sore
3235,2011-05-19,0,5,16,0,4,1,1,0.58,0.5455,0.64,0.194,55,247,302,302,2,Sore
3236,2011-05-19,0,5,17,0,4,1,1,0.56,0.5303,0.78,0.1642,60,487,547,547,2,Sore
3237,2011-05-19,0,5,18,0,4,1,1,0.6,0.6212,0.55,0.1642,59,454,513,513,2,Sore
3238,2011-05-19,0,5,19,0,4,1,1,0.58,0.5455,0.6,0.1343,65,345,410,410,2,Malam
3239,2011-05-19,0,5,20,0,4,1,1,0.54,0.5152,0.77,0.2836,46,236,282,282,2,Malam
3240,2011-05-19,0,5,21,0,4,1,1,0.54,0.5152,0.77,0.2836,29,180,209,209,2,Malam
3241,2011-05-19,0,5,22,0,4,1,3,0.5,0.4848,0.82,0.2985,11,68,79,79,2,Malam
3242,2011-05-19,0,5,23,0,4,1,1,0.48,0.4697,0.94,0.0,9,63,72,72,2,Malam
3243,2011-05-20,0,5,0,0,5,1,1,0.46,0.4545,0.94,0.0896,15,33,48,48,2,
3244,2011-05-20,0,5,1,0,5,1,1,0.46,0.4545,1.0,0.0,8,17,25,25,2,Pagi
3245,2011-05-20,0,5,2,0,5,1,1,0.44,0.4394,1.0,0.0896,4,4,8,8,2,Pagi
3246,2011-05-20,0,5,3,0,5,1,1,0.44,0.4394,1.0,0.0,1,4,5,5,2,Pagi
3247,2011-05-20,0,5,4,0,5,1,1,0.44,0.4394,0.94,0.0896,1,4,5,5,2,Pagi
3248,2011-05-20,0,5,5,0,5,1,1,0.44,0.4394,0.94,0.1045,0,28,28,28,2,Pagi
3249,2011-05-20,0,5,6,0,5,1,1,0.46,0.4545,0.88,0.1045,15,102,117,117,2,Pagi
3250,2011-05-20,0,5,7,0,5,1,1,0.5,0.4848,0.77,0.1642,30,289,319,319,2,Siang
3251,2011-05-20,0,5,8,0,5,1,1,0.54,0.5152,0.68,0.0,41,476,517,517,2,Siang
3252,2011-05-20,0,5,9,0,5,1,1,0.54,0.5152,0.68,0.2239,35,199,234,234,2,Siang
3253,2011-05-20,0,5,10,0,5,1,1,0.56,0.5303,0.64,0.194,44,104,148,148,2,Siang
3254,2011-05-20,0,5,11,0,5,1,2,0.58,0.5455,0.6,0.194,63,133,196,196,2,Siang
3255,2011-05-20,0,5,12,0,5,1,2,0.6,0.6212,0.56,0.2537,69,186,255,255,2,Siang
3256,2011-05-20,0,5,13,0,5,1,3,0.6,0.6212,0.56,0.2836,60,172,232,232,2,Sore
3257,2011-05-20,0,5,14,0,5,1,1,0.62,0.6212,0.53,0.2239,66,131,197,197,2,Sore
3258,2011-05-20,0,5,15,0,5,1,2,0.6,0.6212,0.56,0.194,74,168,242,242,2,Sore
3259,2011-05-20,0,5,16,0,5,1,2,0.6,0.6212,0.53,0.1642,61,269,330,330,2,Sore
3260,2011-05-20,0,5,17,0,5,1,1,0.62,0.6212,0.53,0.0,71,483,554,554,2,Sore
3261,2011-05-20,0,5,18,0,5,1,1,0.6,0.6212,0.56,0.1642,79,394,473,473,2,Sore
3262,2011-05-20,0,5,19,0,5,1,1,0.58,0.5455,0.64,0.0896,49,253,302,302,2,Malam
3263,2011-05-20,0,5,20,0,5,1,1,0.58,0.5455,0.64,0.1045,40,180,220,220,2,Malam
3264,2011-05-20,0,5,21,0,5,1,1,0.56,0.5303,0.64,0.1045,40,155,195,195,2,Malam
3265,2011-05-20,0,5,22,0,5,1,1,0.54,0.5152,0.73,0.0,28,124,152,152,2,Malam
3266,2011-05-20,0,5,23,0,5,1,1,0.52,0.5,0.72,0.1642,15,100,115,115,2,Malam
3267,2011-05-21,0,5,0,0,6,0,1,0.52,0.5,0.77,0.1045,20,78,98,98,2,
3268,2011-05-21,0,5,1,0,6,0,1,0.52,0.5,0.72,0.0,8,64,72,72,2,Pagi
3269,2011-05-21,0,5,2,0,6,0,1,0.52,0.5,0.72,0.1045,5,35,40,40,2,Pagi
3270,2011-05-21,0,5,3,0,6,0,1,0.48,0.4697,0.82,0.1045,7,12,19,19,2,Pagi
3271,2011-05-21,0,5,4,0,6,0,1,0.46,0.4545,0.88,0.1343,1,6,7,7,2,Pagi
3272,2011-05-21,0,5,5,0,6,0,1,0.46,0.4545,0.88,0.1045,1,4,5,5,2,Pagi
3273,2011-05-21,0,5,6,0,6,0,1,0.5,0.4848,0.82,0.1343,6,22,28,28,2,Pagi
3274,2011-05-21,0,5,7,0,6,0,1,0.54,0.5152,0.73,0.1343,10,33,43,43,2,Siang
3275,2011-05-21,0,5,8,0,6,0,1,0.56,0.5303,0.68,0.2836,29,97,126,126,2,Siang
3276,2011-05-21,0,5,9,0,6,0,1,0.6,0.6061,0.64,0.2239,60,165,225,225,2,Siang
3277,2011-05-21,0,5,10,0,6,0,1,0.62,0.6061,0.61,0.1045,122,201,323,323,2,Siang
3278,2011-05-21,0,5,11,0,6,0,1,0.64,0.6212,0.53,0.1343,173,245,418,418,2,Siang
3279,2011-05-21,0,5,12,0,6,0,1,0.66,0.6212,0.5,0.0,222,271,493,493,2,Siang
3280,2011-05-21,0,5,13,0,6,0,1,0.7,0.6364,0.45,0.0,191,271,462,462,2,Sore
3281,2011-05-21,0,5,14,0,6,0,1,0.72,0.6515,0.42,0.0,187,269,456,456,2,Sore
3282,2011-05-21,0,5,15,0,6,0,1,0.72,0.6515,0.45,0.2537,232,274,506,506,2,Sore
3283,2011-05-21,0,5,16,0,6,0,2,0.72,0.6515,0.39,0.2537,204,267,471,471,2,Sore
3284,2011-05-21,0,5,17,0,6,0,2,0.72,0.6515,0.42,0.1642,191,253,444,444,2,Sore
3285,2011-05-21,0,5,18,0,6,0,2,0.7,0.6364,0.45,0.1642,191,253,444,444,2,Sore
3286,2011-05-21,0,5,19,0,6,0,1,0.68,0.6364,0.47,0.1642,117,184,301,301,2,Malam
3287,2011-05-21,0,5,20,0,6,0,1,0.62,0.6061,0.61,0.0,84,164,248,248,2,Malam
3288,2011-05-21,0,5,21,0,6,0,1,0.62,0.6061,0.61,0.1045,77,150,227,227,2,Malam
3289,2011-05-21,0,5,22,0,6,0,1,0.6,0.5909,0.69,0.1343,78,126,204,204,2,Malam
3290,2011-05-21,0,5,23,0,6,0,1,0.58,0.5455,0.78,0.0896,42,103,145,145,2,Malam
3291,2011-05-22,0,5,0,0,0,0,1,0.54,0.5152,0.88,0.1642,31,100,131,131,2,
3292,2011-05-22,0,5,1,0,0,0,1,0.52,0.5,0.94,0.1343,17,81,98,98,2,Pagi
3293,2011-05-22,0,5,2,0,0,0,1,0.52,0.5,0.94,0.1045,18,50,68,68,2,Pagi
3294,2011-05-22,0,5,3,0,0,0,1,0.5,0.4848,1.0,0.1045,10,23,33,33,2,Pagi
3295,2011-05-22,0,5,4,0,0,0,1,0.5,0.4848,1.0,0.0,3,9,12,12,2,Pagi
3296,2011-05-22,0,5,5,0,0,0,1,0.5,0.4848,1.0,0.1045,1,5,6,6,2,Pagi
3297,2011-05-22,0,5,6,0,0,0,1,0.52,0.5,0.94,0.1045,5,13,18,18,2,Pagi
3298,2011-05-22,0,5,7,0,0,0,1,0.54,0.5152,0.88,0.1045,13,27,40,40,2,Siang
3299,2011-05-22,0,5,8,0,0,0,1,0.6,0.5909,0.73,0.0896,29,65,94,94,2,Siang
3300,2011-05-22,0,5,9,0,0,0,1,0.62,0.6061,0.69,0.1045,59,130,189,189,2,Siang
3301,2011-05-22,0,5,10,0,0,0,1,0.64,0.6061,0.65,0.1343,135,170,305,305,2,Siang
3302,2011-05-22,0,5,11,0,0,0,1,0.7,0.6515,0.54,0.194,164,209,373,373,2,Siang
3303,2011-05-22,0,5,12,0,0,0,2,0.72,0.6667,0.51,0.194,146,255,401,401,2,Siang
3304,2011-05-22,0,5,13,0,0,0,2,0.66,0.6212,0.54,0.2239,180,275,455,455,2,Sore
3305,2011-05-22,0,5,14,0,0,0,3,0.62,0.6061,0.69,0.194,125,191,316,316,2,Sore
3306,2011-05-22,0,5,15,0,0,0,2,0.66,0.6212,0.61,0.1642,110,221,331,331,2,Sore
3307,2011-05-22,0,5,16,0,0,0,1,0.68,0.6364,0.61,0.1343,72,201,273,273,2,Sore
3308,2011-05-22,0,5,17,0,0,0,1,0.7,0.6515,0.58,0.2537,93,213,306,306,2,Sore
3309,2011-05-22,0,5,18,0,0,0,1,0.66,0.6212,0.61,0.2239,120,238,358,358,2,Sore
3310,2011-05-22,0,5,19,0,0,0,1,0.66,0.6212,0.61,0.194,107,193,300,300,2,Malam
3311,2011-05-22,0,5,20,0,0,0,1,0.64,0.6061,0.65,0.1642,57,174,231,231,2,Malam
3312,2011-05-22,0,5,21,0,0,0,1,0.62,0.5909,0.73,0.194,27,109,136,136,2,Malam
3313,2011-05-22,0,5,22,0,0,0,1,0.6,0.5606,0.83,0.1343,35,86,121,121,2,Malam
3314,2011-05-22,0,5,23,0,0,0,2,0.58,0.5455,0.83,0.1343,19,46,65,65,2,Malam
3315,2011-05-23,0,5,0,0,1,1,2,0.56,0.5303,0.88,0.1343,23,18,41,41,2,
3316,2011-05-23,0,5,1,0,1,1,1,0.56,0.5303,0.88,0.1045,4,5,9,9,2,Pagi
3317,2011-05-23,0,5,2,0,1,1,3,0.56,0.5303,0.88,0.1642,2,3,5,5,2,Pagi
3318,2011-05-23,0,5,3,0,1,1,3,0.54,0.5152,0.94,0.1642,0,4,4,4,2,Pagi
3319,2011-05-23,0,5,4,0,1,1,2,0.54,0.5152,0.94,0.0,2,2,4,4,2,Pagi
3320,2011-05-23,0,5,5,0,1,1,2,0.54,0.5152,0.94,0.0,0,11,11,11,2,Pagi
3321,2011-05-23,0,5,6,0,1,1,2,0.54,0.5152,1.0,0.0,4,92,96,96,2,Pagi
3322,2011-05-23,0,5,7,0,1,1,2,0.56,0.5303,0.94,0.1045,13,223,236,236,2,Siang
3323,2011-05-23,0,5,8,0,1,1,1,0.6,0.5455,0.88,0.194,50,359,409,409,2,Siang
3324,2011-05-23,0,5,9,0,1,1,1,0.6,0.5455,0.88,0.2239,36,131,167,167,2,Siang
3325,2011-05-23,0,5,10,0,1,1,1,0.66,0.6212,0.74,0.2985,49,72,121,121,2,Siang
3326,2011-05-23,0,5,11,0,1,1,1,0.68,0.6364,0.69,0.3881,73,107,180,180,2,Siang
3327,2011-05-23,0,5,12,0,1,1,1,0.68,0.6364,0.69,0.3881,65,139,204,204,2,Siang
3328,2011-05-23,0,5,13,0,1,1,2,0.74,0.6818,0.58,0.4179,49,155,204,204,2,Sore
3329,2011-05-23,0,5,14,0,1,1,2,0.72,0.6818,0.62,0.5224,57,130,187,187,2,Sore
3330,2011-05-23,0,5,15,0,1,1,2,0.72,0.6818,0.62,0.4478,57,119,176,176,2,Sore
3331,2011-05-23,0,5,16,0,1,1,2,0.72,0.6818,0.62,0.2985,56,223,279,279,2,Sore
3332,2011-05-23,0,5,17,0,1,1,3,0.72,0.6818,0.7,0.3881,56,373,429,429,2,Sore
3333,2011-05-23,0,5,18,0,1,1,1,0.7,0.6667,0.74,0.2836,68,385,453,453,2,Sore
3334,2011-05-23,0,5,19,0,1,1,1,0.7,0.6667,0.74,0.2239,56,302,358,358,2,Malam
3335,2011-05-23,0,5,20,0,1,1,1,0.64,0.5758,0.83,0.2239,39,271,310,310,2,Malam
3336,2011-05-23,0,5,21,0,1,1,1,0.64,0.5758,0.89,0.2239,33,155,188,188,2,Malam
3337,2011-05-23,0,5,22,0,1,1,1,0.62,0.5455,0.94,0.2239,25,106,131,131,2,Malam
3338,2011-05-23,0,5,23,0,1,1,2,0.62,0.5606,0.88,0.194,19,53,72,72,2,Malam
3339,2011-05-24,0,5,0,0,2,1,2,0.6,0.5152,0.94,0.194,12,23,35,35,2,
3340,2011-05-24,0,5,1,0,2,1,2,0.6,0.5152,0.94,0.1642,6,9,15,15,2,Pagi
3341,2011-05-24,0,5,2,0,2,1,2,0.6,0.5152,0.94,0.194,2,8,10,10,2,Pagi
3342,2011-05-24,0,5,3,0,2,1,2,0.58,0.5455,0.94,0.1045,0,2,2,2,2,Pagi
3343,2011-05-24,0,5,4,0,2,1,1,0.6,0.5455,0.88,0.1045,1,3,4,4,2,Pagi
3344,2011-05-24,0,5,5,0,2,1,2,0.58,0.5455,0.94,0.2537,2,22,24,24,2,Pagi
3345,2011-05-24,0,5,6,0,2,1,2,0.58,0.5455,0.94,0.194,10,102,112,112,2,Pagi
3346,2011-05-24,0,5,7,0,2,1,3,0.64,0.5909,0.78,0.194,26,288,314,314,2,Siang
3347,2011-05-24,0,5,8,0,2,1,3,0.62,0.5758,0.83,0.2239,31,403,434,434,2,Siang
3348,2011-05-24,0,5,9,0,2,1,2,0.64,0.6061,0.73,0.194,27,111,138,138,2,Siang
3349,2011-05-24,0,5,10,0,2,1,1,0.7,0.6515,0.61,0.3284,18,90,108,108,2,Siang
3350,2011-05-24,0,5,11,0,2,1,1,0.74,0.6667,0.51,0.2239,33,142,175,175,2,Siang
3351,2011-05-24,0,5,12,0,2,1,1,0.76,0.6818,0.45,0.3881,41,129,170,170,2,Siang
3352,2011-05-24,0,5,13,0,2,1,1,0.78,0.697,0.46,0.2537,38,152,190,190,2,Sore
3353,2011-05-24,0,5,14,0,2,1,1,0.78,0.697,0.46,0.2836,27,126,153,153,2,Sore
3354,2011-05-24,0,5,15,0,2,1,3,0.74,0.6818,0.55,0.4179,59,129,188,188,2,Sore
3355,2011-05-24,0,5,16,0,2,1,1,0.66,0.6212,0.69,0.194,52,225,277,277,2,Sore
3356,2011-05-24,0,5,17,0,2,1,1,0.7,0.6515,0.61,0.1045,56,492,548,548,2,Sore
3357,2011-05-24,0,5,18,0,2,1,1,0.7,0.6515,0.7,0.194,74,490,564,564,2,Sore
3358,2011-05-24,0,5,19,0,2,1,1,0.66,0.6212,0.74,0.194,45,310,355,355,2,Malam
3359,2011-05-24,0,5,20,0,2,1,1,0.66,0.6212,0.74,0.0896,39,241,280,280,2,Malam
3360,2011-05-24,0,5,21,0,2,1,1,0.64,0.5909,0.78,0.0896,21,168,189,189,2,Malam
3361,2011-05-24,0,5,22,0,2,1,3,0.62,0.5606,0.88,0.2239,26,115,141,141,2,Malam
3362,2011-05-24,0,5,23,0,2,1,3,0.66,0.6212,0.74,0.1642,13,53,66,66,2,Malam
3363,2011-05-25,0,5,0,0,3,1,3,0.6,0.5606,0.83,0.2239,3,32,35,35,2,
3364,2011-05-25,0,5,1,0,3,1,3,0.58,0.5455,0.83,0.194,6,2,8,8,2,Pagi
3365,2011-05-25,0,5,2,0,3,1,2,0.56,0.5303,0.94,0.0,0,8,8,8,2,Pagi
3366,2011-05-25,0,5,3,0,3,1,1,0.54,0.5152,1.0,0.1343,0,9,9,9,2,Pagi
3367,2011-05-25,0,5,4,0,3,1,1,0.54,0.5152,1.0,0.1045,0,3,3,3,2,Pagi
3368,2011-05-25,0,5,5,0,3,1,1,0.56,0.5303,0.88,0.0896,2,23,25,25,2,Pagi
3369,2011-05-25,0,5,6,0,3,1,1,0.56,0.5303,0.94,0.0896,4,113,117,117,2,Pagi
3370,2011-05-25,0,5,7,0,3,1,1,0.62,0.5909,0.73,0.1343,29,284,313,313,2,Siang
3371,2011-05-25,0,5,8,0,3,1,1,0.64,0.6061,0.69,0.2239,36,495,531,531,2,Siang
3372,2011-05-25,0,5,9,0,3,1,1,0.68,0.6364,0.65,0.0896,27,207,234,234,2,Siang
3373,2011-05-25,0,5,10,0,3,1,1,0.7,0.6515,0.61,0.0896,30,105,135,135,2,Siang
3374,2011-05-25,0,5,11,0,3,1,1,0.74,0.6667,0.51,0.0896,36,104,140,140,2,Siang
3375,2011-05-25,0,5,12,0,3,1,1,0.74,0.6818,0.55,0.1343,32,178,210,210,2,Siang
3376,2011-05-25,0,5,13,0,3,1,1,0.74,0.6818,0.55,0.1343,39,163,202,202,2,Sore
3377,2011-05-25,0,5,14,0,3,1,1,0.74,0.6818,0.55,0.1642,47,121,168,168,2,Sore
3378,2011-05-25,0,5,15,0,3,1,1,0.76,0.697,0.52,0.2537,37,145,182,182,2,Sore
3379,2011-05-25,0,5,16,0,3,1,1,0.74,0.6667,0.51,0.2836,61,238,299,299,2,Sore
3380,2011-05-25,0,5,17,0,3,1,1,0.74,0.6667,0.51,0.2239,77,524,601,601,2,Sore
3381,2011-05-25,0,5,18,0,3,1,1,0.72,0.6667,0.58,0.2239,66,451,517,517,2,Sore
3382,2011-05-25,0,5,19,0,3,1,1,0.7,0.6515,0.61,0.1343,73,332,405,405,2,Malam
3383,2011-05-25,0,5,20,0,3,1,1,0.7,0.6515,0.61,0.1642,56,284,340,340,2,Malam
3384,2011-05-25,0,5,21,0,3,1,1,0.66,0.6212,0.69,0.1343,33,203,236,236,2,Malam
3385,2011-05-25,0,5,22,0,3,1,1,0.66,0.6212,0.69,0.2537,34,140,174,174,2,Malam
3386,2011-05-25,0,5,23,0,3,1,1,0.64,0.6061,0.73,0.1343,12,74,86,86,2,Malam
3387,2011-05-26,0,5,0,0,4,1,1,0.64,0.6061,0.73,0.1343,11,34,45,45,2,
3388,2011-05-26,0,5,1,0,4,1,1,0.64,0.6061,0.73,0.1343,3,13,16,16,2,Pagi
3389,2011-05-26,0,5,2,0,4,1,1,0.62,0.5758,0.83,0.1045,7,7,14,14,2,Pagi
3390,2011-05-26,0,5,3,0,4,1,1,0.6,0.5455,0.88,0.0896,0,4,4,4,2,Pagi
3391,2011-05-26,0,5,4,0,4,1,1,0.6,0.5455,0.88,0.0,0,2,2,2,2,Pagi
3392,2011-05-26,0,5,5,0,4,1,2,0.6,0.5455,0.88,0.0896,2,25,27,27,2,Pagi
3393,2011-05-26,0,5,6,0,4,1,2,0.6,0.5,1.0,0.0896,4,94,98,98,2,Pagi
3394,2011-05-26,0,5,7,0,4,1,2,0.62,0.5455,0.94,0.2537,16,270,286,286,2,Siang
3395,2011-05-26,0,5,8,0,4,1,2,0.66,0.6061,0.83,0.1642,31,458,489,489,2,Siang
3396,2011-05-26,0,5,9,0,4,1,1,0.72,0.6818,0.7,0.1642,22,194,216,216,2,Siang
3397,2011-05-26,0,5,10,0,4,1,1,0.7,0.6667,0.74,0.2836,49,94,143,143,2,Siang
3398,2011-05-26,0,5,11,0,4,1,1,0.74,0.697,0.66,0.2239,36,124,160,160,2,Siang
3399,2011-05-26,0,5,12,0,4,1,1,0.78,0.7424,0.59,0.3284,53,141,194,194,2,Siang
3400,2011-05-26,0,5,13,0,4,1,1,0.82,0.7727,0.52,0.2836,52,145,197,197,2,Sore
3401,2011-05-26,0,5,14,0,4,1,1,0.82,0.7727,0.52,0.2836,44,145,189,189,2,Sore
3402,2011-05-26,0,5,15,0,4,1,2,0.82,0.7576,0.46,0.2836,40,101,141,141,2,Sore
3403,2011-05-26,0,5,16,0,4,1,2,0.8,0.7424,0.49,0.3582,58,233,291,291,2,Sore
3404,2011-05-26,0,5,17,0,4,1,1,0.8,0.7273,0.46,0.2836,49,445,494,494,2,Sore
3405,2011-05-26,0,5,18,0,4,1,1,0.8,0.7273,0.46,0.3284,74,404,478,478,2,Sore
3406,2011-05-26,0,5,19,0,4,1,1,0.78,0.697,0.46,0.3284,67,311,378,378,2,Malam
3407,2011-05-26,0,5,20,0,4,1,1,0.72,0.6667,0.58,0.1642,55,267,322,322,2,Malam
3408,2011-05-26,0,5,21,0,4,1,1,0.72,0.6818,0.62,0.0896,45,178,223,223,2,Malam
3409,2011-05-26,0,5,22,0,4,1,1,0.7,0.6515,0.65,0.1343,23,157,180,180,2,Malam
3410,2011-05-26,0,5,23,0,4,1,1,0.7,0.6515,0.65,0.194,17,73,90,90,2,Malam
3411,2011-05-27,0,5,0,0,5,1,1,0.68,0.6364,0.69,0.2537,14,55,69,69,2,
3412,2011-05-27,0,5,1,0,5,1,1,0.7,0.6515,0.58,0.2985,14,36,50,50,2,Pagi
3413,2011-05-27,0,5,2,0,5,1,1,0.68,0.6364,0.61,0.2239,6,12,18,18,2,Pagi
3414,2011-05-27,0,5,3,0,5,1,1,0.66,0.6212,0.65,0.0896,1,11,12,12,2,Pagi
3415,2011-05-27,0,5,4,0,5,1,1,0.64,0.6061,0.69,0.1343,2,5,7,7,2,Pagi
3416,2011-05-27,0,5,5,0,5,1,1,0.64,0.6061,0.65,0.2836,2,29,31,31,2,Pagi
3417,2011-05-27,0,5,6,0,5,1,1,0.64,0.6061,0.69,0.0896,8,73,81,81,2,Pagi
3418,2011-05-27,0,5,7,0,5,1,1,0.64,0.6061,0.73,0.1642,20,229,249,249,2,Siang
3419,2011-05-27,0,5,8,0,5,1,1,0.66,0.6212,0.74,0.2836,25,393,418,418,2,Siang
3420,2011-05-27,0,5,9,0,5,1,1,0.7,0.6515,0.65,0.2836,37,190,227,227,2,Siang
3421,2011-05-27,0,5,10,0,5,1,1,0.72,0.6667,0.54,0.3881,42,111,153,153,2,Siang
3422,2011-05-27,0,5,11,0,5,1,2,0.74,0.6818,0.55,0.3284,40,126,166,166,2,Siang
3423,2011-05-27,0,5,12,0,5,1,2,0.76,0.697,0.55,0.2985,53,190,243,243,2,Siang
3424,2011-05-27,0,5,13,0,5,1,1,0.74,0.6818,0.58,0.194,51,158,209,209,2,Sore
3425,2011-05-27,0,5,14,0,5,1,1,0.76,0.697,0.55,0.2537,51,188,239,239,2,Sore
3426,2011-05-27,0,5,15,0,5,1,1,0.78,0.7121,0.49,0.2836,98,258,356,356,2,Sore
3427,2011-05-27,0,5,16,0,5,1,2,0.76,0.697,0.55,0.3881,63,356,419,419,2,Sore
3428,2011-05-27,0,5,17,0,5,1,1,0.74,0.6818,0.58,0.3881,77,414,491,491,2,Sore
3429,2011-05-27,0,5,18,0,5,1,2,0.72,0.6818,0.62,0.2985,89,310,399,399,2,Sore
3430,2011-05-27,0,5,19,0,5,1,3,0.6,0.5758,0.78,0.2537,69,210,279,279,2,Malam
3431,2011-05-27,0,5,20,0,5,1,2,0.62,0.5909,0.73,0.2239,24,120,144,144,2,Malam
3432,2011-05-27,0,5,21,0,5,1,1,0.6,0.5606,0.83,0.1045,37,114,151,151,2,Malam
3433,2011-05-27,0,5,22,0,5,1,1,0.6,0.5758,0.78,0.1343,25,116,141,141,2,Malam
3434,2011-05-27,0,5,23,0,5,1,1,0.58,0.5455,0.88,0.1343,23,104,127,127,2,Malam
3435,2011-05-28,0,5,0,0,6,0,1,0.58,0.5455,0.88,0.1343,15,79,94,94,2,
3436,2011-05-28,0,5,1,0,6,0,1,0.58,0.5455,0.88,0.194,8,47,55,55,2,Pagi
3437,2011-05-28,0,5,2,0,6,0,1,0.56,0.5303,0.94,0.194,13,35,48,48,2,Pagi
3438,2011-05-28,0,5,3,0,6,0,1,0.56,0.5303,0.88,0.2239,2,13,15,15,2,Pagi
3439,2011-05-28,0,5,4,0,6,0,1,0.56,0.5303,0.88,0.2537,0,4,4,4,2,Pagi
3440,2011-05-28,0,5,5,0,6,0,1,0.56,0.5303,0.88,0.2239,4,3,7,7,2,Pagi
3441,2011-05-28,0,5,6,0,6,0,1,0.58,0.5455,0.83,0.2537,3,16,19,19,2,Pagi
3442,2011-05-28,0,5,7,0,6,0,1,0.6,0.5606,0.83,0.2537,17,33,50,50,2,Siang
3443,2011-05-28,0,5,8,0,6,0,1,0.62,0.5909,0.78,0.194,27,75,102,102,2,Siang
3444,2011-05-28,0,5,9,0,6,0,1,0.64,0.6061,0.73,0.2537,61,116,177,177,2,Siang
3445,2011-05-28,0,5,10,0,6,0,1,0.7,0.6515,0.65,0.2239,110,166,276,276,2,Siang
3446,2011-05-28,0,5,11,0,6,0,1,0.7,0.6515,0.65,0.2239,171,178,349,349,2,Siang
3447,2011-05-28,0,5,12,0,6,0,1,0.72,0.6667,0.58,0.2537,145,213,358,358,2,Siang
3448,2011-05-28,0,5,13,0,6,0,1,0.72,0.6818,0.62,0.2239,168,217,385,385,2,Sore
3449,2011-05-28,0,5,14,0,6,0,1,0.74,0.6818,0.58,0.2239,172,210,382,382,2,Sore
3450,2011-05-28,0,5,15,0,6,0,1,0.74,0.6818,0.55,0.2239,187,187,374,374,2,Sore
3451,2011-05-28,0,5,16,0,6,0,1,0.76,0.697,0.55,0.2836,201,201,402,402,2,Sore
3452,2011-05-28,0,5,17,0,6,0,1,0.74,0.6818,0.55,0.2985,180,161,341,341,2,Sore
3453,2011-05-28,0,5,18,0,6,0,1,0.72,0.6818,0.62,0.2537,173,212,385,385,2,Sore
3454,2011-05-28,0,5,19,0,6,0,1,0.7,0.6515,0.65,0.194,99,153,252,252,2,Malam
3455,2011-05-28,0,5,20,0,6,0,1,0.7,0.6515,0.65,0.2239,68,128,196,196,2,Malam
3456,2011-05-28,0,5,21,0,6,0,1,0.66,0.6212,0.74,0.2985,87,114,201,201,2,Malam
3457,2011-05-28,0,5,22,0,6,0,1,0.66,0.6061,0.78,0.2239,46,115,161,161,2,Malam
3458,2011-05-28,0,5,23,0,6,0,1,0.64,0.5758,0.83,0.194,44,81,125,125,2,Malam
3459,2011-05-29,0,5,0,0,0,0,1,0.64,0.5758,0.83,0.2239,32,51,83,83,2,
3460,2011-05-29,0,5,1,0,0,0,1,0.62,0.5606,0.88,0.1642,17,49,66,66,2,Pagi
3461,2011-05-29,0,5,2,0,0,0,1,0.62,0.5606,0.88,0.1045,12,49,61,61,2,Pagi
3462,2011-05-29,0,5,3,0,0,0,1,0.62,0.5606,0.88,0.1045,2,24,26,26,2,Pagi
3463,2011-05-29,0,5,4,0,0,0,1,0.6,0.5455,0.88,0.0896,13,10,23,23,2,Pagi
3464,2011-05-29,0,5,5,0,0,0,1,0.6,0.5152,0.94,0.1642,3,3,6,6,2,Pagi
3465,2011-05-29,0,5,6,0,0,0,2,0.62,0.5606,0.88,0.194,5,10,15,15,2,Pagi
3466,2011-05-29,0,5,7,0,0,0,2,0.62,0.5606,0.88,0.2537,13,17,30,30,2,Siang
3467,2011-05-29,0,5,8,0,0,0,2,0.62,0.5606,0.88,0.2239,34,62,96,96,2,Siang
3468,2011-05-29,0,5,9,0,0,0,2,0.62,0.5455,0.94,0.2537,74,78,152,152,2,Siang
3469,2011-05-29,0,5,10,0,0,0,2,0.66,0.6061,0.83,0.2239,130,121,251,251,2,Siang
3470,2011-05-29,0,5,11,0,0,0,2,0.66,0.6061,0.83,0.2836,139,180,319,319,2,Siang
3471,2011-05-29,0,5,12,0,0,0,2,0.7,0.6667,0.74,0.2239,216,186,402,402,2,Siang
3472,2011-05-29,0,5,13,0,0,0,1,0.72,0.6818,0.7,0.2836,237,181,418,418,2,Sore
3473,2011-05-29,0,5,14,0,0,0,1,0.74,0.697,0.7,0.2836,183,168,351,351,2,Sore
3474,2011-05-29,0,5,15,0,0,0,1,0.74,0.697,0.7,0.2985,221,155,376,376,2,Sore
3475,2011-05-29,0,5,16,0,0,0,1,0.74,0.697,0.7,0.2836,194,167,361,361,2,Sore
3476,2011-05-29,0,5,17,0,0,0,1,0.74,0.697,0.7,0.2836,214,169,383,383,2,Sore
3477,2011-05-29,0,5,18,0,0,0,1,0.72,0.697,0.74,0.2836,151,177,328,328,2,Sore
3478,2011-05-29,0,5,19,0,0,0,1,0.72,0.697,0.74,0.2537,141,146,287,287,2,Malam
3479,2011-05-29,0,5,20,0,0,0,1,0.7,0.6667,0.79,0.194,91,128,219,219,2,Malam
3480,2011-05-29,0,5,21,0,0,0,1,0.68,0.6364,0.83,0.1642,107,122,229,229,2,Malam
3481,2011-05-29,0,5,22,0,0,0,1,0.66,0.5909,0.89,0.1343,78,93,171,171,2,Malam
3482,2011-05-29,0,5,23,0,0,0,1,0.66,0.5909,0.89,0.1642,48,87,135,135,2,Malam
3483,2011-05-30,0,5,0,1,1,0,1,0.64,0.5606,0.94,0.194,38,65,103,103,2,
3484,2011-05-30,0,5,1,1,1,0,1,0.64,0.5606,0.94,0.1343,26,53,79,79,2,Pagi
3485,2011-05-30,0,5,2,1,1,0,1,0.64,0.5606,0.94,0.194,17,28,45,45,2,Pagi
3486,2011-05-30,0,5,3,1,1,0,1,0.64,0.5606,0.94,0.194,10,8,18,18,2,Pagi
3487,2011-05-30,0,5,4,1,1,0,1,0.62,0.5455,0.94,0.1642,2,4,6,6,2,Pagi
3488,2011-05-30,0,5,5,1,1,0,2,0.62,0.5455,0.94,0.1045,1,6,7,7,2,Pagi
3489,2011-05-30,0,5,6,1,1,0,2,0.64,0.5606,0.94,0.0896,6,10,16,16,2,Pagi
3490,2011-05-30,0,5,7,1,1,0,2,0.64,0.5606,0.94,0.0,12,19,31,31,2,Siang
3491,2011-05-30,0,5,8,1,1,0,2,0.66,0.5909,0.89,0.1045,36,58,94,94,2,Siang
3492,2011-05-30,0,5,9,1,1,0,1,0.72,0.697,0.74,0.0896,47,81,128,128,2,Siang
3493,2011-05-30,0,5,10,1,1,0,1,0.8,0.7576,0.55,0.2537,116,153,269,269,2,Siang
3494,2011-05-30,0,5,11,1,1,0,1,0.82,0.7727,0.52,0.0,153,168,321,321,2,Siang
3495,2011-05-30,0,5,12,1,1,0,1,0.86,0.803,0.47,0.1045,179,187,366,366,2,Siang
3496,2011-05-30,0,5,13,1,1,0,1,0.86,0.7879,0.44,0.0896,133,217,350,350,2,Sore
3497,2011-05-30,0,5,14,1,1,0,1,0.88,0.803,0.39,0.0,142,185,327,327,2,Sore
3498,2011-05-30,0,5,15,1,1,0,1,0.88,0.803,0.39,0.2537,132,179,311,311,2,Sore
3499,2011-05-30,0,5,16,1,1,0,1,0.88,0.7879,0.37,0.2836,101,208,309,309,2,Sore
3500,2011-05-30,0,5,17,1,1,0,1,0.86,0.7879,0.41,0.2239,102,202,304,304,2,Sore
3501,2011-05-30,0,5,18,1,1,0,1,0.86,0.7879,0.41,0.1642,77,172,249,249,2,Sore
3502,2011-05-30,0,5,19,1,1,0,2,0.52,0.5,0.48,0.1045,68,157,225,225,2,Malam
3503,2011-05-30,0,5,20,1,1,0,1,0.76,0.7121,0.58,0.0,69,168,237,237,2,Malam
3504,2011-05-30,0,5,21,1,1,0,1,0.74,0.697,0.7,0.1343,42,107,149,149,2,Malam
3505,2011-05-30,0,5,22,1,1,0,1,0.72,0.697,0.74,0.1642,26,80,106,106,2,Malam
3506,2011-05-30,0,5,23,1,1,0,1,0.7,0.6667,0.84,0.1045,14,34,48,48,2,Malam
3507,2011-05-31,0,5,0,0,2,1,1,0.7,0.6667,0.79,0.0896,9,20,29,29,2,
3508,2011-05-31,0,5,1,0,2,1,1,0.68,0.6364,0.89,0.0896,8,9,17,17,2,Pagi
3509,2011-05-31,0,5,2,0,2,1,2,0.66,0.5909,0.94,0.1343,5,7,12,12,2,Pagi
3510,2011-05-31,0,5,3,0,2,1,2,0.64,0.5606,0.94,0.0,1,3,4,4,2,Pagi
3511,2011-05-31,0,5,4,0,2,1,1,0.66,0.6061,0.83,0.0896,0,3,3,3,2,Pagi
3512,2011-05-31,0,5,5,0,2,1,1,0.66,0.6061,0.83,0.0896,0,26,26,26,2,Pagi
3513,2011-05-31,0,5,6,0,2,1,1,0.68,0.6364,0.79,0.0896,11,98,109,109,2,Pagi
3514,2011-05-31,0,5,7,0,2,1,1,0.74,0.697,0.66,0.1045,16,219,235,235,2,Siang
3515,2011-05-31,0,5,8,0,2,1,1,0.78,0.7424,0.59,0.1343,34,372,406,406,2,Siang
3516,2011-05-31,0,5,9,0,2,1,1,0.8,0.7576,0.55,0.1343,22,153,175,175,2,Siang
3517,2011-05-31,0,5,10,0,2,1,1,0.82,0.7879,0.56,0.1343,37,72,109,109,2,Siang
3518,2011-05-31,0,5,11,0,2,1,1,0.86,0.803,0.47,0.0,28,78,106,106,2,Siang
3519,2011-05-31,0,5,12,0,2,1,1,0.86,0.803,0.47,0.1343,37,125,162,162,2,Siang
3520,2011-05-31,0,5,13,0,2,1,1,0.9,0.8333,0.39,0.1642,37,110,147,147,2,Sore
3521,2011-05-31,0,5,14,0,2,1,1,0.9,0.8182,0.37,0.0,41,99,140,140,2,Sore
3522,2011-05-31,0,5,15,0,2,1,1,0.9,0.8182,0.37,0.1642,42,133,175,175,2,Sore
3523,2011-05-31,0,5,16,0,2,1,1,0.9,0.8333,0.39,0.1343,44,205,249,249,2,Sore
3524,2011-05-31,0,5,17,0,2,1,1,0.84,0.803,0.53,0.2239,67,428,495,495,2,Sore
3525,2011-05-31,0,5,18,0,2,1,1,0.84,0.803,0.53,0.194,55,362,417,417,2,Sore
3526,2011-05-31,0,5,19,0,2,1,1,0.78,0.7424,0.62,0.1045,39,246,285,285,2,Malam
3527,2011-05-31,0,5,20,0,2,1,1,0.78,0.7424,0.62,0.1045,38,213,251,251,2,Malam
3528,2011-05-31,0,5,21,0,2,1,1,0.76,0.7273,0.66,0.1045,45,165,210,210,2,Malam
3529,2011-05-31,0,5,22,0,2,1,1,0.74,0.697,0.7,0.1642,42,117,159,159,2,Malam
3530,2011-05-31,0,5,23,0,2,1,1,0.72,0.697,0.79,0.0896,15,46,61,61,2,Malam
3531,2011-06-01,0,6,0,0,3,1,1,0.7,0.6667,0.79,0.1642,9,25,34,34,2,
3532,2011-06-01,0,6,1,0,3,1,1,0.7,0.6667,0.84,0.2537,8,9,17,17,2,Pagi
3533,2011-06-01,0,6,2,0,3,1,1,0.7,0.6667,0.79,0.1642,0,3,3,3,2,Pagi
3534,2011-06-01,0,6,3,0,3,1,1,0.68,0.6364,0.89,0.194,0,6,6,6,2,Pagi
3535,2011-06-01,0,6,4,0,3,1,2,0.68,0.6364,0.89,0.2239,0,4,4,4,2,Pagi
3536,2011-06-01,0,6,5,0,3,1,2,0.66,0.5909,0.89,0.0896,2,19,21,21,2,Pagi
3537,2011-06-01,0,6,6,0,3,1,2,0.68,0.6364,0.89,0.0896,7,121,128,128,2,Pagi
3538,2011-06-01,0,6,7,0,3,1,2,0.7,0.6667,0.79,0.1642,19,265,284,284,2,Siang
3539,2011-06-01,0,6,8,0,3,1,2,0.72,0.697,0.79,0.194,37,417,454,454,2,Siang
3540,2011-06-01,0,6,9,0,3,1,2,0.74,0.7121,0.74,0.2239,34,173,207,207,2,Siang
3541,2011-06-01,0,6,10,0,3,1,2,0.76,0.7424,0.75,0.2537,31,84,115,115,2,Siang
3542,2011-06-01,0,6,11,0,3,1,2,0.82,0.803,0.59,0.2239,26,86,112,112,2,Siang
3543,2011-06-01,0,6,12,0,3,1,1,0.86,0.8333,0.53,0.0,32,137,169,169,2,Siang
3544,2011-06-01,0,6,13,0,3,1,1,0.9,0.8182,0.37,0.194,29,125,154,154,2,Sore
3545,2011-06-01,0,6,14,0,3,1,1,0.9,0.8182,0.37,0.2537,40,105,145,145,2,Sore
3546,2011-06-01,0,6,15,0,3,1,1,0.9,0.8333,0.39,0.2985,25,127,152,152,2,Sore
3547,2011-06-01,0,6,16,0,3,1,1,0.86,0.803,0.47,0.2985,39,227,266,266,2,Sore
3548,2011-06-01,0,6,17,0,3,1,1,0.86,0.803,0.47,0.2985,52,434,486,486,2,Sore
3549,2011-06-01,0,6,18,0,3,1,3,0.82,0.7879,0.56,0.3881,31,278,309,309,2,Sore
3550,2011-06-01,0,6,19,0,3,1,2,0.74,0.7121,0.79,0.1642,16,248,264,264,2,Malam
3551,2011-06-01,0,6,20,0,3,1,2,0.74,0.7121,0.79,0.2537,23,233,256,256,2,Malam
3552,2011-06-01,0,6,21,0,3,1,1,0.74,0.697,0.7,0.2836,29,161,190,190,2,Malam
3553,2011-06-01,0,6,22,0,3,1,1,0.74,0.697,0.66,0.1343,14,115,129,129,2,Malam
3554,2011-06-01,0,6,23,0,3,1,1,0.74,0.6667,0.51,0.1642,10,59,69,69,2,Malam
3555,2011-06-02,0,6,0,0,4,1,1,0.74,0.6515,0.4,0.3582,11,31,42,42,2,
3556,2011-06-02,0,6,1,0,4,1,1,0.72,0.6515,0.38,0.1045,3,12,15,15,2,Pagi
3557,2011-06-02,0,6,2,0,4,1,1,0.7,0.6364,0.39,0.0,0,6,6,6,2,Pagi
3558,2011-06-02,0,6,3,0,4,1,1,0.66,0.6212,0.44,0.1045,0,4,4,4,2,Pagi
3559,2011-06-02,0,6,4,0,4,1,1,0.66,0.6212,0.41,0.194,0,3,3,3,2,Pagi
3560,2011-06-02,0,6,5,0,4,1,1,0.66,0.6212,0.39,0.2239,3,28,31,31,2,Pagi
3561,2011-06-02,0,6,6,0,4,1,1,0.66,0.6212,0.39,0.1343,7,106,113,113,2,Pagi
3562,2011-06-02,0,6,7,0,4,1,1,0.7,0.6364,0.34,0.2537,19,285,304,304,2,Siang
3563,2011-06-02,0,6,8,0,4,1,1,0.7,0.6364,0.32,0.2985,25,442,467,467,2,Siang
3564,2011-06-02,0,6,9,0,4,1,1,0.72,0.6364,0.26,0.3582,28,197,225,225,2,Siang
3565,2011-06-02,0,6,10,0,4,1,1,0.72,0.6515,0.28,0.4925,33,106,139,139,2,Siang
3566,2011-06-02,0,6,11,0,4,1,1,0.74,0.6515,0.28,0.3881,42,123,165,165,2,Siang
3567,2011-06-02,0,6,12,0,4,1,1,0.76,0.6667,0.25,0.4627,39,193,232,232,2,Siang
3568,2011-06-02,0,6,13,0,4,1,1,0.8,0.6818,0.24,0.3582,35,168,203,203,2,Sore
3569,2011-06-02,0,6,14,0,4,1,1,0.78,0.6667,0.24,0.3284,43,142,185,185,2,Sore
3570,2011-06-02,0,6,15,0,4,1,1,0.8,0.6818,0.21,0.3881,44,144,188,188,2,Sore
3571,2011-06-02,0,6,16,0,4,1,1,0.8,0.6818,0.22,0.4925,63,255,318,318,2,Sore
3572,2011-06-02,0,6,17,0,4,1,1,0.76,0.6515,0.2,0.5224,88,484,572,572,2,Sore
3573,2011-06-02,0,6,18,0,4,1,1,0.74,0.6515,0.22,0.3881,74,451,525,525,2,Sore
3574,2011-06-02,0,6,19,0,4,1,1,0.72,0.6364,0.23,0.2985,58,321,379,379,2,Malam
3575,2011-06-02,0,6,20,0,4,1,1,0.7,0.6364,0.24,0.194,51,286,337,337,2,Malam
3576,2011-06-02,0,6,21,0,4,1,1,0.66,0.6212,0.31,0.194,33,215,248,248,2,Malam
3577,2011-06-02,0,6,22,0,4,1,1,0.64,0.6212,0.33,0.2537,14,141,155,155,2,Malam
3578,2011-06-02,0,6,23,0,4,1,1,0.62,0.6212,0.35,0.2239,23,89,112,112,2,Malam
3579,2011-06-03,0,6,0,0,5,1,1,0.62,0.6212,0.38,0.2836,15,53,68,68,2,
3580,2011-06-03,0,6,1,0,5,1,1,0.6,0.6212,0.38,0.3582,7,15,22,22,2,Pagi
3581,2011-06-03,0,6,2,0,5,1,1,0.56,0.5303,0.43,0.2239,0,12,12,12,2,Pagi
3582,2011-06-03,0,6,3,0,5,1,1,0.54,0.5152,0.49,0.2239,0,5,5,5,2,Pagi
3583,2011-06-03,0,6,4,0,5,1,1,0.52,0.5,0.48,0.3284,1,5,6,6,2,Pagi
3584,2011-06-03,0,6,5,0,5,1,1,0.52,0.5,0.48,0.3582,4,24,28,28,2,Pagi
3585,2011-06-03,0,6,6,0,5,1,1,0.54,0.5152,0.45,0.2985,8,98,106,106,2,Pagi
3586,2011-06-03,0,6,7,0,5,1,1,0.54,0.5152,0.45,0.2537,25,252,277,277,2,Siang
3587,2011-06-03,0,6,8,0,5,1,2,0.56,0.5303,0.43,0.3284,31,471,502,502,2,Siang
3588,2011-06-03,0,6,9,0,5,1,1,0.58,0.5455,0.4,0.1642,36,194,230,230,2,Siang
3589,2011-06-03,0,6,10,0,5,1,1,0.62,0.6212,0.33,0.2537,54,107,161,161,2,Siang
3590,2011-06-03,0,6,11,0,5,1,1,0.64,0.6212,0.31,0.3284,57,135,192,192,2,Siang
3591,2011-06-03,0,6,12,0,5,1,1,0.66,0.6212,0.27,0.2836,51,208,259,259,2,Siang
3592,2011-06-03,0,6,13,0,5,1,1,0.68,0.6212,0.26,0.2537,58,190,248,248,2,Sore
3593,2011-06-03,0,6,14,0,5,1,1,0.7,0.6364,0.28,0.2836,66,174,240,240,2,Sore
3594,2011-06-03,0,6,15,0,5,1,1,0.7,0.6364,0.28,0.2836,56,156,212,212,2,Sore
3595,2011-06-03,0,6,16,0,5,1,1,0.72,0.6364,0.26,0.3284,63,286,349,349,2,Sore
3596,2011-06-03,0,6,17,0,5,1,1,0.72,0.6364,0.25,0.2836,73,485,558,558,2,Sore
3597,2011-06-03,0,6,18,0,5,1,1,0.7,0.6364,0.24,0.2985,76,488,564,564,2,Sore
3598,2011-06-03,0,6,19,0,5,1,1,0.68,0.6212,0.26,0.2836,53,338,391,391,2,Malam
3599,2011-06-03,0,6,20,0,5,1,1,0.64,0.6212,0.29,0.1642,57,236,293,293,2,Malam
3600,2011-06-03,0,6,21,0,5,1,1,0.64,0.6212,0.29,0.1045,51,196,247,247,2,Malam
3601,2011-06-03,0,6,22,0,5,1,1,0.62,0.6212,0.35,0.0,26,145,171,171,2,Malam
3602,2011-06-03,0,6,23,0,5,1,1,0.58,0.5455,0.46,0.1045,30,141,171,171,2,Malam
3603,2011-06-04,0,6,0,0,6,0,1,0.56,0.5303,0.52,0.0,24,69,93,93,2,
3604,2011-06-04,0,6,1,0,6,0,1,0.54,0.5152,0.64,0.1045,14,80,94,94,2,Pagi
3605,2011-06-04,0,6,2,0,6,0,1,0.54,0.5152,0.56,0.194,18,41,59,59,2,Pagi
3606,2011-06-04,0,6,3,0,6,0,1,0.52,0.5,0.59,0.1045,8,10,18,18,2,Pagi
3607,2011-06-04,0,6,4,0,6,0,1,0.52,0.5,0.59,0.0896,4,11,15,15,2,Pagi
3608,2011-06-04,0,6,5,0,6,0,1,0.5,0.4848,0.64,0.0,3,5,8,8,2,Pagi
3609,2011-06-04,0,6,6,0,6,0,1,0.54,0.5152,0.6,0.0,11,17,28,28,2,Pagi
3610,2011-06-04,0,6,7,0,6,0,1,0.56,0.5303,0.56,0.0,27,60,87,87,2,Siang
3611,2011-06-04,0,6,8,0,6,0,1,0.6,0.6212,0.46,0.0896,29,96,125,125,2,Siang
3612,2011-06-04,0,6,9,0,6,0,1,0.62,0.6212,0.43,0.1343,55,169,224,224,2,Siang
3613,2011-06-04,0,6,10,0,6,0,1,0.64,0.6212,0.38,0.1045,115,202,317,317,2,Siang
3614,2011-06-04,0,6,11,0,6,0,1,0.66,0.6212,0.36,0.1343,120,249,369,369,2,Siang
3615,2011-06-04,0,6,12,0,6,0,1,0.7,0.6364,0.32,0.1642,150,270,420,420,2,Siang
3616,2011-06-04,0,6,13,0,6,0,1,0.74,0.6515,0.28,0.1343,188,268,456,456,2,Sore
3617,2011-06-04,0,6,14,0,6,0,1,0.74,0.6515,0.33,0.2239,193,258,451,451,2,Sore
3618,2011-06-04,0,6,15,0,6,0,2,0.74,0.6515,0.27,0.4179,180,224,404,404,2,Sore
3619,2011-06-04,0,6,16,0,6,0,2,0.72,0.6515,0.3,0.1343,168,272,440,440,2,Sore
3620,2011-06-04,0,6,17,0,6,0,2,0.72,0.6515,0.34,0.2537,142,202,344,344,2,Sore
3621,2011-06-04,0,6,18,0,6,0,2,0.74,0.6515,0.3,0.1642,127,214,341,341,2,Sore
3622,2011-06-04,0,6,19,0,6,0,2,0.7,0.6364,0.39,0.0896,79,206,285,285,2,Malam
3623,2011-06-04,0,6,20,0,6,0,2,0.7,0.6515,0.48,0.0896,90,149,239,239,2,Malam
3624,2011-06-04,0,6,21,0,6,0,2,0.66,0.6212,0.47,0.1045,46,139,185,185,2,Malam
3625,2011-06-04,0,6,22,0,6,0,1,0.64,0.6212,0.57,0.2239,49,141,190,190,2,Malam
3626,2011-06-04,0,6,23,0,6,0,2,0.64,0.6212,0.57,0.0,29,121,150,150,2,Malam
3627,2011-06-05,0,6,0,0,0,0,1,0.64,0.6212,0.57,0.0896,23,90,113,113,2,
3628,2011-06-05,0,6,1,0,0,0,2,0.64,0.6212,0.61,0.1642,26,70,96,96,2,Pagi
3629,2011-06-05,0,6,2,0,0,0,2,0.64,0.6212,0.61,0.1642,16,48,64,64,2,Pagi
3630,2011-06-05,0,6,3,0,0,0,2,0.62,0.6061,0.65,0.1642,22,25,47,47,2,Pagi
3631,2011-06-05,0,6,4,0,0,0,2,0.62,0.6061,0.65,0.1642,4,8,12,12,2,Pagi
3632,2011-06-05,0,6,5,0,0,0,2,0.62,0.6061,0.61,0.1343,1,5,6,6,2,Pagi
3633,2011-06-05,0,6,6,0,0,0,2,0.62,0.6061,0.61,0.1045,10,11,21,21,2,Pagi
3634,2011-06-05,0,6,7,0,0,0,2,0.6,0.5909,0.73,0.2537,8,19,27,27,2,Siang
3635,2011-06-05,0,6,8,0,0,0,2,0.6,0.5909,0.73,0.2537,24,74,98,98,2,Siang
3636,2011-06-05,0,6,9,0,0,0,2,0.6,0.5758,0.78,0.194,53,111,164,164,2,Siang
3637,2011-06-05,0,6,10,0,0,0,2,0.62,0.5909,0.73,0.0896,83,168,251,251,2,Siang
3638,2011-06-05,0,6,11,0,0,0,2,0.64,0.6061,0.69,0.1045,121,214,335,335,2,Siang
3639,2011-06-05,0,6,12,0,0,0,2,0.64,0.6061,0.69,0.1045,123,212,335,335,2,Siang
3640,2011-06-05,0,6,13,0,0,0,1,0.66,0.6212,0.65,0.1045,154,213,367,367,2,Sore
3641,2011-06-05,0,6,14,0,0,0,1,0.7,0.6515,0.58,0.1642,161,224,385,385,2,Sore
3642,2011-06-05,0,6,15,0,0,0,1,0.7,0.6515,0.54,0.0,161,256,417,417,2,Sore
3643,2011-06-05,0,6,16,0,0,0,1,0.72,0.6667,0.51,0.0896,138,260,398,398,2,Sore
3644,2011-06-05,0,6,17,0,0,0,1,0.74,0.6667,0.51,0.0,126,264,390,390,2,Sore
3645,2011-06-05,0,6,18,0,0,0,1,0.7,0.6515,0.58,0.1045,124,239,363,363,2,Sore
3646,2011-06-05,0,6,19,0,0,0,1,0.68,0.6364,0.65,0.1642,108,249,357,357,2,Malam
3647,2011-06-05,0,6,20,0,0,0,1,0.66,0.6212,0.69,0.194,84,195,279,279,2,Malam
3648,2011-06-05,0,6,21,0,0,0,1,0.64,0.6061,0.73,0.1642,54,111,165,165,2,Malam
3649,2011-06-05,0,6,22,0,0,0,1,0.64,0.5909,0.78,0.2239,36,94,130,130,2,Malam
3650,2011-06-05,0,6,23,0,0,0,1,0.62,0.5909,0.78,0.1343,25,61,86,86,2,Malam
3651,2011-06-06,0,6,0,0,1,1,1,0.62,0.5909,0.78,0.1343,11,18,29,29,2,
3652,2011-06-06,0,6,1,0,1,1,1,0.6,0.5606,0.83,0.1343,9,5,14,14,2,Pagi
3653,2011-06-06,0,6,2,0,1,1,1,0.58,0.5455,0.88,0.1045,4,4,8,8,2,Pagi
3654,2011-06-06,0,6,3,0,1,1,1,0.58,0.5455,0.88,0.0,2,3,5,5,2,Pagi
3655,2011-06-06,0,6,4,0,1,1,1,0.56,0.5303,0.94,0.1045,4,4,8,8,2,Pagi
3656,2011-06-06,0,6,5,0,1,1,1,0.56,0.5303,0.88,0.0896,7,24,31,31,2,Pagi
3657,2011-06-06,0,6,6,0,1,1,1,0.58,0.5455,0.88,0.0,11,101,112,112,2,Pagi
3658,2011-06-06,0,6,7,0,1,1,1,0.62,0.5909,0.78,0.1045,18,281,299,299,2,Siang
3659,2011-06-06,0,6,8,0,1,1,1,0.64,0.6061,0.73,0.0896,28,410,438,438,2,Siang
3660,2011-06-06,0,6,9,0,1,1,1,0.7,0.6515,0.58,0.1642,26,162,188,188,2,Siang
3661,2011-06-06,0,6,10,0,1,1,1,0.72,0.6667,0.51,0.2239,31,64,95,95,2,Siang
3662,2011-06-06,0,6,11,0,1,1,1,0.74,0.6667,0.42,0.1343,39,72,111,111,2,Siang
3663,2011-06-06,0,6,12,0,1,1,1,0.76,0.6667,0.37,0.1642,25,128,153,153,2,Siang
3664,2011-06-06,0,6,13,0,1,1,1,0.78,0.6818,0.35,0.0,28,152,180,180,2,Sore
3665,2011-06-06,0,6,14,0,1,1,1,0.78,0.6818,0.31,0.1343,46,99,145,145,2,Sore
3666,2011-06-06,0,6,15,0,1,1,1,0.8,0.697,0.29,0.194,38,127,165,165,2,Sore
3667,2011-06-06,0,6,16,0,1,1,1,0.76,0.6667,0.33,0.1343,34,233,267,267,2,Sore
3668,2011-06-06,0,6,17,0,1,1,1,0.78,0.6818,0.33,0.2836,63,516,579,579,2,Sore
3669,2011-06-06,0,6,18,0,1,1,1,0.76,0.6667,0.31,0.1343,56,500,556,556,2,Sore
3670,2011-06-06,0,6,19,0,1,1,1,0.72,0.6667,0.54,0.194,64,343,407,407,2,Malam
3671,2011-06-06,0,6,20,0,1,1,1,0.68,0.6364,0.61,0.1343,59,277,336,336,2,Malam
3672,2011-06-06,0,6,21,0,1,1,1,0.66,0.6212,0.57,0.0896,29,160,189,189,2,Malam
3673,2011-06-06,0,6,22,0,1,1,1,0.66,0.6212,0.61,0.0896,36,137,173,173,2,Malam
3674,2011-06-06,0,6,23,0,1,1,1,0.64,0.6061,0.69,0.0896,5,55,60,60,2,Malam
3675,2011-06-07,0,6,0,0,2,1,1,0.64,0.6061,0.65,0.0896,5,15,20,20,2,
3676,2011-06-07,0,6,1,0,2,1,1,0.62,0.6061,0.69,0.1343,2,2,4,4,2,Pagi
3677,2011-06-07,0,6,2,0,2,1,1,0.6,0.5909,0.73,0.0896,3,2,5,5,2,Pagi
3678,2011-06-07,0,6,3,0,2,1,1,0.6,0.5909,0.73,0.0896,1,1,2,2,2,Pagi
3679,2011-06-07,0,6,4,0,2,1,1,0.58,0.5455,0.83,0.1343,2,3,5,5,2,Pagi
3680,2011-06-07,0,6,5,0,2,1,1,0.58,0.5455,0.88,0.1642,2,30,32,32,2,Pagi
3681,2011-06-07,0,6,6,0,2,1,1,0.6,0.5758,0.78,0.1343,10,116,126,126,2,Pagi
3682,2011-06-07,0,6,7,0,2,1,2,0.64,0.6061,0.69,0.194,23,311,334,334,2,Siang
3683,2011-06-07,0,6,8,0,2,1,2,0.68,0.6364,0.61,0.1343,45,432,477,477,2,Siang
3684,2011-06-07,0,6,9,0,2,1,2,0.72,0.6667,0.58,0.2239,27,190,217,217,2,Siang
3685,2011-06-07,0,6,10,0,2,1,2,0.76,0.6818,0.48,0.194,37,86,123,123,2,Siang
3686,2011-06-07,0,6,11,0,2,1,2,0.76,0.697,0.52,0.2537,38,113,151,151,2,Siang
3687,2011-06-07,0,6,12,0,2,1,2,0.8,0.7273,0.46,0.2836,42,141,183,183,2,Siang
3688,2011-06-07,0,6,13,0,2,1,2,0.8,0.7273,0.43,0.2537,55,141,196,196,2,Sore
3689,2011-06-07,0,6,14,0,2,1,2,0.8,0.7273,0.43,0.2836,34,112,146,146,2,Sore
3690,2011-06-07,0,6,15,0,2,1,2,0.82,0.7424,0.41,0.3284,56,127,183,183,2,Sore
3691,2011-06-07,0,6,16,0,2,1,1,0.8,0.7121,0.38,0.2239,55,253,308,308,2,Sore
3692,2011-06-07,0,6,17,0,2,1,1,0.8,0.7273,0.43,0.2537,64,475,539,539,2,Sore
3693,2011-06-07,0,6,18,0,2,1,1,0.78,0.697,0.46,0.2836,72,479,551,551,2,Sore
3694,2011-06-07,0,6,19,0,2,1,1,0.76,0.6818,0.48,0.2537,69,355,424,424,2,Malam
3695,2011-06-07,0,6,20,0,2,1,1,0.74,0.6818,0.56,0.1343,45,301,346,346,2,Malam
3696,2011-06-07,0,6,21,0,2,1,1,0.72,0.6818,0.7,0.1343,31,187,218,218,2,Malam
3697,2011-06-07,0,6,22,0,2,1,1,0.7,0.6515,0.65,0.1343,27,126,153,153,2,Malam
3698,2011-06-07,0,6,23,0,2,1,1,0.68,0.6364,0.79,0.1045,18,72,90,90,2,Malam
3699,2011-06-08,0,6,0,0,3,1,1,0.66,0.5909,0.89,0.1343,12,29,41,41,2,
3700,2011-06-08,0,6,1,0,3,1,1,0.66,0.6061,0.78,0.0,3,20,23,23,2,Pagi
3701,2011-06-08,0,6,2,0,3,1,1,0.64,0.5758,0.89,0.0896,0,7,7,7,2,Pagi
3702,2011-06-08,0,6,3,0,3,1,1,0.64,0.5758,0.89,0.0896,2,1,3,3,2,Pagi
3703,2011-06-08,0,6,4,0,3,1,1,0.62,0.5758,0.83,0.0,0,6,6,6,2,Pagi
3704,2011-06-08,0,6,5,0,3,1,1,0.62,0.5606,0.88,0.0,0,21,21,21,2,Pagi
3705,2011-06-08,0,6,6,0,3,1,1,0.64,0.5758,0.89,0.1343,13,103,116,116,2,Pagi
3706,2011-06-08,0,6,7,0,3,1,1,0.66,0.6212,0.74,0.1045,24,329,353,353,2,Siang
3707,2011-06-08,0,6,8,0,3,1,1,0.76,0.7121,0.58,0.1642,46,435,481,481,2,Siang
3708,2011-06-08,0,6,9,0,3,1,1,0.76,0.7121,0.58,0.1642,34,168,202,202,2,Siang
3709,2011-06-08,0,6,10,0,3,1,1,0.82,0.7424,0.43,0.2239,27,63,90,90,2,Siang
3710,2011-06-08,0,6,11,0,3,1,1,0.84,0.7576,0.41,0.194,28,106,134,134,2,Siang
3711,2011-06-08,0,6,12,0,3,1,1,0.88,0.8182,0.42,0.1343,15,134,149,149,2,Siang
3712,2011-06-08,0,6,13,0,3,1,1,0.9,0.8485,0.42,0.0,20,116,136,136,2,Sore
3713,2011-06-08,0,6,14,0,3,1,1,0.92,0.8788,0.4,0.2537,44,111,155,155,2,Sore
3714,2011-06-08,0,6,15,0,3,1,1,0.92,0.8788,0.4,0.1642,28,100,128,128,2,Sore
3715,2011-06-08,0,6,16,0,3,1,1,0.92,0.8788,0.4,0.2239,34,199,233,233,2,Sore
3716,2011-06-08,0,6,17,0,3,1,1,0.92,0.8485,0.35,0.2239,80,426,506,506,2,Sore
3717,2011-06-08,0,6,18,0,3,1,1,0.9,0.8182,0.37,0.2239,61,398,459,459,2,Sore
3718,2011-06-08,0,6,19,0,3,1,1,0.82,0.803,0.59,0.1343,61,323,384,384,2,Malam
3719,2011-06-08,0,6,20,0,3,1,1,0.8,0.7879,0.63,0.1343,55,225,280,280,2,Malam
3720,2011-06-08,0,6,21,0,3,1,1,0.8,0.803,0.66,0.1343,34,168,202,202,2,Malam
3721,2011-06-08,0,6,22,0,3,1,1,0.76,0.7424,0.75,0.1642,37,139,176,176,2,Malam
3722,2011-06-08,0,6,23,0,3,1,1,0.76,0.7424,0.75,0.194,18,98,116,116,2,Malam
3723,2011-06-09,0,6,0,0,4,1,2,0.74,0.7121,0.79,0.1343,7,40,47,47,2,
3724,2011-06-09,0,6,1,0,4,1,1,0.74,0.7121,0.79,0.1045,3,13,16,16,2,Pagi
3725,2011-06-09,0,6,2,0,4,1,2,0.72,0.7121,0.84,0.1642,0,6,6,6,2,Pagi
3726,2011-06-09,0,6,3,0,4,1,2,0.72,0.7121,0.84,0.1045,0,2,2,2,2,Pagi
3727,2011-06-09,0,6,4,0,4,1,2,0.72,0.697,0.79,0.0896,2,4,6,6,2,Pagi
3728,2011-06-09,0,6,5,0,4,1,2,0.7,0.6667,0.84,0.0,1,19,20,20,2,Pagi
3729,2011-06-09,0,6,6,0,4,1,2,0.72,0.7121,0.84,0.0896,13,105,118,118,2,Pagi
3730,2011-06-09,0,6,7,0,4,1,2,0.72,0.697,0.79,0.1343,31,283,314,314,2,Siang
3731,2011-06-09,0,6,8,0,4,1,2,0.76,0.7273,0.7,0.1045,32,400,432,432,2,Siang
3732,2011-06-09,0,6,9,0,4,1,1,0.84,0.7879,0.49,0.0,20,148,168,168,2,Siang
3733,2011-06-09,0,6,10,0,4,1,1,0.86,0.8182,0.5,0.2836,20,74,94,94,2,Siang
3734,2011-06-09,0,6,11,0,4,1,1,0.9,0.8485,0.42,0.2239,36,82,118,118,2,Siang
3735,2011-06-09,0,6,12,0,4,1,1,0.92,0.8485,0.35,0.194,40,100,140,140,2,Siang
3736,2011-06-09,0,6,13,0,4,1,1,0.9,0.8182,0.37,0.0896,18,118,136,136,2,Sore
3737,2011-06-09,0,6,14,0,4,1,1,0.92,0.8788,0.4,0.194,25,93,118,118,2,Sore
3738,2011-06-09,0,6,15,0,4,1,1,0.94,0.8333,0.31,0.1642,18,86,104,104,2,Sore
3739,2011-06-09,0,6,16,0,4,1,1,0.92,0.8333,0.33,0.1343,30,170,200,200,2,Sore
3740,2011-06-09,0,6,17,0,4,1,1,0.9,0.8182,0.37,0.2537,54,355,409,409,2,Sore
3741,2011-06-09,0,6,18,0,4,1,1,0.88,0.803,0.39,0.2836,52,414,466,466,2,Sore
3742,2011-06-09,0,6,19,0,4,1,2,0.84,0.7424,0.39,0.3284,55,271,326,326,2,Malam
3743,2011-06-09,0,6,20,0,4,1,2,0.8,0.7273,0.43,0.194,40,214,254,254,2,Malam
3744,2011-06-09,0,6,21,0,4,1,3,0.76,0.697,0.52,0.0,29,142,171,171,2,Malam
3745,2011-06-09,0,6,22,0,4,1,2,0.74,0.6818,0.58,0.1642,22,131,153,153,2,Malam
3746,2011-06-09,0,6,23,0,4,1,2,0.74,0.697,0.57,0.1642,15,82,97,97,2,Malam
3747,2011-06-10,0,6,0,0,5,1,3,0.7,0.6515,0.65,0.2239,8,61,69,69,2,
3748,2011-06-10,0,6,1,0,5,1,3,0.7,0.6515,0.65,0.2239,5,18,23,23,2,Pagi
3749,2011-06-10,0,6,2,0,5,1,1,0.68,0.6364,0.69,0.1642,6,7,13,13,2,Pagi
3750,2011-06-10,0,6,3,0,5,1,1,0.68,0.6364,0.69,0.1642,3,3,6,6,2,Pagi
3751,2011-06-10,0,6,4,0,5,1,1,0.66,0.6061,0.78,0.1642,0,4,4,4,2,Pagi
3752,2011-06-10,0,6,5,0,5,1,1,0.66,0.6061,0.78,0.1642,0,28,28,28,2,Pagi
3753,2011-06-10,0,6,6,0,5,1,1,0.66,0.6061,0.78,0.0896,10,94,104,104,2,Pagi
3754,2011-06-10,0,6,7,0,5,1,1,0.72,0.6818,0.66,0.1045,25,242,267,267,2,Siang
3755,2011-06-10,0,6,8,0,5,1,1,0.74,0.6818,0.58,0.1343,29,423,452,452,2,Siang
3756,2011-06-10,0,6,9,0,5,1,1,0.76,0.697,0.55,0.0,37,176,213,213,2,Siang
3757,2011-06-10,0,6,10,0,5,1,1,0.78,0.7121,0.52,0.0,23,88,111,111,2,Siang
3758,2011-06-10,0,6,11,0,5,1,1,0.82,0.7576,0.46,0.0,46,107,153,153,2,Siang
3759,2011-06-10,0,6,12,0,5,1,1,0.84,0.7576,0.44,0.1343,40,167,207,207,2,Siang
3760,2011-06-10,0,6,13,0,5,1,1,0.84,0.7576,0.44,0.1045,40,149,189,189,2,Sore
3761,2011-06-10,0,6,14,0,5,1,1,0.86,0.7727,0.39,0.0,44,121,165,165,2,Sore
3762,2011-06-10,0,6,15,0,5,1,1,0.84,0.7576,0.44,0.1045,49,163,212,212,2,Sore
3763,2011-06-10,0,6,16,0,5,1,1,0.82,0.7879,0.56,0.2985,46,239,285,285,2,Sore
3764,2011-06-10,0,6,17,0,5,1,1,0.82,0.7727,0.52,0.2239,63,454,517,517,2,Sore
3765,2011-06-10,0,6,18,0,5,1,1,0.8,0.7727,0.59,0.2239,96,367,463,463,2,Sore
3766,2011-06-10,0,6,19,0,5,1,1,0.78,0.7424,0.59,0.194,61,245,306,306,2,Malam
3767,2011-06-10,0,6,20,0,5,1,1,0.76,0.7121,0.62,0.1045,53,197,250,250,2,Malam
3768,2011-06-10,0,6,21,0,5,1,1,0.76,0.7273,0.66,0.1343,55,163,218,218,2,Malam
3769,2011-06-10,0,6,22,0,5,1,1,0.72,0.697,0.74,0.2537,40,145,185,185,2,Malam
3770,2011-06-10,0,6,23,0,5,1,1,0.72,0.697,0.74,0.1642,36,110,146,146,2,Malam
3771,2011-06-11,0,6,0,0,6,0,1,0.7,0.6667,0.79,0.1343,28,89,117,117,2,
3772,2011-06-11,0,6,1,0,6,0,1,0.7,0.6667,0.79,0.0896,10,67,77,77,2,Pagi
3773,2011-06-11,0,6,2,0,6,0,1,0.7,0.6667,0.79,0.1045,10,50,60,60,2,Pagi
3774,2011-06-11,0,6,3,0,6,0,1,0.68,0.6364,0.83,0.0896,10,18,28,28,2,Pagi
3775,2011-06-11,0,6,4,0,6,0,1,0.68,0.6364,0.79,0.0896,4,9,13,13,2,Pagi
3776,2011-06-11,0,6,5,0,6,0,1,0.68,0.6364,0.74,0.1343,4,12,16,16,2,Pagi
3777,2011-06-11,0,6,6,0,6,0,1,0.7,0.6515,0.61,0.1343,9,31,40,40,2,Pagi
3778,2011-06-11,0,6,7,0,6,0,1,0.72,0.6667,0.58,0.194,18,50,68,68,2,Siang
3779,2011-06-11,0,6,8,0,6,0,1,0.74,0.6818,0.58,0.194,32,111,143,143,2,Siang
3780,2011-06-11,0,6,9,0,6,0,1,0.74,0.6818,0.62,0.1343,59,171,230,230,2,Siang
3781,2011-06-11,0,6,10,0,6,0,1,0.74,0.6818,0.58,0.1642,91,173,264,264,2,Siang
3782,2011-06-11,0,6,11,0,6,0,1,0.76,0.7121,0.62,0.1343,110,215,325,325,2,Siang
3783,2011-06-11,0,6,12,0,6,0,1,0.8,0.7576,0.55,0.2239,112,235,347,347,2,Siang
3784,2011-06-11,0,6,13,0,6,0,1,0.8,0.7576,0.55,0.194,150,237,387,387,2,Sore
3785,2011-06-11,0,6,14,0,6,0,1,0.82,0.7727,0.49,0.1045,148,232,380,380,2,Sore
3786,2011-06-11,0,6,15,0,6,0,1,0.82,0.7727,0.49,0.1045,142,232,374,374,2,Sore
3787,2011-06-11,0,6,16,0,6,0,2,0.8,0.7273,0.46,0.194,169,225,394,394,2,Sore
3788,2011-06-11,0,6,17,0,6,0,2,0.74,0.6818,0.58,0.1642,147,190,337,337,2,Sore
3789,2011-06-11,0,6,18,0,6,0,2,0.72,0.6818,0.62,0.1343,131,155,286,286,2,Sore
3790,2011-06-11,0,6,19,0,6,0,1,0.7,0.6515,0.65,0.194,97,167,264,264,2,Malam
3791,2011-06-11,0,6,20,0,6,0,1,0.68,0.6364,0.74,0.2537,95,180,275,275,2,Malam
3792,2011-06-11,0,6,21,0,6,0,1,0.66,0.6212,0.74,0.2239,76,144,220,220,2,Malam
3793,2011-06-11,0,6,22,0,6,0,1,0.66,0.6061,0.78,0.2239,53,137,190,190,2,Malam
3794,2011-06-11,0,6,23,0,6,0,1,0.66,0.6212,0.74,0.1045,24,107,131,131,2,Malam
3795,2011-06-12,0,6,0,0,0,0,1,0.66,0.6061,0.78,0.2239,19,100,119,119,2,
3796,2011-06-12,0,6,1,0,0,0,1,0.64,0.5758,0.83,0.1045,19,74,93,93,2,Pagi
3797,2011-06-12,0,6,2,0,0,0,1,0.64,0.5758,0.89,0.2537,9,57,66,66,2,Pagi
3798,2011-06-12,0,6,3,0,0,0,1,0.64,0.5758,0.89,0.2836,8,20,28,28,2,Pagi
3799,2011-06-12,0,6,4,0,0,0,1,0.62,0.5606,0.88,0.1642,8,6,14,14,2,Pagi
3800,2011-06-12,0,6,5,0,0,0,1,0.62,0.5606,0.88,0.2239,5,5,10,10,2,Pagi
3801,2011-06-12,0,6,6,0,0,0,1,0.62,0.5606,0.88,0.1045,5,9,14,14,2,Pagi
3802,2011-06-12,0,6,7,0,0,0,1,0.64,0.5909,0.78,0.1045,7,27,34,34,2,Siang
3803,2011-06-12,0,6,8,0,0,0,1,0.7,0.6667,0.74,0.0,28,64,92,92,2,Siang
3804,2011-06-12,0,6,9,0,0,0,1,0.72,0.6818,0.66,0.0,75,107,182,182,2,Siang
3805,2011-06-12,0,6,10,0,0,0,1,0.76,0.7121,0.58,0.0896,120,191,311,311,2,Siang
3806,2011-06-12,0,6,11,0,0,0,1,0.78,0.7273,0.55,0.1045,131,236,367,367,2,Siang
3807,2011-06-12,0,6,12,0,0,0,1,0.82,0.7576,0.46,0.0,176,244,420,420,2,Siang
3808,2011-06-12,0,6,13,0,0,0,1,0.78,0.7424,0.59,0.2836,109,264,373,373,2,Sore
3809,2011-06-12,0,6,14,0,0,0,1,0.82,0.7879,0.56,0.2537,96,219,315,315,2,Sore
3810,2011-06-12,0,6,15,0,0,0,1,0.8,0.7727,0.59,0.2985,142,218,360,360,2,Sore
3811,2011-06-12,0,6,16,0,0,0,3,0.68,0.6364,0.83,0.2836,115,235,350,350,2,Sore
3812,2011-06-12,0,6,17,0,0,0,3,0.68,0.6364,0.83,0.2836,94,158,252,252,2,Sore
3813,2011-06-12,0,6,18,0,0,0,1,0.7,0.6667,0.74,0.1642,69,187,256,256,2,Sore
3814,2011-06-12,0,6,19,0,0,0,1,0.7,0.6667,0.74,0.1045,67,156,223,223,2,Malam
3815,2011-06-12,0,6,20,0,0,0,1,0.66,0.6061,0.83,0.1642,62,144,206,206,2,Malam
3816,2011-06-12,0,6,21,0,0,0,1,0.66,0.6061,0.83,0.1045,39,101,140,140,2,Malam
3817,2011-06-12,0,6,22,0,0,0,1,0.64,0.5758,0.83,0.1343,31,97,128,128,2,Malam
3818,2011-06-12,0,6,23,0,0,0,1,0.64,0.5909,0.78,0.194,33,74,107,107,2,Malam
3819,2011-06-13,0,6,0,0,1,1,1,0.64,0.5909,0.78,0.1343,8,20,28,28,2,
3820,2011-06-13,0,6,1,0,1,1,1,0.64,0.6061,0.73,0.2239,6,10,16,16,2,Pagi
3821,2011-06-13,0,6,2,0,1,1,1,0.62,0.5909,0.73,0.2836,2,8,10,10,2,Pagi
3822,2011-06-13,0,6,3,0,1,1,1,0.6,0.6061,0.6,0.4925,1,6,7,7,2,Pagi
3823,2011-06-13,0,6,4,0,1,1,1,0.56,0.5303,0.64,0.2985,1,3,4,4,2,Pagi
3824,2011-06-13,0,6,5,0,1,1,1,0.54,0.5152,0.64,0.3881,2,27,29,29,2,Pagi
3825,2011-06-13,0,6,6,0,1,1,1,0.54,0.5152,0.64,0.4179,7,98,105,105,2,Pagi
3826,2011-06-13,0,6,7,0,1,1,1,0.56,0.5303,0.56,0.3582,26,302,328,328,2,Siang
3827,2011-06-13,0,6,8,0,1,1,1,0.58,0.5455,0.49,0.4478,44,432,476,476,2,Siang
3828,2011-06-13,0,6,9,0,1,1,1,0.62,0.6212,0.46,0.3582,35,189,224,224,2,Siang
3829,2011-06-13,0,6,10,0,1,1,1,0.64,0.6212,0.41,0.3284,38,80,118,118,2,Siang
3830,2011-06-13,0,6,11,0,1,1,1,0.66,0.6212,0.41,0.2985,53,106,159,159,2,Siang
3831,2011-06-13,0,6,12,0,1,1,1,0.66,0.6212,0.41,0.2836,35,161,196,196,2,Siang
3832,2011-06-13,0,6,13,0,1,1,1,0.7,0.6364,0.37,0.0,53,174,227,227,2,Sore
3833,2011-06-13,0,6,14,0,1,1,1,0.7,0.6364,0.34,0.2537,55,145,200,200,2,Sore
3834,2011-06-13,0,6,15,0,1,1,1,0.7,0.6364,0.37,0.4478,58,127,185,185,2,Sore
3835,2011-06-13,0,6,16,0,1,1,1,0.7,0.6364,0.37,0.4179,64,262,326,326,2,Sore
3836,2011-06-13,0,6,17,0,1,1,1,0.7,0.6364,0.39,0.3284,72,529,601,601,2,Sore
3837,2011-06-13,0,6,18,0,1,1,1,0.7,0.6364,0.37,0.3582,76,510,586,586,2,Sore
3838,2011-06-13,0,6,19,0,1,1,1,0.66,0.6212,0.39,0.2836,75,348,423,423,2,Malam
3839,2011-06-13,0,6,20,0,1,1,1,0.64,0.6212,0.44,0.2537,78,253,331,331,2,Malam
3840,2011-06-13,0,6,21,0,1,1,1,0.64,0.6212,0.41,0.2537,40,178,218,218,2,Malam
3841,2011-06-13,0,6,22,0,1,1,1,0.62,0.6212,0.46,0.2239,20,114,134,134,2,Malam
3842,2011-06-13,0,6,23,0,1,1,1,0.62,0.6212,0.46,0.194,14,75,89,89,2,Malam
3843,2011-06-14,0,6,0,0,2,1,1,0.6,0.6212,0.49,0.194,13,18,31,31,2,
3844,2011-06-14,0,6,1,0,2,1,1,0.6,0.6212,0.49,0.2537,3,10,13,13,2,Pagi
3845,2011-06-14,0,6,2,0,2,1,1,0.6,0.6212,0.49,0.2836,2,8,10,10,2,Pagi
3846,2011-06-14,0,6,3,0,2,1,1,0.58,0.5455,0.53,0.3284,1,1,2,2,2,Pagi
3847,2011-06-14,0,6,4,0,2,1,1,0.54,0.5152,0.6,0.2537,0,3,3,3,2,Pagi
3848,2011-06-14,0,6,5,0,2,1,1,0.54,0.5152,0.56,0.3284,3,23,26,26,2,Pagi
3849,2011-06-14,0,6,6,0,2,1,1,0.54,0.5152,0.56,0.2985,6,107,113,113,2,Pagi
3850,2011-06-14,0,6,7,0,2,1,1,0.56,0.5303,0.52,0.4179,19,346,365,365,2,Siang
3851,2011-06-14,0,6,8,0,2,1,1,0.58,0.5455,0.49,0.3881,45,441,486,486,2,Siang
3852,2011-06-14,0,6,9,0,2,1,1,0.62,0.6212,0.46,0.194,19,174,193,193,2,Siang
3853,2011-06-14,0,6,10,0,2,1,1,0.62,0.6212,0.46,0.2239,33,97,130,130,2,Siang
3854,2011-06-14,0,6,11,0,2,1,1,0.64,0.6212,0.41,0.2836,40,103,143,143,2,Siang
3855,2011-06-14,0,6,12,0,2,1,1,0.64,0.6212,0.41,0.3582,30,139,169,169,2,Siang
3856,2011-06-14,0,6,13,0,2,1,1,0.64,0.6212,0.44,0.2239,33,176,209,209,2,Sore
3857,2011-06-14,0,6,14,0,2,1,2,0.64,0.6212,0.47,0.194,41,118,159,159,2,Sore
3858,2011-06-14,0,6,15,0,2,1,1,0.64,0.6212,0.47,0.1642,42,136,178,178,2,Sore
3859,2011-06-14,0,6,16,0,2,1,1,0.68,0.6364,0.41,0.194,51,279,330,330,2,Sore
3860,2011-06-14,0,6,17,0,2,1,3,0.64,0.6212,0.5,0.2836,85,484,569,569,2,Sore
3861,2011-06-14,0,6,18,0,2,1,1,0.62,0.6212,0.51,0.3284,65,473,538,538,2,Sore
3862,2011-06-14,0,6,19,0,2,1,1,0.64,0.6212,0.5,0.3582,51,335,386,386,2,Malam
3863,2011-06-14,0,6,20,0,2,1,1,0.6,0.6212,0.56,0.1642,60,237,297,297,2,Malam
3864,2011-06-14,0,6,21,0,2,1,1,0.6,0.6212,0.56,0.2985,37,206,243,243,2,Malam
3865,2011-06-14,0,6,22,0,2,1,1,0.58,0.5455,0.6,0.2239,29,159,188,188,2,Malam
3866,2011-06-14,0,6,23,0,2,1,1,0.56,0.5303,0.68,0.2239,19,91,110,110,2,Malam
3867,2011-06-15,0,6,0,0,3,1,1,0.56,0.5303,0.64,0.3582,8,44,52,52,2,
3868,2011-06-15,0,6,1,0,3,1,1,0.54,0.5152,0.64,0.2836,0,14,14,14,2,Pagi
3869,2011-06-15,0,6,2,0,3,1,1,0.52,0.5,0.63,0.2239,0,9,9,9,2,Pagi
3870,2011-06-15,0,6,3,0,3,1,1,0.5,0.4848,0.68,0.2537,0,1,1,1,2,Pagi
3871,2011-06-15,0,6,4,0,3,1,1,0.5,0.4848,0.63,0.2836,0,4,4,4,2,Pagi
3872,2011-06-15,0,6,5,0,3,1,1,0.48,0.4697,0.67,0.2836,1,20,21,21,2,Pagi
3873,2011-06-15,0,6,6,0,3,1,1,0.5,0.4848,0.63,0.2537,11,110,121,121,2,Pagi
3874,2011-06-15,0,6,7,0,3,1,1,0.54,0.5152,0.6,0.1343,22,348,370,370,2,Siang
3875,2011-06-15,0,6,8,0,3,1,1,0.58,0.5455,0.53,0.1343,53,445,498,498,2,Siang
3876,2011-06-15,0,6,9,0,3,1,1,0.6,0.6212,0.49,0.0,22,185,207,207,2,Siang
3877,2011-06-15,0,6,10,0,3,1,1,0.64,0.6212,0.47,0.1642,27,108,135,135,2,Siang
3878,2011-06-15,0,6,11,0,3,1,1,0.68,0.6364,0.36,0.0,49,115,164,164,2,Siang
3879,2011-06-15,0,6,12,0,3,1,1,0.7,0.6364,0.34,0.2239,33,178,211,211,2,Siang
3880,2011-06-15,0,6,13,0,3,1,1,0.74,0.6515,0.28,0.2836,43,146,189,189,2,Sore
3881,2011-06-15,0,6,14,0,3,1,1,0.74,0.6515,0.28,0.0,50,128,178,178,2,Sore
3882,2011-06-15,0,6,15,0,3,1,1,0.76,0.6667,0.27,0.0,33,131,164,164,2,Sore
3883,2011-06-15,0,6,16,0,3,1,1,0.76,0.6667,0.27,0.1343,47,265,312,312,2,Sore
3884,2011-06-15,0,6,17,0,3,1,1,0.74,0.6515,0.28,0.1045,83,555,638,638,2,Sore
3885,2011-06-15,0,6,18,0,3,1,1,0.72,0.6515,0.32,0.1343,80,527,607,607,2,Sore
3886,2011-06-15,0,6,19,0,3,1,1,0.7,0.6364,0.37,0.2836,54,362,416,416,2,Malam
3887,2011-06-15,0,6,20,0,3,1,1,0.66,0.6212,0.44,0.1642,57,273,330,330,2,Malam
3888,2011-06-15,0,6,21,0,3,1,1,0.64,0.6212,0.47,0.2239,48,209,257,257,2,Malam
3889,2011-06-15,0,6,22,0,3,1,1,0.62,0.6212,0.5,0.1045,31,144,175,175,2,Malam
3890,2011-06-15,0,6,23,0,3,1,1,0.62,0.6212,0.53,0.0,17,90,107,107,2,Malam
3891,2011-06-16,0,6,0,0,4,1,1,0.6,0.6212,0.56,0.1045,9,38,47,47,2,
3892,2011-06-16,0,6,1,0,4,1,1,0.58,0.5455,0.6,0.0,4,13,17,17,2,Pagi
3893,2011-06-16,0,6,2,0,4,1,1,0.6,0.6212,0.56,0.0896,1,4,5,5,2,Pagi
3894,2011-06-16,0,6,3,0,4,1,2,0.56,0.5303,0.73,0.0896,0,4,4,4,2,Pagi
3895,2011-06-16,0,6,4,0,4,1,2,0.56,0.5303,0.68,0.1045,0,6,6,6,2,Pagi
3896,2011-06-16,0,6,5,0,4,1,1,0.6,0.6061,0.64,0.194,7,18,25,25,2,Pagi
3897,2011-06-16,0,6,6,0,4,1,3,0.58,0.5455,0.73,0.1642,8,104,112,112,2,Pagi
3898,2011-06-16,0,6,7,0,4,1,3,0.56,0.5303,0.78,0.1642,16,172,188,188,2,Siang
3899,2011-06-16,0,6,8,0,4,1,2,0.6,0.5909,0.69,0.1343,24,364,388,388,2,Siang
3900,2011-06-16,0,6,9,0,4,1,2,0.62,0.6061,0.65,0.194,29,232,261,261,2,Siang
3901,2011-06-16,0,6,10,0,4,1,2,0.66,0.6212,0.61,0.2537,18,103,121,121,2,Siang
3902,2011-06-16,0,6,11,0,4,1,2,0.68,0.6364,0.61,0.2985,33,117,150,150,2,Siang
3903,2011-06-16,0,6,12,0,4,1,1,0.72,0.6667,0.54,0.3881,41,165,206,206,2,Siang
3904,2011-06-16,0,6,13,0,4,1,2,0.72,0.6667,0.54,0.2537,37,114,151,151,2,Sore
3905,2011-06-16,0,6,14,0,4,1,2,0.72,0.6667,0.54,0.3284,39,114,153,153,2,Sore
3906,2011-06-16,0,6,15,0,4,1,2,0.7,0.6515,0.61,0.2985,32,127,159,159,2,Sore
3907,2011-06-16,0,6,16,0,4,1,3,0.66,0.6212,0.69,0.194,36,258,294,294,2,Sore
3908,2011-06-16,0,6,17,0,4,1,2,0.64,0.5909,0.78,0.1045,42,230,272,272,2,Sore
3909,2011-06-16,0,6,18,0,4,1,1,0.64,0.5758,0.83,0.2239,26,299,325,325,2,Sore
3910,2011-06-16,0,6,19,0,4,1,1,0.62,0.5758,0.83,0.2836,58,269,327,327,2,Malam
3911,2011-06-16,0,6,20,0,4,1,1,0.62,0.5758,0.83,0.3284,25,176,201,201,2,Malam
3912,2011-06-16,0,6,21,0,4,1,3,0.62,0.5758,0.83,0.2537,34,154,188,188,2,Malam
3913,2011-06-16,0,6,22,0,4,1,3,0.62,0.5758,0.83,0.2537,24,127,151,151,2,Malam
3914,2011-06-16,0,6,23,0,4,1,3,0.6,0.5606,0.83,0.2537,2,14,16,16,2,Malam
3915,2011-06-17,0,6,0,0,5,1,1,0.56,0.5303,0.88,0.0896,3,21,24,24,2,
3916,2011-06-17,0,6,1,0,5,1,1,0.56,0.5303,0.94,0.1343,4,19,23,23,2,Pagi
3917,2011-06-17,0,6,2,0,5,1,1,0.56,0.5303,0.94,0.1045,2,11,13,13,2,Pagi
3918,2011-06-17,0,6,3,0,5,1,1,0.56,0.5303,0.94,0.1045,1,5,6,6,2,Pagi
3919,2011-06-17,0,6,4,0,5,1,1,0.54,0.5152,0.94,0.1343,1,5,6,6,2,Pagi
3920,2011-06-17,0,6,5,0,5,1,1,0.54,0.5152,1.0,0.0,1,12,13,13,2,Pagi
3921,2011-06-17,0,6,6,0,5,1,1,0.56,0.5303,0.94,0.0,8,89,97,97,2,Pagi
3922,2011-06-17,0,6,7,0,5,1,1,0.6,0.5606,0.83,0.0,25,225,250,250,2,Siang
3923,2011-06-17,0,6,8,0,5,1,2,0.6,0.5606,0.83,0.0,28,426,454,454,2,Siang
3924,2011-06-17,0,6,9,0,5,1,1,0.7,0.6515,0.58,0.194,28,196,224,224,2,Siang
3925,2011-06-17,0,6,10,0,5,1,1,0.7,0.6515,0.58,0.194,44,126,170,170,2,Siang
3926,2011-06-17,0,6,11,0,5,1,1,0.68,0.6364,0.69,0.2537,43,138,181,181,2,Siang
3927,2011-06-17,0,6,12,0,5,1,1,0.7,0.6515,0.65,0.2537,49,194,243,243,2,Siang
3928,2011-06-17,0,6,13,0,5,1,1,0.74,0.6818,0.62,0.2836,48,156,204,204,2,Sore
3929,2011-06-17,0,6,14,0,5,1,1,0.76,0.697,0.52,0.194,73,142,215,215,2,Sore
3930,2011-06-17,0,6,15,0,5,1,1,0.78,0.697,0.43,0.2239,62,181,243,243,2,Sore
3931,2011-06-17,0,6,16,0,5,1,1,0.76,0.6818,0.45,0.1642,69,286,355,355,2,Sore
3932,2011-06-17,0,6,17,0,5,1,3,0.76,0.6818,0.4,0.194,85,467,552,552,2,Sore
3933,2011-06-17,0,6,18,0,5,1,3,0.76,0.6818,0.4,0.194,62,388,450,450,2,Sore
3934,2011-06-17,0,6,19,0,5,1,3,0.64,0.5758,0.83,0.2537,53,275,328,328,2,Malam
3935,2011-06-17,0,6,20,0,5,1,1,0.64,0.5909,0.78,0.1045,40,192,232,232,2,Malam
3936,2011-06-17,0,6,21,0,5,1,1,0.64,0.5909,0.78,0.0896,49,159,208,208,2,Malam
3937,2011-06-17,0,6,22,0,5,1,1,0.62,0.5606,0.88,0.1343,48,127,175,175,2,Malam
3938,2011-06-17,0,6,23,0,5,1,1,0.62,0.5758,0.83,0.1343,37,141,178,178,2,Malam
3939,2011-06-18,0,6,0,0,6,0,1,0.62,0.5606,0.88,0.1343,21,83,104,104,2,
3940,2011-06-18,0,6,1,0,6,0,1,0.62,0.5758,0.83,0.1045,15,80,95,95,2,Pagi
3941,2011-06-18,0,6,2,0,6,0,1,0.6,0.5455,0.88,0.0,16,37,53,53,2,Pagi
3942,2011-06-18,0,6,3,0,6,0,1,0.6,0.5455,0.88,0.0896,4,16,20,20,2,Pagi
3943,2011-06-18,0,6,4,0,6,0,1,0.6,0.5455,0.88,0.0896,1,4,5,5,2,Pagi
3944,2011-06-18,0,6,5,0,6,0,1,0.62,0.5758,0.83,0.0,1,6,7,7,2,Pagi
3945,2011-06-18,0,6,6,0,6,0,1,0.62,0.5758,0.83,0.1045,9,18,27,27,2,Pagi
3946,2011-06-18,0,6,7,0,6,0,1,0.64,0.5909,0.78,0.1343,12,45,57,57,2,Siang
3947,2011-06-18,0,6,8,0,6,0,1,0.66,0.6061,0.78,0.0896,28,103,131,131,2,Siang
3948,2011-06-18,0,6,9,0,6,0,1,0.7,0.6515,0.61,0.2239,62,156,218,218,2,Siang
3949,2011-06-18,0,6,10,0,6,0,1,0.72,0.6818,0.62,0.194,68,176,244,244,2,Siang
3950,2011-06-18,0,6,11,0,6,0,1,0.72,0.6818,0.62,0.1343,134,270,404,404,2,Siang
3951,2011-06-18,0,6,12,0,6,0,1,0.74,0.697,0.66,0.0896,162,258,420,420,2,Siang
3952,2011-06-18,0,6,13,0,6,0,1,0.76,0.697,0.55,0.0,135,192,327,327,2,Sore
3953,2011-06-18,0,6,14,0,6,0,2,0.8,0.7273,0.46,0.2836,138,196,334,334,2,Sore
3954,2011-06-18,0,6,15,0,6,0,2,0.82,0.7576,0.46,0.1343,153,214,367,367,2,Sore
3955,2011-06-18,0,6,16,0,6,0,2,0.76,0.697,0.52,0.2239,193,275,468,468,2,Sore
3956,2011-06-18,0,6,17,0,6,0,2,0.76,0.6818,0.48,0.1642,210,239,449,449,2,Sore
3957,2011-06-18,0,6,18,0,6,0,2,0.74,0.6818,0.55,0.194,118,263,381,381,2,Sore
3958,2011-06-18,0,6,19,0,6,0,2,0.74,0.6667,0.51,0.1045,99,227,326,326,2,Malam
3959,2011-06-18,0,6,20,0,6,0,2,0.72,0.6667,0.58,0.1343,61,127,188,188,2,Malam
3960,2011-06-18,0,6,21,0,6,0,2,0.72,0.6818,0.66,0.1045,58,125,183,183,2,Malam
3961,2011-06-18,0,6,22,0,6,0,2,0.72,0.6818,0.62,0.1343,56,105,161,161,2,Malam
3962,2011-06-18,0,6,23,0,6,0,2,0.72,0.6818,0.62,0.0,53,97,150,150,2,Malam
3963,2011-06-19,0,6,0,0,0,0,1,0.7,0.6515,0.65,0.0,18,71,89,89,2,
3964,2011-06-19,0,6,1,0,0,0,2,0.7,0.6515,0.65,0.0896,17,59,76,76,2,Pagi
3965,2011-06-19,0,6,2,0,0,0,1,0.68,0.6364,0.74,0.0896,13,59,72,72,2,Pagi
3966,2011-06-19,0,6,3,0,0,0,2,0.66,0.6061,0.78,0.1343,14,16,30,30,2,Pagi
3967,2011-06-19,0,6,4,0,0,0,2,0.66,0.6212,0.74,0.1343,7,10,17,17,2,Pagi
3968,2011-06-19,0,6,5,0,0,0,2,0.66,0.6061,0.78,0.0,7,12,19,19,2,Pagi
3969,2011-06-19,0,6,6,0,0,0,2,0.66,0.6061,0.78,0.1642,11,22,33,33,2,Pagi
3970,2011-06-19,0,6,7,0,0,0,2,0.66,0.6061,0.78,0.1642,35,36,71,71,2,Siang
3971,2011-06-19,0,6,8,0,0,0,3,0.68,0.6364,0.74,0.1045,25,59,84,84,2,Siang
3972,2011-06-19,0,6,9,0,0,0,2,0.68,0.6364,0.74,0.1045,58,111,169,169,2,Siang
3973,2011-06-19,0,6,10,0,0,0,2,0.7,0.6515,0.61,0.1045,86,158,244,244,2,Siang
3974,2011-06-19,0,6,11,0,0,0,2,0.72,0.6667,0.58,0.0896,141,236,377,377,2,Siang
3975,2011-06-19,0,6,12,0,0,0,2,0.74,0.6818,0.55,0.0896,141,255,396,396,2,Siang
3976,2011-06-19,0,6,13,0,0,0,2,0.74,0.6667,0.51,0.0,149,214,363,363,2,Sore
3977,2011-06-19,0,6,14,0,0,0,3,0.74,0.6818,0.58,0.1045,124,193,317,317,2,Sore
3978,2011-06-19,0,6,15,0,0,0,2,0.74,0.6818,0.55,0.1045,146,216,362,362,2,Sore
3979,2011-06-19,0,6,16,0,0,0,2,0.76,0.6818,0.48,0.0,121,257,378,378,2,Sore
3980,2011-06-19,0,6,17,0,0,0,1,0.74,0.6667,0.51,0.0,159,238,397,397,2,Sore
3981,2011-06-19,0,6,18,0,0,0,2,0.74,0.6818,0.58,0.0896,78,218,296,296,2,Sore
3982,2011-06-19,0,6,19,0,0,0,1,0.72,0.6818,0.62,0.1343,94,217,311,311,2,Malam
3983,2011-06-19,0,6,20,0,0,0,1,0.7,0.6515,0.7,0.194,86,146,232,232,2,Malam
3984,2011-06-19,0,6,21,0,0,0,1,0.68,0.6364,0.79,0.1343,57,110,167,167,2,Malam
3985,2011-06-19,0,6,22,0,0,0,1,0.66,0.6061,0.78,0.2239,38,114,152,152,2,Malam
3986,2011-06-19,0,6,23,0,0,0,1,0.66,0.6061,0.78,0.194,14,78,92,92,2,Malam
3987,2011-06-20,0,6,0,0,1,1,1,0.66,0.6061,0.83,0.1642,7,19,26,26,2,
3988,2011-06-20,0,6,1,0,1,1,1,0.64,0.5758,0.89,0.0896,9,3,12,12,2,Pagi
3989,2011-06-20,0,6,2,0,1,1,1,0.64,0.5758,0.89,0.0896,2,0,2,2,2,Pagi
3990,2011-06-20,0,6,3,0,1,1,3,0.64,0.5758,0.89,0.0,1,0,1,1,2,Pagi
3991,2011-06-20,0,6,4,0,1,1,3,0.62,0.5606,0.88,0.1642,1,2,3,3,2,Pagi
3992,2011-06-20,0,6,5,0,1,1,3,0.62,0.5758,0.83,0.1343,0,3,3,3,2,Pagi
3993,2011-06-20,0,6,6,0,1,1,3,0.6,0.5758,0.78,0.1343,1,25,26,26,2,Pagi
3994,2011-06-20,0,6,7,0,1,1,3,0.56,0.5303,0.88,0.194,0,46,46,46,2,Siang
3995,2011-06-20,0,6,8,0,1,1,3,0.56,0.5303,0.83,0.194,12,209,221,221,2,Siang
3996,2011-06-20,0,6,9,0,1,1,2,0.6,0.5758,0.78,0.2537,19,200,219,219,2,Siang
3997,2011-06-20,0,6,10,0,1,1,2,0.6,0.5758,0.78,0.2537,33,58,91,91,2,Siang
3998,2011-06-20,0,6,11,0,1,1,2,0.6,0.5758,0.78,0.1045,27,67,94,94,2,Siang
3999,2011-06-20,0,6,12,0,1,1,2,0.62,0.6061,0.69,0.1045,33,129,162,162,2,Siang
4000,2011-06-20,0,6,13,0,1,1,1,0.64,0.6061,0.65,0.1045,50,129,179,179,2,Sore
4001,2011-06-20,0,6,14,0,1,1,1,0.66,0.6212,0.61,0.1045,45,130,175,175,2,Sore
4002,2011-06-20,0,6,15,0,1,1,1,0.66,0.6212,0.61,0.1343,66,139,205,205,2,Sore
4003,2011-06-20,0,6,16,0,1,1,1,0.7,0.6515,0.58,0.1642,61,238,299,299,2,Sore
4004,2011-06-20,0,6,17,0,1,1,1,0.7,0.6515,0.54,0.0,81,484,565,565,2,Sore
4005,2011-06-20,0,6,18,0,1,1,1,0.7,0.6515,0.61,0.2537,64,474,538,538,2,Sore
4006,2011-06-20,0,6,19,0,1,1,1,0.66,0.6212,0.65,0.2239,62,369,431,431,2,Malam
4007,2011-06-20,0,6,20,0,1,1,1,0.66,0.6212,0.69,0.2239,52,264,316,316,2,Malam
4008,2011-06-20,0,6,21,0,1,1,1,0.64,0.6061,0.73,0.1642,39,167,206,206,2,Malam
4009,2011-06-20,0,6,22,0,1,1,2,0.64,0.6061,0.73,0.2239,24,106,130,130,2,Malam
4010,2011-06-20,0,6,23,0,1,1,1,0.62,0.5909,0.78,0.2537,10,50,60,60,2,Malam
4011,2011-06-21,0,6,0,0,2,1,1,0.62,0.5909,0.78,0.1642,10,23,33,33,3,
4012,2011-06-21,0,6,1,0,2,1,3,0.62,0.5909,0.78,0.1642,2,12,14,14,3,Pagi
4013,2011-06-21,0,6,2,0,2,1,3,0.62,0.5758,0.83,0.1642,1,5,6,6,3,Pagi
4014,2011-06-21,0,6,3,0,2,1,3,0.62,0.5758,0.83,0.1642,0,2,2,2,3,Pagi
4015,2011-06-21,0,6,4,0,2,1,2,0.6,0.5455,0.88,0.1045,2,7,9,9,3,Pagi
4016,2011-06-21,0,6,5,0,2,1,2,0.6,0.5455,0.88,0.1343,3,22,25,25,3,Pagi
4017,2011-06-21,0,6,6,0,2,1,2,0.6,0.5455,0.88,0.1343,8,107,115,115,3,Pagi
4018,2011-06-21,0,6,7,0,2,1,2,0.6,0.5152,0.94,0.0,21,288,309,309,3,Siang
4019,2011-06-21,0,6,8,0,2,1,2,0.62,0.5606,0.88,0.1045,33,368,401,401,3,Siang
4020,2011-06-21,0,6,9,0,2,1,2,0.62,0.5606,0.88,0.2537,32,243,275,275,3,Siang
4021,2011-06-21,0,6,10,0,2,1,2,0.64,0.5758,0.83,0.194,41,120,161,161,3,Siang
4022,2011-06-21,0,6,11,0,2,1,1,0.66,0.6061,0.83,0.1642,52,119,171,171,3,Siang
4023,2011-06-21,0,6,12,0,2,1,1,0.7,0.6667,0.74,0.1642,40,149,189,189,3,Siang
4024,2011-06-21,0,6,13,0,2,1,1,0.74,0.697,0.66,0.1642,49,158,207,207,3,Sore
4025,2011-06-21,0,6,14,0,2,1,1,0.76,0.7121,0.62,0.2239,44,108,152,152,3,Sore
4026,2011-06-21,0,6,15,0,2,1,1,0.78,0.7424,0.59,0.2537,42,128,170,170,3,Sore
4027,2011-06-21,0,6,16,0,2,1,1,0.8,0.7727,0.59,0.2239,62,273,335,335,3,Sore
4028,2011-06-21,0,6,17,0,2,1,1,0.78,0.7576,0.66,0.2239,65,507,572,572,3,Sore
4029,2011-06-21,0,6,18,0,2,1,2,0.76,0.7273,0.7,0.2537,67,469,536,536,3,Sore
4030,2011-06-21,0,6,19,0,2,1,2,0.74,0.7121,0.74,0.2239,67,358,425,425,3,Malam
4031,2011-06-21,0,6,20,0,2,1,3,0.74,0.697,0.7,0.2239,72,254,326,326,3,Malam
4032,2011-06-21,0,6,21,0,2,1,1,0.72,0.697,0.74,0.194,38,191,229,229,3,Malam
4033,2011-06-21,0,6,22,0,2,1,1,0.7,0.6667,0.79,0.1045,12,97,109,109,3,Malam
4034,2011-06-21,0,6,23,0,2,1,1,0.7,0.6667,0.74,0.1045,11,53,64,64,3,Malam
4035,2011-06-22,0,6,0,0,3,1,1,0.66,0.6061,0.78,0.194,15,18,33,33,3,
4036,2011-06-22,0,6,1,0,3,1,1,0.66,0.6061,0.78,0.1343,2,19,21,21,3,Pagi
4037,2011-06-22,0,6,2,0,3,1,1,0.66,0.6061,0.78,0.0,2,5,7,7,3,Pagi
4038,2011-06-22,0,6,3,0,3,1,1,0.66,0.6061,0.78,0.1343,0,7,7,7,3,Pagi
4039,2011-06-22,0,6,4,0,3,1,1,0.64,0.5758,0.83,0.0,3,8,11,11,3,Pagi
4040,2011-06-22,0,6,5,0,3,1,1,0.64,0.5758,0.89,0.0,2,21,23,23,3,Pagi
4041,2011-06-22,0,6,6,0,3,1,1,0.66,0.6061,0.83,0.0,12,110,122,122,3,Pagi
4042,2011-06-22,0,6,7,0,3,1,1,0.7,0.6667,0.79,0.0,23,288,311,311,3,Siang
4043,2011-06-22,0,6,8,0,3,1,1,0.72,0.697,0.74,0.1045,27,396,423,423,3,Siang
4044,2011-06-22,0,6,9,0,3,1,1,0.72,0.697,0.79,0.1642,14,205,219,219,3,Siang
4045,2011-06-22,0,6,10,0,3,1,1,0.74,0.697,0.7,0.2537,31,104,135,135,3,Siang
4046,2011-06-22,0,6,11,0,3,1,1,0.74,0.697,0.7,0.1642,37,108,145,145,3,Siang
4047,2011-06-22,0,6,12,0,3,1,2,0.8,0.7727,0.59,0.2239,44,144,188,188,3,Siang
4048,2011-06-22,0,6,13,0,3,1,2,0.82,0.7879,0.56,0.2537,34,113,147,147,3,Sore
4049,2011-06-22,0,6,14,0,3,1,2,0.82,0.7727,0.52,0.2836,32,113,145,145,3,Sore
4050,2011-06-22,0,6,15,0,3,1,2,0.82,0.7879,0.56,0.2836,32,114,146,146,3,Sore
4051,2011-06-22,0,6,16,0,3,1,2,0.82,0.803,0.59,0.3284,34,224,258,258,3,Sore
4052,2011-06-22,0,6,17,0,3,1,2,0.8,0.7576,0.55,0.3881,67,462,529,529,3,Sore
4053,2011-06-22,0,6,18,0,3,1,2,0.8,0.7727,0.59,0.2537,66,447,513,513,3,Sore
4054,2011-06-22,0,6,19,0,3,1,2,0.8,0.7424,0.52,0.2537,62,280,342,342,3,Malam
4055,2011-06-22,0,6,20,0,3,1,1,0.74,0.7121,0.74,0.1343,52,230,282,282,3,Malam
4056,2011-06-22,0,6,21,0,3,1,1,0.74,0.7121,0.79,0.1642,31,216,247,247,3,Malam
4057,2011-06-22,0,6,22,0,3,1,2,0.72,0.697,0.79,0.194,25,123,148,148,3,Malam
4058,2011-06-22,0,6,23,0,3,1,2,0.72,0.697,0.79,0.2239,14,91,105,105,3,Malam
4059,2011-06-23,0,6,0,0,4,1,1,0.72,0.697,0.79,0.2239,5,44,49,49,3,
4060,2011-06-23,0,6,1,0,4,1,1,0.72,0.697,0.74,0.2239,5,26,31,31,3,Pagi
4061,2011-06-23,0,6,2,0,4,1,1,0.72,0.697,0.74,0.2239,0,4,4,4,3,Pagi
4062,2011-06-23,0,6,3,0,4,1,2,0.72,0.697,0.74,0.1642,1,4,5,5,3,Pagi
4063,2011-06-23,0,6,4,0,4,1,2,0.7,0.6667,0.79,0.1343,0,7,7,7,3,Pagi
4064,2011-06-23,0,6,5,0,4,1,1,0.72,0.697,0.74,0.1642,2,22,24,24,3,Pagi
4065,2011-06-23,0,6,6,0,4,1,1,0.72,0.697,0.74,0.1642,8,92,100,100,3,Pagi
4066,2011-06-23,0,6,7,0,4,1,2,0.72,0.697,0.74,0.1343,26,301,327,327,3,Siang
4067,2011-06-23,0,6,8,0,4,1,2,0.74,0.697,0.7,0.194,20,412,432,432,3,Siang
4068,2011-06-23,0,6,9,0,4,1,2,0.74,0.697,0.7,0.1343,33,194,227,227,3,Siang
4069,2011-06-23,0,6,10,0,4,1,2,0.76,0.7273,0.66,0.1343,39,88,127,127,3,Siang
4070,2011-06-23,0,6,11,0,4,1,3,0.76,0.7273,0.66,0.2537,28,108,136,136,3,Siang
4071,2011-06-23,0,6,12,0,4,1,2,0.76,0.7273,0.66,0.2836,30,130,160,160,3,Siang
4072,2011-06-23,0,6,13,0,4,1,2,0.76,0.7121,0.62,0.2836,37,149,186,186,3,Sore
4073,2011-06-23,0,6,14,0,4,1,2,0.76,0.7273,0.66,0.2985,46,103,149,149,3,Sore
4074,2011-06-23,0,6,15,0,4,1,2,0.76,0.697,0.52,0.3582,62,127,189,189,3,Sore
4075,2011-06-23,0,6,16,0,4,1,2,0.74,0.6818,0.62,0.2985,58,217,275,275,3,Sore
4076,2011-06-23,0,6,17,0,4,1,2,0.72,0.6818,0.7,0.3582,74,495,569,569,3,Sore
4077,2011-06-23,0,6,18,0,4,1,1,0.72,0.6818,0.7,0.4179,57,483,540,540,3,Sore
4078,2011-06-23,0,6,19,0,4,1,1,0.72,0.6818,0.7,0.3582,56,344,400,400,3,Malam
4079,2011-06-23,0,6,20,0,4,1,1,0.7,0.6667,0.74,0.2239,75,277,352,352,3,Malam
4080,2011-06-23,0,6,21,0,4,1,1,0.7,0.6667,0.74,0.194,46,188,234,234,3,Malam
4081,2011-06-23,0,6,22,0,4,1,2,0.7,0.6667,0.74,0.2239,23,139,162,162,3,Malam
4082,2011-06-23,0,6,23,0,4,1,1,0.7,0.6667,0.74,0.2836,15,90,105,105,3,Malam
4083,2011-06-24,0,6,0,0,5,1,1,0.68,0.6364,0.79,0.194,10,53,63,63,3,
4084,2011-06-24,0,6,1,0,5,1,1,0.66,0.6061,0.83,0.3284,8,20,28,28,3,Pagi
4085,2011-06-24,0,6,2,0,5,1,1,0.66,0.6061,0.83,0.3284,4,10,14,14,3,Pagi
4086,2011-06-24,0,6,3,0,5,1,1,0.66,0.6061,0.83,0.1642,1,4,5,5,3,Pagi
4087,2011-06-24,0,6,4,0,5,1,1,0.66,0.6061,0.83,0.0896,1,8,9,9,3,Pagi
4088,2011-06-24,0,6,5,0,5,1,1,0.64,0.5758,0.89,0.0896,2,18,20,20,3,Pagi
4089,2011-06-24,0,6,6,0,5,1,1,0.66,0.6061,0.83,0.1343,4,87,91,91,3,Pagi
4090,2011-06-24,0,6,7,0,5,1,2,0.66,0.6061,0.83,0.2239,21,247,268,268,3,Siang
4091,2011-06-24,0,6,8,0,5,1,1,0.7,0.6667,0.74,0.2239,27,439,466,466,3,Siang
4092,2011-06-24,0,6,9,0,5,1,1,0.74,0.6818,0.62,0.1343,28,203,231,231,3,Siang
4093,2011-06-24,0,6,10,0,5,1,1,0.8,0.7273,0.43,0.2836,43,102,145,145,3,Siang
4094,2011-06-24,0,6,11,0,5,1,1,0.8,0.7121,0.38,0.3284,56,147,203,203,3,Siang
4095,2011-06-24,0,6,12,0,5,1,1,0.8,0.7121,0.41,0.2836,51,150,201,201,3,Siang
4096,2011-06-24,0,6,13,0,5,1,1,0.8,0.7121,0.36,0.2239,43,178,221,221,3,Sore
4097,2011-06-24,0,6,14,0,5,1,1,0.78,0.697,0.43,0.2836,67,162,229,229,3,Sore
4098,2011-06-24,0,6,15,0,5,1,1,0.82,0.7273,0.34,0.3881,69,147,216,216,3,Sore
4099,2011-06-24,0,6,16,0,5,1,1,0.8,0.697,0.33,0.4179,80,247,327,327,3,Sore
4100,2011-06-24,0,6,17,0,5,1,1,0.76,0.6667,0.37,0.2537,85,472,557,557,3,Sore
4101,2011-06-24,0,6,18,0,5,1,1,0.76,0.6667,0.37,0.2985,87,365,452,452,3,Sore
4102,2011-06-24,0,6,19,0,5,1,1,0.74,0.6515,0.4,0.2239,92,293,385,385,3,Malam
4103,2011-06-24,0,6,20,0,5,1,1,0.72,0.6515,0.45,0.1642,66,222,288,288,3,Malam
4104,2011-06-24,0,6,21,0,5,1,1,0.7,0.6515,0.48,0.1343,50,183,233,233,3,Malam
4105,2011-06-24,0,6,22,0,5,1,1,0.7,0.6515,0.48,0.0,41,126,167,167,3,Malam
4106,2011-06-24,0,6,23,0,5,1,1,0.68,0.6364,0.51,0.1343,33,139,172,172,3,Malam
4107,2011-06-25,0,6,0,0,6,0,1,0.68,0.6364,0.47,0.1642,19,97,116,116,3,
4108,2011-06-25,0,6,1,0,6,0,1,0.66,0.6212,0.5,0.1642,20,75,95,95,3,Pagi
4109,2011-06-25,0,6,2,0,6,0,2,0.66,0.6212,0.5,0.194,8,51,59,59,3,Pagi
4110,2011-06-25,0,6,3,0,6,0,1,0.64,0.6212,0.57,0.194,18,21,39,39,3,Pagi
4111,2011-06-25,0,6,4,0,6,0,1,0.64,0.6212,0.57,0.194,7,4,11,11,3,Pagi
4112,2011-06-25,0,6,5,0,6,0,1,0.62,0.6061,0.61,0.1343,6,8,14,14,3,Pagi
4113,2011-06-25,0,6,6,0,6,0,1,0.64,0.6212,0.57,0.2239,12,17,29,29,3,Pagi
4114,2011-06-25,0,6,7,0,6,0,1,0.64,0.6212,0.57,0.2836,7,35,42,42,3,Siang
4115,2011-06-25,0,6,8,0,6,0,1,0.7,0.6515,0.48,0.2537,27,85,112,112,3,Siang
4116,2011-06-25,0,6,9,0,6,0,1,0.72,0.6515,0.45,0.2537,47,139,186,186,3,Siang
4117,2011-06-25,0,6,10,0,6,0,1,0.72,0.6515,0.45,0.194,99,203,302,302,3,Siang
4118,2011-06-25,0,6,11,0,6,0,1,0.74,0.6667,0.42,0.0,122,209,331,331,3,Siang
4119,2011-06-25,0,6,12,0,6,0,1,0.74,0.6515,0.4,0.2836,140,252,392,392,3,Siang
4120,2011-06-25,0,6,13,0,6,0,1,0.74,0.6515,0.4,0.2836,140,231,371,371,3,Sore
4121,2011-06-25,0,6,14,0,6,0,1,0.74,0.6667,0.45,0.2985,151,232,383,383,3,Sore
4122,2011-06-25,0,6,15,0,6,0,1,0.74,0.6667,0.45,0.0,157,235,392,392,3,Sore
4123,2011-06-25,0,6,16,0,6,0,1,0.76,0.6818,0.43,0.2985,175,235,410,410,3,Sore
4124,2011-06-25,0,6,17,0,6,0,1,0.74,0.6667,0.42,0.2239,152,247,399,399,3,Sore
4125,2011-06-25,0,6,18,0,6,0,1,0.72,0.6515,0.45,0.2537,108,199,307,307,3,Sore
4126,2011-06-25,0,6,19,0,6,0,1,0.72,0.6667,0.48,0.2836,121,254,375,375,3,Malam
4127,2011-06-25,0,6,20,0,6,0,1,0.7,0.6515,0.48,0.194,74,195,269,269,3,Malam
4128,2011-06-25,0,6,21,0,6,0,1,0.68,0.6364,0.51,0.1642,62,140,202,202,3,Malam
4129,2011-06-25,0,6,22,0,6,0,1,0.68,0.6364,0.47,0.194,61,126,187,187,3,Malam
4130,2011-06-25,0,6,23,0,6,0,2,0.66,0.6212,0.5,0.2985,49,130,179,179,3,Malam
4131,2011-06-26,0,6,0,0,0,0,1,0.64,0.6212,0.53,0.0,30,85,115,115,3,
4132,2011-06-26,0,6,1,0,0,0,1,0.64,0.6212,0.53,0.1045,17,73,90,90,3,Pagi
4133,2011-06-26,0,6,2,0,0,0,1,0.62,0.6212,0.57,0.1045,17,70,87,87,3,Pagi
4134,2011-06-26,0,6,3,0,0,0,1,0.6,0.6061,0.64,0.1045,12,22,34,34,3,Pagi
4135,2011-06-26,0,6,4,0,0,0,1,0.6,0.6061,0.64,0.0896,3,8,11,11,3,Pagi
4136,2011-06-26,0,6,5,0,0,0,1,0.6,0.6061,0.64,0.0,3,9,12,12,3,Pagi
4137,2011-06-26,0,6,6,0,0,0,1,0.6,0.6061,0.64,0.0,7,13,20,20,3,Pagi
4138,2011-06-26,0,6,7,0,0,0,1,0.62,0.6061,0.61,0.0,24,27,51,51,3,Siang
4139,2011-06-26,0,6,8,0,0,0,1,0.64,0.6212,0.61,0.194,29,78,107,107,3,Siang
4140,2011-06-26,0,6,9,0,0,0,1,0.66,0.6212,0.54,0.0896,75,131,206,206,3,Siang
4141,2011-06-26,0,6,10,0,0,0,1,0.72,0.6667,0.48,0.1045,136,196,332,332,3,Siang
4142,2011-06-26,0,6,11,0,0,0,1,0.72,0.6515,0.45,0.1343,127,219,346,346,3,Siang
4143,2011-06-26,0,6,12,0,0,0,1,0.74,0.6515,0.4,0.1642,175,268,443,443,3,Siang
4144,2011-06-26,0,6,13,0,0,0,1,0.74,0.6515,0.4,0.0,197,245,442,442,3,Sore
4145,2011-06-26,0,6,14,0,0,0,1,0.74,0.6515,0.4,0.1343,197,246,443,443,3,Sore
4146,2011-06-26,0,6,15,0,0,0,1,0.74,0.6515,0.4,0.0,174,229,403,403,3,Sore
4147,2011-06-26,0,6,16,0,0,0,1,0.74,0.6667,0.42,0.194,177,278,455,455,3,Sore
4148,2011-06-26,0,6,17,0,0,0,2,0.72,0.6515,0.42,0.1642,178,243,421,421,3,Sore
4149,2011-06-26,0,6,18,0,0,0,2,0.72,0.6515,0.45,0.2537,117,265,382,382,3,Sore
4150,2011-06-26,0,6,19,0,0,0,2,0.72,0.6667,0.48,0.1343,89,228,317,317,3,Malam
4151,2011-06-26,0,6,20,0,0,0,2,0.7,0.6515,0.48,0.1045,55,158,213,213,3,Malam
4152,2011-06-26,0,6,21,0,0,0,2,0.7,0.6515,0.54,0.1045,48,135,183,183,3,Malam
4153,2011-06-26,0,6,22,0,0,0,1,0.7,0.6515,0.51,0.0,19,95,114,114,3,Malam
4154,2011-06-26,0,6,23,0,0,0,1,0.7,0.6515,0.54,0.0896,14,64,78,78,3,Malam
4155,2011-06-27,0,6,0,0,1,1,3,0.64,0.6061,0.73,0.2836,7,25,32,32,3,
4156,2011-06-27,0,6,1,0,1,1,2,0.62,0.5909,0.78,0.1343,4,11,15,15,3,Pagi
4157,2011-06-27,0,6,2,0,1,1,3,0.62,0.5909,0.78,0.1343,3,3,6,6,3,Pagi
4158,2011-06-27,0,6,3,0,1,1,3,0.62,0.5909,0.78,0.1343,0,2,2,2,3,Pagi
4159,2011-06-27,0,6,4,0,1,1,2,0.6,0.5606,0.83,0.1642,1,8,9,9,3,Pagi
4160,2011-06-27,0,6,5,0,1,1,2,0.62,0.5758,0.83,0.1642,1,21,22,22,3,Pagi
4161,2011-06-27,0,6,6,0,1,1,2,0.62,0.5909,0.78,0.1642,4,90,94,94,3,Pagi
4162,2011-06-27,0,6,7,0,1,1,2,0.64,0.6061,0.73,0.2239,14,247,261,261,3,Siang
4163,2011-06-27,0,6,8,0,1,1,1,0.66,0.6212,0.74,0.194,29,418,447,447,3,Siang
4164,2011-06-27,0,6,9,0,1,1,2,0.72,0.6667,0.54,0.0,37,150,187,187,3,Siang
4165,2011-06-27,0,6,10,0,1,1,2,0.72,0.6667,0.54,0.1343,55,95,150,150,3,Siang
4166,2011-06-27,0,6,11,0,1,1,2,0.7,0.6515,0.58,0.0,55,95,150,150,3,Siang
4167,2011-06-27,0,6,12,0,1,1,2,0.72,0.6667,0.54,0.0,40,130,170,170,3,Siang
4168,2011-06-27,0,6,13,0,1,1,2,0.72,0.6667,0.58,0.2239,37,127,164,164,3,Sore
4169,2011-06-27,0,6,14,0,1,1,2,0.72,0.6667,0.58,0.0896,58,100,158,158,3,Sore
4170,2011-06-27,0,6,15,0,1,1,2,0.74,0.6818,0.55,0.0,76,126,202,202,3,Sore
4171,2011-06-27,0,6,16,0,1,1,1,0.74,0.6818,0.55,0.1045,53,222,275,275,3,Sore
4172,2011-06-27,0,6,17,0,1,1,1,0.74,0.6818,0.55,0.1343,90,514,604,604,3,Sore
4173,2011-06-27,0,6,18,0,1,1,1,0.74,0.6667,0.51,0.0,79,512,591,591,3,Sore
4174,2011-06-27,0,6,19,0,1,1,1,0.72,0.6818,0.62,0.194,56,340,396,396,3,Malam
4175,2011-06-27,0,6,20,0,1,1,1,0.7,0.6515,0.65,0.1045,54,251,305,305,3,Malam
4176,2011-06-27,0,6,21,0,1,1,1,0.7,0.6515,0.65,0.0,52,190,242,242,3,Malam
4177,2011-06-27,0,6,22,0,1,1,1,0.68,0.6364,0.69,0.0,33,112,145,145,3,Malam
4178,2011-06-27,0,6,23,0,1,1,1,0.68,0.6364,0.69,0.0,16,65,81,81,3,Malam
4179,2011-06-28,0,6,0,0,2,1,2,0.66,0.6061,0.78,0.1343,5,25,30,30,3,
4180,2011-06-28,0,6,1,0,2,1,1,0.66,0.6212,0.74,0.0,5,8,13,13,3,Pagi
4181,2011-06-28,0,6,2,0,2,1,2,0.66,0.6212,0.74,0.0,2,9,11,11,3,Pagi
4182,2011-06-28,0,6,3,0,2,1,2,0.66,0.6212,0.74,0.0,0,2,2,2,3,Pagi
4183,2011-06-28,0,6,4,0,2,1,1,0.66,0.6212,0.74,0.0,1,7,8,8,3,Pagi
4184,2011-06-28,0,6,5,0,2,1,1,0.66,0.6061,0.78,0.0,1,20,21,21,3,Pagi
4185,2011-06-28,0,6,6,0,2,1,1,0.66,0.6061,0.83,0.1642,7,117,124,124,3,Pagi
4186,2011-06-28,0,6,7,0,2,1,1,0.68,0.6364,0.83,0.194,27,320,347,347,3,Siang
4187,2011-06-28,0,6,8,0,2,1,1,0.7,0.6667,0.79,0.1642,39,417,456,456,3,Siang
4188,2011-06-28,0,6,9,0,2,1,1,0.74,0.697,0.7,0.0,38,208,246,246,3,Siang
4189,2011-06-28,0,6,10,0,2,1,1,0.8,0.7424,0.49,0.1642,45,112,157,157,3,Siang
4190,2011-06-28,0,6,11,0,2,1,1,0.82,0.7576,0.46,0.0,49,118,167,167,3,Siang
4191,2011-06-28,0,6,12,0,2,1,1,0.84,0.7727,0.47,0.2239,41,161,202,202,3,Siang
4192,2011-06-28,0,6,13,0,2,1,1,0.84,0.7576,0.44,0.0,33,156,189,189,3,Sore
4193,2011-06-28,0,6,14,0,2,1,1,0.86,0.7879,0.44,0.2239,43,117,160,160,3,Sore
4194,2011-06-28,0,6,15,0,2,1,1,0.86,0.7879,0.41,0.0,39,127,166,166,3,Sore
4195,2011-06-28,0,6,16,0,2,1,1,0.86,0.803,0.47,0.2836,41,220,261,261,3,Sore
4196,2011-06-28,0,6,17,0,2,1,3,0.82,0.7879,0.56,0.2836,70,509,579,579,3,Sore
4197,2011-06-28,0,6,18,0,2,1,3,0.8,0.7576,0.55,0.2985,68,436,504,504,3,Sore
4198,2011-06-28,0,6,19,0,2,1,2,0.74,0.6818,0.58,0.4627,44,255,299,299,3,Malam
4199,2011-06-28,0,6,20,0,2,1,1,0.74,0.6818,0.62,0.0,50,246,296,296,3,Malam
4200,2011-06-28,0,6,21,0,2,1,1,0.74,0.697,0.66,0.2836,31,164,195,195,3,Malam
4201,2011-06-28,0,6,22,0,2,1,1,0.7,0.6515,0.7,0.2985,30,104,134,134,3,Malam
4202,2011-06-28,0,6,23,0,2,1,1,0.7,0.6515,0.7,0.2836,23,58,81,81,3,Malam
4203,2011-06-29,0,6,0,0,3,1,2,0.68,0.6364,0.79,0.2836,11,25,36,36,3,
4204,2011-06-29,0,6,1,0,3,1,1,0.68,0.6364,0.79,0.2985,10,18,28,28,3,Pagi
4205,2011-06-29,0,6,2,0,3,1,1,0.66,0.6061,0.83,0.2239,7,9,16,16,3,Pagi
4206,2011-06-29,0,6,3,0,3,1,2,0.66,0.6061,0.83,0.1045,2,3,5,5,3,Pagi
4207,2011-06-29,0,6,4,0,3,1,1,0.66,0.6061,0.83,0.1045,0,5,5,5,3,Pagi
4208,2011-06-29,0,6,5,0,3,1,1,0.64,0.5758,0.83,0.194,3,19,22,22,3,Pagi
4209,2011-06-29,0,6,6,0,3,1,1,0.66,0.6212,0.69,0.2985,12,104,116,116,3,Pagi
4210,2011-06-29,0,6,7,0,3,1,1,0.7,0.6515,0.54,0.2239,18,318,336,336,3,Siang
4211,2011-06-29,0,6,8,0,3,1,1,0.7,0.6515,0.48,0.2836,41,499,540,540,3,Siang
4212,2011-06-29,0,6,9,0,3,1,1,0.72,0.6515,0.45,0.3881,32,189,221,221,3,Siang
4213,2011-06-29,0,6,10,0,3,1,1,0.74,0.6667,0.42,0.2836,31,95,126,126,3,Siang
4214,2011-06-29,0,6,11,0,3,1,1,0.76,0.6667,0.35,0.2239,53,117,170,170,3,Siang
4215,2011-06-29,0,6,12,0,3,1,1,0.76,0.6667,0.35,0.2537,55,188,243,243,3,Siang
4216,2011-06-29,0,6,13,0,3,1,1,0.8,0.697,0.31,0.3284,45,186,231,231,3,Sore
4217,2011-06-29,0,6,14,0,3,1,1,0.8,0.697,0.31,0.194,50,138,188,188,3,Sore
4218,2011-06-29,0,6,15,0,3,1,1,0.82,0.7121,0.3,0.1642,43,146,189,189,3,Sore
4219,2011-06-29,0,6,16,0,3,1,1,0.82,0.7121,0.3,0.4179,60,268,328,328,3,Sore
4220,2011-06-29,0,6,17,0,3,1,1,0.82,0.7121,0.26,0.4179,78,492,570,570,3,Sore
4221,2011-06-29,0,6,18,0,3,1,1,0.8,0.697,0.29,0.2985,78,510,588,588,3,Sore
4222,2011-06-29,0,6,19,0,3,1,1,0.76,0.6667,0.35,0.3881,60,341,401,401,3,Malam
4223,2011-06-29,0,6,20,0,3,1,1,0.74,0.6515,0.37,0.2985,69,264,333,333,3,Malam
4224,2011-06-29,0,6,21,0,3,1,1,0.72,0.6515,0.39,0.2239,26,195,221,221,3,Malam
4225,2011-06-29,0,6,22,0,3,1,1,0.7,0.6364,0.42,0.194,32,151,183,183,3,Malam
4226,2011-06-29,0,6,23,0,3,1,1,0.68,0.6364,0.47,0.194,32,97,129,129,3,Malam
4227,2011-06-30,0,6,0,0,4,1,1,0.66,0.6212,0.5,0.1642,15,39,54,54,3,
4228,2011-06-30,0,6,1,0,4,1,1,0.64,0.6212,0.53,0.1343,13,19,32,32,3,Pagi
4229,2011-06-30,0,6,2,0,4,1,1,0.62,0.6212,0.57,0.1343,2,6,8,8,3,Pagi
4230,2011-06-30,0,6,3,0,4,1,1,0.6,0.6061,0.6,0.1642,2,7,9,9,3,Pagi
4231,2011-06-30,0,6,4,0,4,1,1,0.58,0.5455,0.64,0.1343,2,4,6,6,3,Pagi
4232,2011-06-30,0,6,5,0,4,1,1,0.58,0.5455,0.64,0.2537,1,24,25,25,3,Pagi
4233,2011-06-30,0,6,6,0,4,1,1,0.6,0.6061,0.64,0.2537,4,119,123,123,3,Pagi
4234,2011-06-30,0,6,7,0,4,1,1,0.62,0.6061,0.61,0.2239,29,291,320,320,3,Siang
4235,2011-06-30,0,6,8,0,4,1,1,0.68,0.6364,0.47,0.2239,44,511,555,555,3,Siang
4236,2011-06-30,0,6,9,0,4,1,1,0.7,0.6364,0.42,0.2239,33,227,260,260,3,Siang
4237,2011-06-30,0,6,10,0,4,1,1,0.72,0.6515,0.42,0.194,35,97,132,132,3,Siang
4238,2011-06-30,0,6,11,0,4,1,1,0.74,0.6515,0.37,0.1343,47,122,169,169,3,Siang
4239,2011-06-30,0,6,12,0,4,1,1,0.76,0.6667,0.35,0.1642,50,183,233,233,3,Siang
4240,2011-06-30,0,6,13,0,4,1,1,0.76,0.6667,0.33,0.194,70,162,232,232,3,Sore
4241,2011-06-30,0,6,14,0,4,1,1,0.78,0.6818,0.31,0.194,46,117,163,163,3,Sore
4242,2011-06-30,0,6,15,0,4,1,1,0.78,0.6667,0.25,0.2537,64,176,240,240,3,Sore
4243,2011-06-30,0,6,16,0,4,1,1,0.8,0.697,0.26,0.1343,63,260,323,323,3,Sore
4244,2011-06-30,0,6,17,0,4,1,1,0.78,0.6818,0.27,0.3582,98,496,594,594,3,Sore
4245,2011-06-30,0,6,18,0,4,1,1,0.76,0.6667,0.29,0.2537,114,472,586,586,3,Sore
4246,2011-06-30,0,6,19,0,4,1,1,0.74,0.6515,0.33,0.194,89,366,455,455,3,Malam
4247,2011-06-30,0,6,20,0,4,1,1,0.74,0.6515,0.33,0.194,55,285,340,340,3,Malam
4248,2011-06-30,0,6,21,0,4,1,1,0.72,0.6515,0.37,0.1045,81,242,323,323,3,Malam
4249,2011-06-30,0,6,22,0,4,1,1,0.7,0.6364,0.42,0.1642,43,164,207,207,3,Malam
4250,2011-06-30,0,6,23,0,4,1,1,0.66,0.6212,0.5,0.0,27,99,126,126,3,Malam
4251,2011-07-01,0,7,0,0,5,1,1,0.66,0.6212,0.5,0.0,20,48,68,68,3,
4252,2011-07-01,0,7,1,0,5,1,1,0.66,0.6212,0.5,0.0,15,16,31,31,3,Pagi
4253,2011-07-01,0,7,2,0,5,1,1,0.62,0.6061,0.69,0.0,6,7,13,13,3,Pagi
4254,2011-07-01,0,7,3,0,5,1,1,0.64,0.6212,0.53,0.0,5,6,11,11,3,Pagi
4255,2011-07-01,0,7,4,0,5,1,1,0.62,0.6212,0.57,0.0,1,5,6,6,3,Pagi
4256,2011-07-01,0,7,5,0,5,1,1,0.6,0.6061,0.64,0.1343,3,27,30,30,3,Pagi
4257,2011-07-01,0,7,6,0,5,1,1,0.62,0.6061,0.61,0.1343,11,97,108,108,3,Pagi
4258,2011-07-01,0,7,7,0,5,1,1,0.66,0.6212,0.54,0.1045,25,218,243,243,3,Siang
4259,2011-07-01,0,7,8,0,5,1,1,0.7,0.6364,0.42,0.1642,39,453,492,492,3,Siang
4260,2011-07-01,0,7,9,0,5,1,1,0.74,0.6515,0.35,0.1642,58,202,260,260,3,Siang
4261,2011-07-01,0,7,10,0,5,1,1,0.76,0.6667,0.33,0.1642,61,109,170,170,3,Siang
4262,2011-07-01,0,7,11,0,5,1,1,0.8,0.697,0.26,0.0,68,146,214,214,3,Siang
4263,2011-07-01,0,7,12,0,5,1,1,0.8,0.697,0.26,0.0,83,180,263,263,3,Siang
4264,2011-07-01,0,7,13,0,5,1,1,0.8,0.6818,0.24,0.0,83,209,292,292,3,Sore
4265,2011-07-01,0,7,14,0,5,1,1,0.82,0.697,0.23,0.194,78,225,303,303,3,Sore
4266,2011-07-01,0,7,15,0,5,1,1,0.82,0.697,0.21,0.2537,82,299,381,381,3,Sore
4267,2011-07-01,0,7,16,0,5,1,1,0.82,0.697,0.17,0.0,85,342,427,427,3,Sore
4268,2011-07-01,0,7,17,0,5,1,1,0.82,0.697,0.21,0.194,99,362,461,461,3,Sore
4269,2011-07-01,0,7,18,0,5,1,1,0.8,0.6818,0.24,0.2537,98,324,422,422,3,Sore
4270,2011-07-01,0,7,19,0,5,1,1,0.78,0.6667,0.25,0.194,80,238,318,318,3,Malam
4271,2011-07-01,0,7,20,0,5,1,1,0.72,0.6515,0.42,0.2239,84,185,269,269,3,Malam
4272,2011-07-01,0,7,21,0,5,1,1,0.7,0.6364,0.45,0.194,69,149,218,218,3,Malam
4273,2011-07-01,0,7,22,0,5,1,1,0.7,0.6364,0.42,0.0,49,173,222,222,3,Malam
4274,2011-07-01,0,7,23,0,5,1,1,0.68,0.6364,0.47,0.0896,44,96,140,140,3,Malam
4275,2011-07-02,0,7,0,0,6,0,1,0.68,0.6364,0.47,0.0896,31,84,115,115,3,
4276,2011-07-02,0,7,1,0,6,0,1,0.66,0.6212,0.54,0.0,20,58,78,78,3,Pagi
4277,2011-07-02,0,7,2,0,6,0,1,0.64,0.6212,0.53,0.0,9,43,52,52,3,Pagi
4278,2011-07-02,0,7,3,0,6,0,1,0.64,0.6212,0.53,0.0,5,21,26,26,3,Pagi
4279,2011-07-02,0,7,4,0,6,0,1,0.62,0.6061,0.61,0.0,3,8,11,11,3,Pagi
4280,2011-07-02,0,7,5,0,6,0,1,0.58,0.5455,0.73,0.1045,1,13,14,14,3,Pagi
4281,2011-07-02,0,7,6,0,6,0,1,0.62,0.6061,0.69,0.1045,11,21,32,32,3,Pagi
4282,2011-07-02,0,7,7,0,6,0,1,0.64,0.6061,0.65,0.0,10,35,45,45,3,Siang
4283,2011-07-02,0,7,8,0,6,0,1,0.68,0.6364,0.57,0.0,38,94,132,132,3,Siang
4284,2011-07-02,0,7,9,0,6,0,1,0.74,0.6667,0.51,0.0896,55,124,179,179,3,Siang
4285,2011-07-02,0,7,10,0,6,0,1,0.8,0.7121,0.36,0.0,103,168,271,271,3,Siang
4286,2011-07-02,0,7,11,0,6,0,1,0.8,0.7121,0.36,0.0896,144,213,357,357,3,Siang
4287,2011-07-02,0,7,12,0,6,0,1,0.82,0.7121,0.3,0.1343,142,232,374,374,3,Siang
4288,2011-07-02,0,7,13,0,6,0,1,0.82,0.7121,0.3,0.1045,178,226,404,404,3,Sore
4289,2011-07-02,0,7,14,0,6,0,1,0.84,0.7121,0.2,0.0,177,215,392,392,3,Sore
4290,2011-07-02,0,7,15,0,6,0,1,0.86,0.7273,0.19,0.1642,168,163,331,331,3,Sore
4291,2011-07-02,0,7,16,0,6,0,1,0.88,0.7424,0.22,0.2239,206,192,398,398,3,Sore
4292,2011-07-02,0,7,17,0,6,0,1,0.84,0.7273,0.3,0.2239,179,170,349,349,3,Sore
4293,2011-07-02,0,7,18,0,6,0,1,0.82,0.7121,0.3,0.2836,193,190,383,383,3,Sore
4294,2011-07-02,0,7,19,0,6,0,1,0.8,0.697,0.33,0.2239,156,149,305,305,3,Malam
4295,2011-07-02,0,7,20,0,6,0,1,0.76,0.6818,0.45,0.2836,136,148,284,284,3,Malam
4296,2011-07-02,0,7,21,0,6,0,1,0.74,0.6667,0.48,0.194,95,137,232,232,3,Malam
4297,2011-07-02,0,7,22,0,6,0,1,0.72,0.6667,0.51,0.1642,78,123,201,201,3,Malam
4298,2011-07-02,0,7,23,0,6,0,1,0.72,0.6667,0.54,0.2836,66,88,154,154,3,Malam
4299,2011-07-03,0,7,0,0,0,0,1,0.7,0.6515,0.58,0.2239,47,97,144,144,3,
4300,2011-07-03,0,7,1,0,0,0,2,0.7,0.6515,0.61,0.1642,23,55,78,78,3,Pagi
4301,2011-07-03,0,7,2,0,0,0,1,0.7,0.6515,0.58,0.194,19,50,69,69,3,Pagi
4302,2011-07-03,0,7,3,0,0,0,3,0.68,0.6364,0.65,0.0896,8,25,33,33,3,Pagi
4303,2011-07-03,0,7,4,0,0,0,3,0.68,0.6364,0.65,0.0896,3,2,5,5,3,Pagi
4304,2011-07-03,0,7,5,0,0,0,3,0.62,0.5758,0.83,0.194,0,1,1,1,3,Pagi
4305,2011-07-03,0,7,6,0,0,0,2,0.62,0.5455,0.94,0.0896,0,3,3,3,3,Pagi
4306,2011-07-03,0,7,7,0,0,0,2,0.64,0.5758,0.89,0.194,3,22,25,25,3,Siang
4307,2011-07-03,0,7,8,0,0,0,1,0.68,0.6364,0.79,0.2239,39,53,92,92,3,Siang
4308,2011-07-03,0,7,9,0,0,0,1,0.7,0.6667,0.74,0.2537,82,99,181,181,3,Siang
4309,2011-07-03,0,7,10,0,0,0,1,0.74,0.697,0.66,0.1642,131,133,264,264,3,Siang
4310,2011-07-03,0,7,11,0,0,0,1,0.76,0.7121,0.62,0.1045,215,175,390,390,3,Siang
4311,2011-07-03,0,7,12,0,0,0,1,0.8,0.7576,0.55,0.1045,198,206,404,404,3,Siang
4312,2011-07-03,0,7,13,0,0,0,1,0.8,0.7727,0.59,0.2239,248,173,421,421,3,Sore
4313,2011-07-03,0,7,14,0,0,0,1,0.82,0.7879,0.56,0.2537,225,150,375,375,3,Sore
4314,2011-07-03,0,7,15,0,0,0,1,0.84,0.803,0.53,0.2985,194,182,376,376,3,Sore
4315,2011-07-03,0,7,16,0,0,0,1,0.84,0.803,0.53,0.2985,195,219,414,414,3,Sore
4316,2011-07-03,0,7,17,0,0,0,3,0.8,0.7424,0.49,0.8507,181,177,358,358,3,Sore
4317,2011-07-03,0,7,18,0,0,0,3,0.8,0.7424,0.49,0.8507,74,107,181,181,3,Sore
4318,2011-07-03,0,7,19,0,0,0,2,0.66,0.6061,0.83,0.194,100,83,183,183,3,Malam
4319,2011-07-03,0,7,20,0,0,0,3,0.66,0.6061,0.83,0.0,83,93,176,176,3,Malam
4320,2011-07-03,0,7,21,0,0,0,2,0.66,0.6061,0.83,0.1642,75,92,167,167,3,Malam
4321,2011-07-03,0,7,22,0,0,0,2,0.66,0.6061,0.78,0.1045,69,93,162,162,3,Malam
4322,2011-07-03,0,7,23,0,0,0,1,0.64,0.5758,0.83,0.1642,70,77,147,147,3,Malam
4323,2011-07-04,0,7,0,1,1,0,1,0.64,0.5758,0.83,0.1343,63,77,140,140,3,
4324,2011-07-04,0,7,1,1,1,0,1,0.64,0.5758,0.83,0.0896,43,76,119,119,3,Pagi
4325,2011-07-04,0,7,2,1,1,0,1,0.64,0.5758,0.83,0.0,33,30,63,63,3,Pagi
4326,2011-07-04,0,7,3,1,1,0,1,0.64,0.5909,0.78,0.0,13,13,26,26,3,Pagi
4327,2011-07-04,0,7,4,1,1,0,2,0.66,0.6061,0.78,0.0896,8,4,12,12,3,Pagi
4328,2011-07-04,0,7,5,1,1,0,2,0.64,0.5758,0.83,0.1343,1,3,4,4,3,Pagi
4329,2011-07-04,0,7,6,1,1,0,1,0.64,0.5758,0.89,0.1642,5,11,16,16,3,Pagi
4330,2011-07-04,0,7,7,1,1,0,1,0.66,0.6061,0.83,0.1343,17,19,36,36,3,Siang
4331,2011-07-04,0,7,8,1,1,0,1,0.7,0.6667,0.74,0.1045,42,44,86,86,3,Siang
4332,2011-07-04,0,7,9,1,1,0,2,0.72,0.6818,0.66,0.0896,142,96,238,238,3,Siang
4333,2011-07-04,0,7,10,1,1,0,2,0.76,0.697,0.55,0.0896,166,114,280,280,3,Siang
4334,2011-07-04,0,7,11,1,1,0,2,0.76,0.697,0.55,0.0896,177,172,349,349,3,Siang
4335,2011-07-04,0,7,12,1,1,0,2,0.78,0.7121,0.52,0.0,237,210,447,447,3,Siang
4336,2011-07-04,0,7,13,1,1,0,2,0.78,0.7121,0.49,0.0,242,181,423,423,3,Sore
4337,2011-07-04,0,7,14,1,1,0,1,0.8,0.7273,0.46,0.0,235,173,408,408,3,Sore
4338,2011-07-04,0,7,15,1,1,0,1,0.82,0.7424,0.43,0.0896,224,184,408,408,3,Sore
4339,2011-07-04,0,7,16,1,1,0,1,0.82,0.7424,0.41,0.0,236,216,452,452,3,Sore
4340,2011-07-04,0,7,17,1,1,0,1,0.8,0.7273,0.46,0.0,240,196,436,436,3,Sore
4341,2011-07-04,0,7,18,1,1,0,1,0.8,0.7273,0.46,0.1343,222,196,418,418,3,Sore
4342,2011-07-04,0,7,19,1,1,0,2,0.78,0.7121,0.49,0.1642,170,205,375,375,3,Malam
4343,2011-07-04,0,7,20,1,1,0,2,0.76,0.697,0.55,0.1045,195,191,386,386,3,Malam
4344,2011-07-04,0,7,21,1,1,0,2,0.74,0.6818,0.62,0.1045,195,262,457,457,3,Malam
4345,2011-07-04,0,7,22,1,1,0,2,0.74,0.6818,0.62,0.1343,115,211,326,326,3,Malam
4346,2011-07-04,0,7,23,1,1,0,2,0.72,0.6818,0.7,0.1045,44,94,138,138,3,Malam
4347,2011-07-05,0,7,0,0,2,1,2,0.7,0.6515,0.65,0.1642,19,36,55,55,3,
4348,2011-07-05,0,7,1,0,2,1,1,0.7,0.6515,0.65,0.1045,15,24,39,39,3,Pagi
4349,2011-07-05,0,7,2,0,2,1,1,0.66,0.6212,0.74,0.0896,8,5,13,13,3,Pagi
4350,2011-07-05,0,7,3,0,2,1,1,0.66,0.6212,0.74,0.2239,1,7,8,8,3,Pagi
4351,2011-07-05,0,7,4,0,2,1,1,0.66,0.6212,0.69,0.1642,1,4,5,5,3,Pagi
4352,2011-07-05,0,7,5,0,2,1,1,0.66,0.6212,0.69,0.0,1,19,20,20,3,Pagi
4353,2011-07-05,0,7,6,0,2,1,1,0.66,0.6212,0.74,0.0896,3,91,94,94,3,Pagi
4354,2011-07-05,0,7,7,0,2,1,1,0.7,0.6515,0.65,0.0896,22,248,270,270,3,Siang
4355,2011-07-05,0,7,8,0,2,1,1,0.72,0.6818,0.62,0.1343,41,391,432,432,3,Siang
4356,2011-07-05,0,7,9,0,2,1,1,0.74,0.6818,0.58,0.1343,50,177,227,227,3,Siang
4357,2011-07-05,0,7,10,0,2,1,1,0.76,0.697,0.52,0.1045,55,84,139,139,3,Siang
4358,2011-07-05,0,7,11,0,2,1,1,0.78,0.697,0.46,0.1045,75,97,172,172,3,Siang
4359,2011-07-05,0,7,12,0,2,1,1,0.8,0.7273,0.43,0.1045,71,130,201,201,3,Siang
4360,2011-07-05,0,7,13,0,2,1,1,0.82,0.7424,0.43,0.1045,67,136,203,203,3,Sore
4361,2011-07-05,0,7,14,0,2,1,1,0.8,0.7424,0.49,0.1642,66,112,178,178,3,Sore
4362,2011-07-05,0,7,15,0,2,1,1,0.82,0.7424,0.43,0.0,51,111,162,162,3,Sore
4363,2011-07-05,0,7,16,0,2,1,1,0.82,0.7576,0.46,0.1045,79,202,281,281,3,Sore
4364,2011-07-05,0,7,17,0,2,1,1,0.82,0.7576,0.46,0.1045,79,466,545,545,3,Sore
4365,2011-07-05,0,7,18,0,2,1,1,0.8,0.7576,0.55,0.1642,70,426,496,496,3,Sore
4366,2011-07-05,0,7,19,0,2,1,1,0.8,0.7727,0.59,0.1343,71,297,368,368,3,Malam
4367,2011-07-05,0,7,20,0,2,1,1,0.76,0.7273,0.66,0.1045,59,225,284,284,3,Malam
4368,2011-07-05,0,7,21,0,2,1,1,0.78,0.7424,0.62,0.2537,77,168,245,245,3,Malam
4369,2011-07-05,0,7,22,0,2,1,1,0.76,0.7273,0.66,0.2239,31,124,155,155,3,Malam
4370,2011-07-05,0,7,23,0,2,1,1,0.74,0.697,0.66,0.1642,19,54,73,73,3,Malam
4371,2011-07-06,0,7,0,0,3,1,1,0.72,0.697,0.74,0.194,11,26,37,37,3,
4372,2011-07-06,0,7,1,0,3,1,1,0.7,0.6667,0.74,0.1343,4,11,15,15,3,Pagi
4373,2011-07-06,0,7,2,0,3,1,1,0.7,0.6667,0.79,0.0896,1,4,5,5,3,Pagi
4374,2011-07-06,0,7,3,0,3,1,1,0.7,0.6667,0.79,0.0,0,6,6,6,3,Pagi
4375,2011-07-06,0,7,4,0,3,1,2,0.68,0.6364,0.83,0.0896,0,6,6,6,3,Pagi
4376,2011-07-06,0,7,5,0,3,1,1,0.68,0.6364,0.83,0.0896,5,30,35,35,3,Pagi
4377,2011-07-06,0,7,6,0,3,1,1,0.7,0.6667,0.79,0.0896,9,112,121,121,3,Pagi
4378,2011-07-06,0,7,7,0,3,1,2,0.72,0.697,0.79,0.0,24,288,312,312,3,Siang
4379,2011-07-06,0,7,8,0,3,1,2,0.72,0.697,0.74,0.1045,31,397,428,428,3,Siang
4380,2011-07-06,0,7,9,0,3,1,3,0.7,0.6667,0.79,0.194,31,158,189,189,3,Siang
4381,2011-07-06,0,7,10,0,3,1,3,0.7,0.6667,0.79,0.0896,13,30,43,43,3,Siang
4382,2011-07-06,0,7,11,0,3,1,2,0.72,0.697,0.74,0.0,24,103,127,127,3,Siang
4383,2011-07-06,0,7,12,0,3,1,2,0.74,0.697,0.66,0.0896,38,114,152,152,3,Siang
4384,2011-07-06,0,7,13,0,3,1,2,0.74,0.697,0.7,0.1045,33,107,140,140,3,Sore
4385,2011-07-06,0,7,14,0,3,1,1,0.76,0.7273,0.66,0.2836,50,113,163,163,3,Sore
4386,2011-07-06,0,7,15,0,3,1,1,0.76,0.7273,0.7,0.2836,55,130,185,185,3,Sore
4387,2011-07-06,0,7,16,0,3,1,1,0.76,0.7273,0.7,0.2537,57,218,275,275,3,Sore
4388,2011-07-06,0,7,17,0,3,1,1,0.78,0.7424,0.59,0.2239,79,517,596,596,3,Sore
4389,2011-07-06,0,7,18,0,3,1,1,0.76,0.7121,0.62,0.194,77,486,563,563,3,Sore
4390,2011-07-06,0,7,19,0,3,1,1,0.74,0.697,0.7,0.2239,71,323,394,394,3,Malam
4391,2011-07-06,0,7,20,0,3,1,1,0.72,0.697,0.74,0.2537,55,257,312,312,3,Malam
4392,2011-07-06,0,7,21,0,3,1,1,0.7,0.6667,0.79,0.194,66,175,241,241,3,Malam
4393,2011-07-06,0,7,22,0,3,1,1,0.7,0.6667,0.79,0.194,30,156,186,186,3,Malam
4394,2011-07-06,0,7,23,0,3,1,1,0.68,0.6364,0.83,0.2239,20,78,98,98,3,Malam
4395,2011-07-07,0,7,0,0,4,1,1,0.66,0.5909,0.89,0.1343,6,29,35,35,3,
4396,2011-07-07,0,7,1,0,4,1,1,0.66,0.5909,0.89,0.194,2,14,16,16,3,Pagi
4397,2011-07-07,0,7,2,0,4,1,1,0.66,0.5909,0.89,0.194,1,7,8,8,3,Pagi
4398,2011-07-07,0,7,3,0,4,1,1,0.64,0.5606,0.94,0.1045,2,2,4,4,3,Pagi
4399,2011-07-07,0,7,4,0,4,1,1,0.64,0.5758,0.89,0.1045,0,4,4,4,3,Pagi
4400,2011-07-07,0,7,5,0,4,1,1,0.64,0.5758,0.89,0.1045,2,30,32,32,3,Pagi
4401,2011-07-07,0,7,6,0,4,1,2,0.64,0.5758,0.89,0.1343,11,107,118,118,3,Pagi
4402,2011-07-07,0,7,7,0,4,1,2,0.66,0.5909,0.89,0.1045,13,279,292,292,3,Siang
4403,2011-07-07,0,7,8,0,4,1,2,0.7,0.6667,0.79,0.194,28,415,443,443,3,Siang
4404,2011-07-07,0,7,9,0,4,1,1,0.74,0.697,0.7,0.1642,25,154,179,179,3,Siang
4405,2011-07-07,0,7,10,0,4,1,1,0.78,0.7424,0.62,0.0,29,72,101,101,3,Siang
4406,2011-07-07,0,7,11,0,4,1,1,0.82,0.7727,0.52,0.1343,30,112,142,142,3,Siang
4407,2011-07-07,0,7,12,0,4,1,1,0.84,0.7727,0.41,0.0,32,139,171,171,3,Siang
4408,2011-07-07,0,7,13,0,4,1,1,0.86,0.7879,0.41,0.0,48,107,155,155,3,Sore
4409,2011-07-07,0,7,14,0,4,1,1,0.86,0.7879,0.41,0.2537,39,121,160,160,3,Sore
4410,2011-07-07,0,7,15,0,4,1,1,0.86,0.7879,0.41,0.2537,47,119,166,166,3,Sore
4411,2011-07-07,0,7,16,0,4,1,1,0.86,0.7727,0.39,0.2239,47,218,265,265,3,Sore
4412,2011-07-07,0,7,17,0,4,1,1,0.86,0.7576,0.36,0.2537,80,489,569,569,3,Sore
4413,2011-07-07,0,7,18,0,4,1,1,0.84,0.7576,0.44,0.2985,70,492,562,562,3,Sore
4414,2011-07-07,0,7,19,0,4,1,1,0.82,0.7727,0.52,0.2836,79,286,365,365,3,Malam
4415,2011-07-07,0,7,20,0,4,1,1,0.76,0.7121,0.58,0.3582,61,224,285,285,3,Malam
4416,2011-07-07,0,7,21,0,4,1,1,0.74,0.6818,0.62,0.1642,39,170,209,209,3,Malam
4417,2011-07-07,0,7,22,0,4,1,1,0.74,0.6818,0.62,0.1642,32,150,182,182,3,Malam
4418,2011-07-07,0,7,23,0,4,1,1,0.72,0.6818,0.66,0.0,31,98,129,129,3,Malam
4419,2011-07-08,0,7,0,0,5,1,1,0.74,0.697,0.66,0.1045,6,41,47,47,3,
4420,2011-07-08,0,7,1,0,5,1,1,0.72,0.697,0.79,0.0,9,25,34,34,3,Pagi
4421,2011-07-08,0,7,2,0,5,1,2,0.7,0.6667,0.74,0.1642,10,12,22,22,3,Pagi
4422,2011-07-08,0,7,3,0,5,1,1,0.68,0.6364,0.79,0.1045,2,4,6,6,3,Pagi
4423,2011-07-08,0,7,4,0,5,1,1,0.7,0.6667,0.79,0.2537,7,4,11,11,3,Pagi
4424,2011-07-08,0,7,5,0,5,1,1,0.68,0.6364,0.79,0.2537,3,24,27,27,3,Pagi
4425,2011-07-08,0,7,6,0,5,1,1,0.7,0.6667,0.74,0.1045,11,91,102,102,3,Pagi
4426,2011-07-08,0,7,7,0,5,1,2,0.7,0.6667,0.79,0.194,30,302,332,332,3,Siang
4427,2011-07-08,0,7,8,0,5,1,2,0.72,0.697,0.74,0.2537,36,421,457,457,3,Siang
4428,2011-07-08,0,7,9,0,5,1,2,0.76,0.7273,0.7,0.2985,30,211,241,241,3,Siang
4429,2011-07-08,0,7,10,0,5,1,2,0.74,0.697,0.7,0.3582,30,108,138,138,3,Siang
4430,2011-07-08,0,7,11,0,5,1,2,0.74,0.7121,0.74,0.2537,61,104,165,165,3,Siang
4431,2011-07-08,0,7,12,0,5,1,2,0.76,0.7273,0.7,0.2836,49,164,213,213,3,Siang
4432,2011-07-08,0,7,13,0,5,1,2,0.78,0.7576,0.66,0.2836,54,175,229,229,3,Sore
4433,2011-07-08,0,7,14,0,5,1,2,0.8,0.7879,0.63,0.3582,53,163,216,216,3,Sore
4434,2011-07-08,0,7,15,0,5,1,2,0.8,0.7879,0.63,0.3582,39,102,141,141,3,Sore
4435,2011-07-08,0,7,16,0,5,1,3,0.68,0.6364,0.83,0.4478,27,105,132,132,3,Sore
4436,2011-07-08,0,7,17,0,5,1,3,0.66,0.5909,0.89,0.4478,6,161,167,167,3,Sore
4437,2011-07-08,0,7,18,0,5,1,1,0.66,0.6061,0.83,0.0896,35,281,316,316,3,Sore
4438,2011-07-08,0,7,19,0,5,1,1,0.66,0.6061,0.83,0.0896,45,225,270,270,3,Malam
4439,2011-07-08,0,7,20,0,5,1,1,0.66,0.6061,0.83,0.1642,30,220,250,250,3,Malam
4440,2011-07-08,0,7,21,0,5,1,2,0.66,0.6061,0.83,0.2537,46,158,204,204,3,Malam
4441,2011-07-08,0,7,22,0,5,1,2,0.66,0.6061,0.78,0.194,33,136,169,169,3,Malam
4442,2011-07-08,0,7,23,0,5,1,2,0.66,0.6061,0.78,0.0896,40,111,151,151,3,Malam
4443,2011-07-09,0,7,0,0,6,0,2,0.66,0.6061,0.83,0.1343,31,90,121,121,3,
4444,2011-07-09,0,7,1,0,6,0,2,0.64,0.5758,0.89,0.1045,5,48,53,53,3,Pagi
4445,2011-07-09,0,7,2,0,6,0,1,0.64,0.5758,0.89,0.1642,12,43,55,55,3,Pagi
4446,2011-07-09,0,7,3,0,6,0,1,0.64,0.5758,0.89,0.1343,7,23,30,30,3,Pagi
4447,2011-07-09,0,7,4,0,6,0,1,0.64,0.5758,0.83,0.2239,2,4,6,6,3,Pagi
4448,2011-07-09,0,7,5,0,6,0,2,0.62,0.5606,0.88,0.1642,4,11,15,15,3,Pagi
4449,2011-07-09,0,7,6,0,6,0,2,0.64,0.5758,0.83,0.194,11,27,38,38,3,Pagi
4450,2011-07-09,0,7,7,0,6,0,1,0.66,0.6061,0.78,0.194,21,50,71,71,3,Siang
4451,2011-07-09,0,7,8,0,6,0,1,0.7,0.6515,0.7,0.2537,68,114,182,182,3,Siang
4452,2011-07-09,0,7,9,0,6,0,1,0.74,0.6818,0.58,0.2836,77,170,247,247,3,Siang
4453,2011-07-09,0,7,10,0,6,0,1,0.76,0.697,0.52,0.1642,87,177,264,264,3,Siang
4454,2011-07-09,0,7,11,0,6,0,1,0.78,0.697,0.46,0.2985,101,189,290,290,3,Siang
4455,2011-07-09,0,7,12,0,6,0,1,0.8,0.7273,0.46,0.2537,145,221,366,366,3,Siang
4456,2011-07-09,0,7,13,0,6,0,1,0.82,0.7424,0.41,0.2239,167,249,416,416,3,Sore
4457,2011-07-09,0,7,14,0,6,0,1,0.84,0.7424,0.36,0.1343,158,215,373,373,3,Sore
4458,2011-07-09,0,7,15,0,6,0,1,0.84,0.7273,0.34,0.0896,182,220,402,402,3,Sore
4459,2011-07-09,0,7,16,0,6,0,1,0.82,0.7273,0.38,0.0,171,245,416,416,3,Sore
4460,2011-07-09,0,7,17,0,6,0,1,0.84,0.7273,0.32,0.0,160,241,401,401,3,Sore
4461,2011-07-09,0,7,18,0,6,0,1,0.82,0.7273,0.36,0.1045,132,246,378,378,3,Sore
4462,2011-07-09,0,7,19,0,6,0,1,0.76,0.697,0.55,0.1642,128,178,306,306,3,Malam
4463,2011-07-09,0,7,20,0,6,0,1,0.76,0.7121,0.58,0.2239,129,185,314,314,3,Malam
4464,2011-07-09,0,7,21,0,6,0,1,0.74,0.6818,0.58,0.1642,83,155,238,238,3,Malam
4465,2011-07-09,0,7,22,0,6,0,1,0.72,0.6818,0.62,0.1642,60,154,214,214,3,Malam
4466,2011-07-09,0,7,23,0,6,0,1,0.72,0.6667,0.58,0.194,47,93,140,140,3,Malam
4467,2011-07-10,0,7,0,0,0,0,1,0.7,0.6515,0.61,0.1642,42,112,154,154,3,
4468,2011-07-10,0,7,1,0,0,0,1,0.7,0.6515,0.61,0.1343,19,94,113,113,3,Pagi
4469,2011-07-10,0,7,2,0,0,0,1,0.68,0.6364,0.69,0.0896,28,68,96,96,3,Pagi
4470,2011-07-10,0,7,3,0,0,0,1,0.66,0.6212,0.74,0.0896,6,19,25,25,3,Pagi
4471,2011-07-10,0,7,4,0,0,0,1,0.66,0.6212,0.69,0.0896,0,5,5,5,3,Pagi
4472,2011-07-10,0,7,5,0,0,0,1,0.66,0.6212,0.74,0.0,7,10,17,17,3,Pagi
4473,2011-07-10,0,7,6,0,0,0,1,0.64,0.5909,0.78,0.0896,8,17,25,25,3,Pagi
4474,2011-07-10,0,7,7,0,0,0,1,0.7,0.6515,0.7,0.0896,27,38,65,65,3,Siang
4475,2011-07-10,0,7,8,0,0,0,1,0.72,0.6818,0.66,0.0,27,65,92,92,3,Siang
4476,2011-07-10,0,7,9,0,0,0,1,0.74,0.697,0.66,0.0896,62,107,169,169,3,Siang
4477,2011-07-10,0,7,10,0,0,0,1,0.76,0.697,0.55,0.1343,95,173,268,268,3,Siang
4478,2011-07-10,0,7,11,0,0,0,1,0.78,0.7273,0.55,0.194,110,177,287,287,3,Siang
4479,2011-07-10,0,7,12,0,0,0,1,0.82,0.7576,0.46,0.2836,133,244,377,377,3,Siang
4480,2011-07-10,0,7,13,0,0,0,1,0.8,0.7273,0.46,0.2985,139,228,367,367,3,Sore
4481,2011-07-10,0,7,14,0,0,0,1,0.82,0.7424,0.41,0.3284,122,227,349,349,3,Sore
4482,2011-07-10,0,7,15,0,0,0,1,0.84,0.7424,0.39,0.2836,142,219,361,361,3,Sore
4483,2011-07-10,0,7,16,0,0,0,1,0.84,0.7576,0.41,0.2836,128,244,372,372,3,Sore
4484,2011-07-10,0,7,17,0,0,0,1,0.84,0.7424,0.36,0.2239,146,217,363,363,3,Sore
4485,2011-07-10,0,7,18,0,0,0,1,0.82,0.7424,0.43,0.2836,141,222,363,363,3,Sore
4486,2011-07-10,0,7,19,0,0,0,1,0.8,0.7424,0.49,0.3284,120,183,303,303,3,Malam
4487,2011-07-10,0,7,20,0,0,0,1,0.76,0.697,0.55,0.194,101,167,268,268,3,Malam
4488,2011-07-10,0,7,21,0,0,0,1,0.74,0.6818,0.62,0.2537,65,162,227,227,3,Malam
4489,2011-07-10,0,7,22,0,0,0,1,0.74,0.697,0.66,0.2239,56,87,143,143,3,Malam
4490,2011-07-10,0,7,23,0,0,0,1,0.72,0.6818,0.66,0.2537,19,53,72,72,3,Malam
4491,2011-07-11,0,7,0,0,1,1,1,0.7,0.6515,0.65,0.194,10,25,35,35,3,
4492,2011-07-11,0,7,1,0,1,1,1,0.7,0.6515,0.61,0.2836,5,5,10,10,3,Pagi
4493,2011-07-11,0,7,2,0,1,1,1,0.7,0.6515,0.61,0.2239,8,4,12,12,3,Pagi
4494,2011-07-11,0,7,3,0,1,1,1,0.68,0.6364,0.65,0.1642,2,8,10,10,3,Pagi
4495,2011-07-11,0,7,4,0,1,1,1,0.66,0.6212,0.74,0.2239,0,4,4,4,3,Pagi
4496,2011-07-11,0,7,5,0,1,1,1,0.66,0.6212,0.74,0.1343,5,21,26,26,3,Pagi
4497,2011-07-11,0,7,6,0,1,1,1,0.68,0.6364,0.74,0.194,19,102,121,121,3,Pagi
4498,2011-07-11,0,7,7,0,1,1,1,0.7,0.6667,0.74,0.2537,28,289,317,317,3,Siang
4499,2011-07-11,0,7,8,0,1,1,1,0.74,0.697,0.66,0.2836,35,385,420,420,3,Siang
4500,2011-07-11,0,7,9,0,1,1,1,0.78,0.7424,0.59,0.2985,41,167,208,208,3,Siang
4501,2011-07-11,0,7,10,0,1,1,1,0.8,0.7576,0.55,0.3582,44,73,117,117,3,Siang
4502,2011-07-11,0,7,11,0,1,1,1,0.82,0.7879,0.56,0.2985,39,89,128,128,3,Siang
4503,2011-07-11,0,7,12,0,1,1,1,0.84,0.803,0.53,0.2836,40,108,148,148,3,Siang
4504,2011-07-11,0,7,13,0,1,1,1,0.86,0.8182,0.5,0.2537,22,119,141,141,3,Sore
4505,2011-07-11,0,7,14,0,1,1,1,0.86,0.8333,0.53,0.2836,40,94,134,134,3,Sore
4506,2011-07-11,0,7,15,0,1,1,1,0.86,0.8485,0.56,0.4179,38,108,146,146,3,Sore
4507,2011-07-11,0,7,16,0,1,1,1,0.86,0.8485,0.56,0.3881,57,182,239,239,3,Sore
4508,2011-07-11,0,7,17,0,1,1,1,0.86,0.8485,0.56,0.4179,59,455,514,514,3,Sore
4509,2011-07-11,0,7,18,0,1,1,1,0.86,0.8333,0.53,0.3881,57,415,472,472,3,Sore
4510,2011-07-11,0,7,19,0,1,1,1,0.84,0.8333,0.59,0.3284,80,293,373,373,3,Malam
4511,2011-07-11,0,7,20,0,1,1,1,0.72,0.697,0.74,0.4179,42,194,236,236,3,Malam
4512,2011-07-11,0,7,21,0,1,1,1,0.7,0.6667,0.79,0.4179,21,109,130,130,3,Malam
4513,2011-07-11,0,7,22,0,1,1,1,0.72,0.697,0.74,0.1343,20,70,90,90,3,Malam
4514,2011-07-11,0,7,23,0,1,1,1,0.7,0.6667,0.79,0.1343,11,44,55,55,3,Malam
4515,2011-07-12,0,7,0,0,2,1,1,0.7,0.6667,0.79,0.1343,3,19,22,22,3,
4516,2011-07-12,0,7,1,0,2,1,1,0.7,0.6667,0.79,0.0896,6,8,14,14,3,Pagi
4517,2011-07-12,0,7,2,0,2,1,1,0.7,0.6667,0.79,0.1045,2,7,9,9,3,Pagi
4518,2011-07-12,0,7,3,0,2,1,2,0.7,0.6667,0.79,0.0,2,6,8,8,3,Pagi
4519,2011-07-12,0,7,4,0,2,1,1,0.7,0.6667,0.79,0.1642,0,6,6,6,3,Pagi
4520,2011-07-12,0,7,5,0,2,1,1,0.7,0.6667,0.79,0.0896,4,21,25,25,3,Pagi
4521,2011-07-12,0,7,6,0,2,1,1,0.74,0.6818,0.58,0.2239,13,102,115,115,3,Pagi
4522,2011-07-12,0,7,7,0,2,1,1,0.76,0.697,0.55,0.194,29,301,330,330,3,Siang
4523,2011-07-12,0,7,8,0,2,1,1,0.76,0.7121,0.58,0.2239,35,382,417,417,3,Siang
4524,2011-07-12,0,7,9,0,2,1,1,0.78,0.7273,0.55,0.4925,27,149,176,176,3,Siang
4525,2011-07-12,0,7,10,0,2,1,1,0.82,0.7727,0.52,0.1642,38,85,123,123,3,Siang
4526,2011-07-12,0,7,11,0,2,1,1,0.82,0.7727,0.52,0.1642,39,86,125,125,3,Siang
4527,2011-07-12,0,7,12,0,2,1,1,0.86,0.7879,0.44,0.2985,38,125,163,163,3,Siang
4528,2011-07-12,0,7,13,0,2,1,1,0.86,0.803,0.47,0.2239,32,104,136,136,3,Sore
4529,2011-07-12,0,7,14,0,2,1,1,0.9,0.8485,0.42,0.2985,33,91,124,124,3,Sore
4530,2011-07-12,0,7,15,0,2,1,1,0.9,0.8485,0.42,0.3582,37,111,148,148,3,Sore
4531,2011-07-12,0,7,16,0,2,1,1,0.86,0.7879,0.44,0.2836,25,177,202,202,3,Sore
4532,2011-07-12,0,7,17,0,2,1,1,0.88,0.8182,0.44,0.2836,48,380,428,428,3,Sore
4533,2011-07-12,0,7,18,0,2,1,1,0.86,0.803,0.47,0.2985,39,472,511,511,3,Sore
4534,2011-07-12,0,7,19,0,2,1,1,0.84,0.7576,0.44,0.2836,42,295,337,337,3,Malam
4535,2011-07-12,0,7,20,0,2,1,1,0.82,0.7424,0.43,0.194,57,251,308,308,3,Malam
4536,2011-07-12,0,7,21,0,2,1,1,0.82,0.7424,0.43,0.1045,49,209,258,258,3,Malam
4537,2011-07-12,0,7,22,0,2,1,1,0.8,0.7273,0.46,0.1343,44,150,194,194,3,Malam
4538,2011-07-12,0,7,23,0,2,1,1,0.78,0.7121,0.52,0.0,20,59,79,79,3,Malam
4539,2011-07-13,0,7,0,0,3,1,1,0.76,0.7121,0.62,0.0,9,37,46,46,3,
4540,2011-07-13,0,7,1,0,3,1,1,0.76,0.697,0.55,0.0,1,11,12,12,3,Pagi
4541,2011-07-13,0,7,2,0,3,1,1,0.76,0.697,0.55,0.0,2,3,5,5,3,Pagi
4542,2011-07-13,0,7,3,0,3,1,1,0.74,0.6818,0.58,0.194,0,4,4,4,3,Pagi
4543,2011-07-13,0,7,4,0,3,1,1,0.74,0.6818,0.58,0.2537,0,5,5,5,3,Pagi
4544,2011-07-13,0,7,5,0,3,1,1,0.74,0.6818,0.58,0.194,4,22,26,26,3,Pagi
4545,2011-07-13,0,7,6,0,3,1,1,0.74,0.6818,0.58,0.1642,18,103,121,121,3,Pagi
4546,2011-07-13,0,7,7,0,3,1,1,0.76,0.697,0.55,0.2537,32,281,313,313,3,Siang
4547,2011-07-13,0,7,8,0,3,1,1,0.8,0.7424,0.49,0.2537,31,418,449,449,3,Siang
4548,2011-07-13,0,7,9,0,3,1,1,0.82,0.7424,0.41,0.194,23,163,186,186,3,Siang
4549,2011-07-13,0,7,10,0,3,1,1,0.82,0.7576,0.46,0.194,33,80,113,113,3,Siang
4550,2011-07-13,0,7,11,0,3,1,1,0.84,0.7424,0.39,0.1642,55,110,165,165,3,Siang
4551,2011-07-13,0,7,12,0,3,1,1,0.84,0.7576,0.41,0.2836,40,134,174,174,3,Siang
4552,2011-07-13,0,7,13,0,3,1,3,0.82,0.7576,0.46,0.1343,39,119,158,158,3,Sore
4553,2011-07-13,0,7,14,0,3,1,3,0.82,0.7576,0.46,0.1343,27,89,116,116,3,Sore
4554,2011-07-13,0,7,15,0,3,1,3,0.64,0.5606,0.94,0.1343,13,33,46,46,3,Sore
4555,2011-07-13,0,7,16,0,3,1,2,0.66,0.5909,0.89,0.0,23,118,141,141,3,Sore
4556,2011-07-13,0,7,17,0,3,1,1,0.7,0.6667,0.79,0.0,70,418,488,488,3,Sore
4557,2011-07-13,0,7,18,0,3,1,1,0.72,0.697,0.79,0.1343,51,412,463,463,3,Sore
4558,2011-07-13,0,7,19,0,3,1,1,0.7,0.6667,0.79,0.1045,79,340,419,419,3,Malam
4559,2011-07-13,0,7,20,0,3,1,1,0.7,0.6667,0.84,0.1642,61,281,342,342,3,Malam
4560,2011-07-13,0,7,21,0,3,1,1,0.7,0.6667,0.79,0.1045,56,194,250,250,3,Malam
4561,2011-07-13,0,7,22,0,3,1,1,0.68,0.6364,0.83,0.194,48,136,184,184,3,Malam
4562,2011-07-13,0,7,23,0,3,1,1,0.66,0.6061,0.83,0.2537,33,83,116,116,3,Malam
4563,2011-07-14,0,7,0,0,4,1,1,0.66,0.6212,0.69,0.2985,14,32,46,46,3,
4564,2011-07-14,0,7,1,0,4,1,1,0.66,0.6212,0.61,0.2537,4,21,25,25,3,Pagi
4565,2011-07-14,0,7,2,0,4,1,1,0.64,0.6212,0.57,0.2985,3,7,10,10,3,Pagi
4566,2011-07-14,0,7,3,0,4,1,1,0.62,0.6212,0.57,0.2985,1,5,6,6,3,Pagi
4567,2011-07-14,0,7,4,0,4,1,1,0.62,0.6212,0.53,0.2537,0,6,6,6,3,Pagi
4568,2011-07-14,0,7,5,0,4,1,1,0.6,0.6212,0.56,0.2239,6,22,28,28,3,Pagi
4569,2011-07-14,0,7,6,0,4,1,1,0.6,0.6061,0.6,0.2239,14,116,130,130,3,Pagi
4570,2011-07-14,0,7,7,0,4,1,1,0.62,0.6212,0.53,0.2537,23,311,334,334,3,Siang
4571,2011-07-14,0,7,8,0,4,1,1,0.64,0.6212,0.5,0.3582,53,433,486,486,3,Siang
4572,2011-07-14,0,7,9,0,4,1,1,0.68,0.6364,0.47,0.2836,29,195,224,224,3,Siang
4573,2011-07-14,0,7,10,0,4,1,1,0.7,0.6364,0.42,0.2537,32,95,127,127,3,Siang
4574,2011-07-14,0,7,11,0,4,1,1,0.72,0.6515,0.37,0.2239,38,110,148,148,3,Siang
4575,2011-07-14,0,7,12,0,4,1,1,0.74,0.6515,0.35,0.2537,51,172,223,223,3,Siang
4576,2011-07-14,0,7,13,0,4,1,1,0.76,0.6667,0.33,0.3284,39,138,177,177,3,Sore
4577,2011-07-14,0,7,14,0,4,1,1,0.74,0.6515,0.35,0.2836,49,129,178,178,3,Sore
4578,2011-07-14,0,7,15,0,4,1,1,0.76,0.6667,0.33,0.2985,42,138,180,180,3,Sore
4579,2011-07-14,0,7,16,0,4,1,1,0.76,0.6667,0.33,0.1343,43,231,274,274,3,Sore
4580,2011-07-14,0,7,17,0,4,1,1,0.74,0.6515,0.37,0.1343,78,517,595,595,3,Sore
4581,2011-07-14,0,7,18,0,4,1,1,0.72,0.6515,0.42,0.194,94,484,578,578,3,Sore
4582,2011-07-14,0,7,19,0,4,1,1,0.72,0.6515,0.39,0.2239,67,333,400,400,3,Malam
4583,2011-07-14,0,7,20,0,4,1,1,0.7,0.6364,0.42,0.2239,81,267,348,348,3,Malam
4584,2011-07-14,0,7,21,0,4,1,1,0.66,0.6212,0.5,0.1343,58,203,261,261,3,Malam
4585,2011-07-14,0,7,22,0,4,1,1,0.64,0.6212,0.57,0.0896,42,134,176,176,3,Malam
4586,2011-07-14,0,7,23,0,4,1,1,0.64,0.6061,0.65,0.2537,27,97,124,124,3,Malam
4587,2011-07-15,0,7,0,0,5,1,1,0.62,0.5909,0.73,0.2239,23,57,80,80,3,
4588,2011-07-15,0,7,1,0,5,1,1,0.62,0.5909,0.73,0.194,7,13,20,20,3,Pagi
4589,2011-07-15,0,7,2,0,5,1,1,0.6,0.5758,0.78,0.1642,16,22,38,38,3,Pagi
4590,2011-07-15,0,7,3,0,5,1,1,0.6,0.5909,0.73,0.194,1,6,7,7,3,Pagi
4591,2011-07-15,0,7,4,0,5,1,1,0.6,0.5909,0.73,0.1642,2,8,10,10,3,Pagi
4592,2011-07-15,0,7,5,0,5,1,1,0.6,0.5909,0.73,0.1343,7,16,23,23,3,Pagi
4593,2011-07-15,0,7,6,0,5,1,2,0.6,0.5909,0.73,0.1045,12,108,120,120,3,Pagi
4594,2011-07-15,0,7,7,0,5,1,1,0.64,0.6061,0.65,0.1045,17,257,274,274,3,Siang
4595,2011-07-15,0,7,8,0,5,1,1,0.64,0.6061,0.65,0.2537,50,514,564,564,3,Siang
4596,2011-07-15,0,7,9,0,5,1,1,0.68,0.6364,0.54,0.194,31,176,207,207,3,Siang
4597,2011-07-15,0,7,10,0,5,1,2,0.66,0.6212,0.61,0.1642,59,107,166,166,3,Siang
4598,2011-07-15,0,7,11,0,5,1,1,0.7,0.6515,0.54,0.1343,73,137,210,210,3,Siang
4599,2011-07-15,0,7,12,0,5,1,1,0.7,0.6515,0.48,0.194,61,177,238,238,3,Siang
4600,2011-07-15,0,7,13,0,5,1,1,0.7,0.6515,0.54,0.194,85,162,247,247,3,Sore
4601,2011-07-15,0,7,14,0,5,1,1,0.7,0.6515,0.51,0.194,105,160,265,265,3,Sore
4602,2011-07-15,0,7,15,0,5,1,1,0.72,0.6515,0.45,0.1642,74,163,237,237,3,Sore
4603,2011-07-15,0,7,16,0,5,1,1,0.72,0.6667,0.51,0.194,96,265,361,361,3,Sore
4604,2011-07-15,0,7,17,0,5,1,1,0.74,0.6667,0.42,0.2537,104,483,587,587,3,Sore
4605,2011-07-15,0,7,18,0,5,1,1,0.72,0.6515,0.45,0.2239,102,394,496,496,3,Sore
4606,2011-07-15,0,7,19,0,5,1,1,0.7,0.6364,0.45,0.2239,114,280,394,394,3,Malam
4607,2011-07-15,0,7,20,0,5,1,1,0.7,0.6515,0.51,0.2239,92,251,343,343,3,Malam
4608,2011-07-15,0,7,21,0,5,1,1,0.66,0.6212,0.54,0.1045,75,186,261,261,3,Malam
4609,2011-07-15,0,7,22,0,5,1,1,0.66,0.6212,0.57,0.2239,71,152,223,223,3,Malam
4610,2011-07-15,0,7,23,0,5,1,1,0.64,0.6212,0.61,0.1642,41,126,167,167,3,Malam
4611,2011-07-16,0,7,0,0,6,0,1,0.62,0.6061,0.65,0.194,42,68,110,110,3,
4612,2011-07-16,0,7,1,0,6,0,1,0.6,0.5909,0.69,0.1045,24,51,75,75,3,Pagi
4613,2011-07-16,0,7,2,0,6,0,1,0.6,0.5909,0.73,0.1343,10,48,58,58,3,Pagi
4614,2011-07-16,0,7,3,0,6,0,1,0.6,0.5758,0.78,0.1343,6,20,26,26,3,Pagi
4615,2011-07-16,0,7,4,0,6,0,1,0.6,0.5909,0.73,0.0896,9,7,16,16,3,Pagi
4616,2011-07-16,0,7,5,0,6,0,1,0.58,0.5455,0.78,0.0896,4,6,10,10,3,Pagi
4617,2011-07-16,0,7,6,0,6,0,1,0.6,0.5758,0.78,0.1642,16,21,37,37,3,Pagi
4618,2011-07-16,0,7,7,0,6,0,1,0.62,0.5909,0.73,0.1343,14,38,52,52,3,Siang
4619,2011-07-16,0,7,8,0,6,0,1,0.66,0.6212,0.65,0.1642,37,90,127,127,3,Siang
4620,2011-07-16,0,7,9,0,6,0,1,0.7,0.6515,0.54,0.2239,72,150,222,222,3,Siang
4621,2011-07-16,0,7,10,0,6,0,1,0.72,0.6667,0.54,0.194,114,208,322,322,3,Siang
4622,2011-07-16,0,7,11,0,6,0,1,0.74,0.6667,0.48,0.2239,171,225,396,396,3,Siang
4623,2011-07-16,0,7,12,0,6,0,1,0.76,0.6818,0.43,0.2836,187,276,463,463,3,Siang
4624,2011-07-16,0,7,13,0,6,0,1,0.76,0.6818,0.45,0.2985,221,276,497,497,3,Sore
4625,2011-07-16,0,7,14,0,6,0,1,0.74,0.6667,0.45,0.2985,201,232,433,433,3,Sore
4626,2011-07-16,0,7,15,0,6,0,1,0.76,0.6818,0.45,0.3284,205,223,428,428,3,Sore
4627,2011-07-16,0,7,16,0,6,0,1,0.76,0.6818,0.45,0.2836,183,242,425,425,3,Sore
4628,2011-07-16,0,7,17,0,6,0,1,0.76,0.6818,0.45,0.2239,234,241,475,475,3,Sore
4629,2011-07-16,0,7,18,0,6,0,1,0.76,0.6818,0.45,0.2836,185,243,428,428,3,Sore
4630,2011-07-16,0,7,19,0,6,0,1,0.74,0.6818,0.48,0.194,164,242,406,406,3,Malam
4631,2011-07-16,0,7,20,0,6,0,1,0.72,0.6667,0.51,0.2239,108,188,296,296,3,Malam
4632,2011-07-16,0,7,21,0,6,0,1,0.7,0.6515,0.58,0.2239,85,167,252,252,3,Malam
4633,2011-07-16,0,7,22,0,6,0,1,0.7,0.6515,0.65,0.2836,65,136,201,201,3,Malam
4634,2011-07-16,0,7,23,0,6,0,1,0.68,0.6364,0.61,0.2239,61,107,168,168,3,Malam
4635,2011-07-17,0,7,0,0,0,0,1,0.66,0.6212,0.65,0.2239,34,91,125,125,3,
4636,2011-07-17,0,7,1,0,0,0,1,0.64,0.6061,0.69,0.194,16,86,102,102,3,Pagi
4637,2011-07-17,0,7,2,0,0,0,1,0.64,0.6061,0.69,0.2239,28,66,94,94,3,Pagi
4638,2011-07-17,0,7,3,0,0,0,1,0.64,0.6061,0.69,0.2239,21,26,47,47,3,Pagi
4639,2011-07-17,0,7,4,0,0,0,1,0.62,0.5909,0.73,0.1642,4,6,10,10,3,Pagi
4640,2011-07-17,0,7,5,0,0,0,1,0.64,0.6061,0.69,0.2239,4,8,12,12,3,Pagi
4641,2011-07-17,0,7,6,0,0,0,1,0.62,0.5909,0.73,0.1642,10,11,21,21,3,Pagi
4642,2011-07-17,0,7,7,0,0,0,1,0.64,0.6061,0.73,0.1642,20,30,50,50,3,Siang
4643,2011-07-17,0,7,8,0,0,0,1,0.68,0.6364,0.65,0.2239,45,73,118,118,3,Siang
4644,2011-07-17,0,7,9,0,0,0,1,0.72,0.6667,0.58,0.2239,74,110,184,184,3,Siang
4645,2011-07-17,0,7,10,0,0,0,1,0.74,0.6818,0.6,0.2239,127,177,304,304,3,Siang
4646,2011-07-17,0,7,11,0,0,0,1,0.76,0.697,0.55,0.2836,147,244,391,391,3,Siang
4647,2011-07-17,0,7,12,0,0,0,1,0.76,0.697,0.55,0.2836,177,243,420,420,3,Siang
4648,2011-07-17,0,7,13,0,0,0,1,0.8,0.7424,0.49,0.2985,200,272,472,472,3,Sore
4649,2011-07-17,0,7,14,0,0,0,1,0.8,0.7424,0.49,0.3582,168,262,430,430,3,Sore
4650,2011-07-17,0,7,15,0,0,0,1,0.82,0.7424,0.43,0.2985,129,195,324,324,3,Sore
4651,2011-07-17,0,7,16,0,0,0,1,0.8,0.7273,0.46,0.2985,129,188,317,317,3,Sore
4652,2011-07-17,0,7,17,0,0,0,1,0.8,0.7424,0.49,0.3881,133,236,369,369,3,Sore
4653,2011-07-17,0,7,18,0,0,0,1,0.8,0.7273,0.46,0.2985,147,243,390,390,3,Sore
4654,2011-07-17,0,7,19,0,0,0,1,0.76,0.697,0.55,0.2836,145,234,379,379,3,Malam
4655,2011-07-17,0,7,20,0,0,0,1,0.76,0.7121,0.58,0.2537,85,177,262,262,3,Malam
4656,2011-07-17,0,7,21,0,0,0,1,0.74,0.6818,0.62,0.2239,59,148,207,207,3,Malam
4657,2011-07-17,0,7,22,0,0,0,1,0.72,0.6818,0.66,0.2239,65,116,181,181,3,Malam
4658,2011-07-17,0,7,23,0,0,0,1,0.7,0.6667,0.74,0.1343,39,54,93,93,3,Malam
4659,2011-07-18,0,7,0,0,1,1,1,0.7,0.6667,0.74,0.1343,21,30,51,51,3,
4660,2011-07-18,0,7,1,0,1,1,1,0.7,0.6667,0.74,0.2239,17,8,25,25,3,Pagi
4661,2011-07-18,0,7,2,0,1,1,1,0.66,0.6061,0.83,0.2239,2,8,10,10,3,Pagi
4662,2011-07-18,0,7,3,0,1,1,1,0.66,0.6061,0.78,0.194,3,4,7,7,3,Pagi
4663,2011-07-18,0,7,4,0,1,1,1,0.64,0.5909,0.78,0.1642,1,3,4,4,3,Pagi
4664,2011-07-18,0,7,5,0,1,1,1,0.64,0.5909,0.78,0.1045,2,15,17,17,3,Pagi
4665,2011-07-18,0,7,6,0,1,1,1,0.64,0.5758,0.83,0.1045,10,95,105,105,3,Pagi
4666,2011-07-18,0,7,7,0,1,1,1,0.68,0.6364,0.74,0.2239,22,255,277,277,3,Siang
4667,2011-07-18,0,7,8,0,1,1,1,0.7,0.6515,0.7,0.194,18,329,347,347,3,Siang
4668,2011-07-18,0,7,9,0,1,1,1,0.74,0.697,0.67,0.2239,33,170,203,203,3,Siang
4669,2011-07-18,0,7,10,0,1,1,1,0.76,0.7121,0.62,0.194,52,78,130,130,3,Siang
4670,2011-07-18,0,7,11,0,1,1,1,0.8,0.7576,0.55,0.0896,42,99,141,141,3,Siang
4671,2011-07-18,0,7,12,0,1,1,1,0.8,0.7727,0.59,0.194,39,126,165,165,3,Siang
4672,2011-07-18,0,7,13,0,1,1,1,0.82,0.7879,0.56,0.2537,27,125,152,152,3,Sore
4673,2011-07-18,0,7,14,0,1,1,1,0.82,0.7879,0.56,0.3284,32,106,138,138,3,Sore
4674,2011-07-18,0,7,15,0,1,1,1,0.84,0.803,0.53,0.3284,53,111,164,164,3,Sore
4675,2011-07-18,0,7,16,0,1,1,1,0.84,0.803,0.53,0.2836,45,220,265,265,3,Sore
4676,2011-07-18,0,7,17,0,1,1,1,0.84,0.7879,0.49,0.3284,72,473,545,545,3,Sore
4677,2011-07-18,0,7,18,0,1,1,1,0.82,0.7727,0.49,0.3582,80,478,558,558,3,Sore
4678,2011-07-18,0,7,19,0,1,1,1,0.8,0.7576,0.55,0.2239,63,335,398,398,3,Malam
4679,2011-07-18,0,7,20,0,1,1,1,0.78,0.7424,0.59,0.2239,91,232,323,323,3,Malam
4680,2011-07-18,0,7,21,0,1,1,1,0.74,0.697,0.66,0.194,48,154,202,202,3,Malam
4681,2011-07-18,0,7,22,0,1,1,1,0.76,0.7273,0.66,0.2239,36,104,140,140,3,Malam
4682,2011-07-18,0,7,23,0,1,1,1,0.74,0.697,0.66,0.1642,32,59,91,91,3,Malam
4683,2011-07-19,0,7,0,0,2,1,1,0.74,0.697,0.66,0.1045,25,26,51,51,3,
4684,2011-07-19,0,7,1,0,2,1,2,0.74,0.697,0.66,0.1343,7,6,13,13,3,Pagi
4685,2011-07-19,0,7,2,0,2,1,1,0.72,0.6818,0.7,0.1642,9,4,13,13,3,Pagi
4686,2011-07-19,0,7,3,0,2,1,1,0.72,0.6818,0.7,0.1642,2,1,3,3,3,Pagi
4687,2011-07-19,0,7,4,0,2,1,1,0.72,0.6818,0.7,0.1343,1,4,5,5,3,Pagi
4688,2011-07-19,0,7,5,0,2,1,2,0.7,0.6667,0.74,0.1045,0,19,19,19,3,Pagi
4689,2011-07-19,0,7,6,0,2,1,2,0.72,0.697,0.74,0.1045,8,126,134,134,3,Pagi
4690,2011-07-19,0,7,7,0,2,1,2,0.74,0.697,0.7,0.1642,28,287,315,315,3,Siang
4691,2011-07-19,0,7,8,0,2,1,2,0.76,0.7273,0.7,0.1642,31,381,412,412,3,Siang
4692,2011-07-19,0,7,9,0,2,1,2,0.8,0.7879,0.63,0.1343,22,177,199,199,3,Siang
4693,2011-07-19,0,7,10,0,2,1,2,0.82,0.7879,0.56,0.1642,29,112,141,141,3,Siang
4694,2011-07-19,0,7,11,0,2,1,1,0.82,0.803,0.59,0.0,29,98,127,127,3,Siang
4695,2011-07-19,0,7,12,0,2,1,1,0.84,0.8182,0.56,0.0896,26,127,153,153,3,Siang
4696,2011-07-19,0,7,13,0,2,1,1,0.86,0.8333,0.53,0.1045,33,139,172,172,3,Sore
4697,2011-07-19,0,7,14,0,2,1,1,0.86,0.8182,0.5,0.194,41,111,152,152,3,Sore
4698,2011-07-19,0,7,15,0,2,1,1,0.88,0.8182,0.44,0.194,48,110,158,158,3,Sore
4699,2011-07-19,0,7,16,0,2,1,1,0.9,0.8485,0.42,0.2985,61,216,277,277,3,Sore
4700,2011-07-19,0,7,17,0,2,1,1,0.8,0.803,0.66,0.0,68,445,513,513,3,Sore
4701,2011-07-19,0,7,18,0,2,1,1,0.8,0.803,0.66,0.1343,80,450,530,530,3,Sore
4702,2011-07-19,0,7,19,0,2,1,1,0.76,0.7424,0.75,0.194,54,334,388,388,3,Malam
4703,2011-07-19,0,7,20,0,2,1,1,0.74,0.7273,0.74,0.0896,48,229,277,277,3,Malam
4704,2011-07-19,0,7,21,0,2,1,1,0.74,0.7121,0.74,0.1343,47,194,241,241,3,Malam
4705,2011-07-19,0,7,22,0,2,1,1,0.74,0.7121,0.74,0.0,36,120,156,156,3,Malam
4706,2011-07-19,0,7,23,0,2,1,3,0.72,0.697,0.79,0.1642,19,73,92,92,3,Malam
4707,2011-07-20,0,7,0,0,3,1,1,0.7,0.6667,0.84,0.1045,11,29,40,40,3,
4708,2011-07-20,0,7,1,0,3,1,1,0.7,0.6667,0.84,0.0,4,7,11,11,3,Pagi
4709,2011-07-20,0,7,2,0,3,1,1,0.7,0.6667,0.84,0.0,2,7,9,9,3,Pagi
4710,2011-07-20,0,7,3,0,3,1,1,0.7,0.6667,0.84,0.1045,2,4,6,6,3,Pagi
4711,2011-07-20,0,7,4,0,3,1,1,0.68,0.6364,0.83,0.0,0,4,4,4,3,Pagi
4712,2011-07-20,0,7,5,0,3,1,1,0.68,0.6364,0.83,0.1045,4,19,23,23,3,Pagi
4713,2011-07-20,0,7,6,0,3,1,2,0.68,0.6364,0.89,0.1045,5,111,116,116,3,Pagi
4714,2011-07-20,0,7,7,0,3,1,2,0.7,0.6667,0.84,0.1045,27,276,303,303,3,Siang
4715,2011-07-20,0,7,8,0,3,1,1,0.74,0.7121,0.74,0.0,34,404,438,438,3,Siang
4716,2011-07-20,0,7,9,0,3,1,1,0.74,0.697,0.7,0.0896,28,181,209,209,3,Siang
4717,2011-07-20,0,7,10,0,3,1,1,0.76,0.7273,0.7,0.0,34,76,110,110,3,Siang
4718,2011-07-20,0,7,11,0,3,1,1,0.8,0.7879,0.63,0.0896,26,116,142,142,3,Siang
4719,2011-07-20,0,7,12,0,3,1,1,0.82,0.803,0.59,0.0,28,121,149,149,3,Siang
4720,2011-07-20,0,7,13,0,3,1,1,0.84,0.8182,0.56,0.194,23,97,120,120,3,Sore
4721,2011-07-20,0,7,14,0,3,1,1,0.86,0.8333,0.53,0.2239,44,83,127,127,3,Sore
4722,2011-07-20,0,7,15,0,3,1,1,0.86,0.8182,0.5,0.1642,36,102,138,138,3,Sore
4723,2011-07-20,0,7,16,0,3,1,1,0.84,0.8182,0.56,0.0,30,204,234,234,3,Sore
4724,2011-07-20,0,7,17,0,3,1,1,0.84,0.8333,0.59,0.194,50,405,455,455,3,Sore
4725,2011-07-20,0,7,18,0,3,1,1,0.84,0.8333,0.59,0.2239,68,429,497,497,3,Sore
4726,2011-07-20,0,7,19,0,3,1,1,0.82,0.8485,0.67,0.1642,59,323,382,382,3,Malam
4727,2011-07-20,0,7,20,0,3,1,1,0.8,0.8333,0.75,0.2239,45,264,309,309,3,Malam
4728,2011-07-20,0,7,21,0,3,1,1,0.8,0.803,0.66,0.1642,33,209,242,242,3,Malam
4729,2011-07-20,0,7,22,0,3,1,1,0.78,0.7727,0.7,0.2239,25,144,169,169,3,Malam
4730,2011-07-20,0,7,23,0,3,1,1,0.76,0.7424,0.75,0.2537,26,73,99,99,3,Malam
4731,2011-07-21,0,7,0,0,4,1,2,0.76,0.7424,0.75,0.194,13,29,42,42,3,
4732,2011-07-21,0,7,1,0,4,1,2,0.74,0.7273,0.84,0.2239,5,16,21,21,3,Pagi
4733,2011-07-21,0,7,2,0,4,1,2,0.74,0.7273,0.84,0.2239,2,4,6,6,3,Pagi
4734,2011-07-21,0,7,3,0,4,1,2,0.74,0.7121,0.79,0.1343,1,5,6,6,3,Pagi
4735,2011-07-21,0,7,4,0,4,1,2,0.72,0.7121,0.84,0.1045,0,4,4,4,3,Pagi
4736,2011-07-21,0,7,5,0,4,1,2,0.72,0.7121,0.84,0.1045,2,16,18,18,3,Pagi
4737,2011-07-21,0,7,6,0,4,1,2,0.72,0.7121,0.84,0.1045,6,111,117,117,3,Pagi
4738,2011-07-21,0,7,7,0,4,1,2,0.74,0.7273,0.84,0.1343,23,251,274,274,3,Siang
4739,2011-07-21,0,7,8,0,4,1,2,0.76,0.7576,0.79,0.1642,23,358,381,381,3,Siang
4740,2011-07-21,0,7,9,0,4,1,2,0.8,0.8182,0.75,0.2537,34,166,200,200,3,Siang
4741,2011-07-21,0,7,10,0,4,1,2,0.82,0.8636,0.71,0.2239,31,47,78,78,3,Siang
4742,2011-07-21,0,7,11,0,4,1,2,0.86,0.8939,0.63,0.2985,27,79,106,106,3,Siang
4743,2011-07-21,0,7,12,0,4,1,1,0.88,0.8939,0.56,0.3284,29,106,135,135,3,Siang
4744,2011-07-21,0,7,13,0,4,1,1,0.88,0.8939,0.56,0.2985,21,81,102,102,3,Sore
4745,2011-07-21,0,7,14,0,4,1,1,0.9,0.8939,0.5,0.3582,50,97,147,147,3,Sore
4746,2011-07-21,0,7,15,0,4,1,1,0.9,0.9242,0.53,0.2537,40,93,133,133,3,Sore
4747,2011-07-21,0,7,16,0,4,1,1,0.92,0.9242,0.48,0.2836,43,167,210,210,3,Sore
4748,2011-07-21,0,7,17,0,4,1,1,0.92,0.9091,0.45,0.2985,40,374,414,414,3,Sore
4749,2011-07-21,0,7,18,0,4,1,1,0.9,0.8939,0.5,0.2836,39,343,382,382,3,Sore
4750,2011-07-21,0,7,19,0,4,1,1,0.86,0.9242,0.67,0.2836,51,233,284,284,3,Malam
4751,2011-07-21,0,7,20,0,4,1,1,0.84,0.8939,0.71,0.2239,38,199,237,237,3,Malam
4752,2011-07-21,0,7,21,0,4,1,1,0.82,0.8939,0.75,0.2239,38,187,225,225,3,Malam
4753,2011-07-21,0,7,22,0,4,1,1,0.82,0.8636,0.71,0.1642,36,113,149,149,3,Malam
4754,2011-07-21,0,7,23,0,4,1,1,0.8,0.8182,0.71,0.1642,40,73,113,113,3,Malam
4755,2011-07-22,0,7,0,0,5,1,1,0.82,0.8333,0.63,0.1343,9,51,60,60,3,
4756,2011-07-22,0,7,1,0,5,1,1,0.8,0.7879,0.63,0.0,7,17,24,24,3,Pagi
4757,2011-07-22,0,7,2,0,5,1,1,0.78,0.803,0.79,0.1343,0,14,14,14,3,Pagi
4758,2011-07-22,0,7,3,0,5,1,1,0.78,0.7879,0.75,0.1045,1,6,7,7,3,Pagi
4759,2011-07-22,0,7,4,0,5,1,1,0.76,0.7424,0.75,0.1045,8,5,13,13,3,Pagi
4760,2011-07-22,0,7,5,0,5,1,1,0.74,0.7121,0.79,0.1045,2,17,19,19,3,Pagi
4761,2011-07-22,0,7,6,0,5,1,1,0.76,0.7424,0.75,0.0896,13,83,96,96,3,Pagi
4762,2011-07-22,0,7,7,0,5,1,2,0.8,0.803,0.66,0.1045,20,232,252,252,3,Siang
4763,2011-07-22,0,7,8,0,5,1,2,0.84,0.8485,0.63,0.1642,30,292,322,322,3,Siang
4764,2011-07-22,0,7,9,0,5,1,1,0.86,0.8939,0.63,0.0896,31,177,208,208,3,Siang
4765,2011-07-22,0,7,10,0,5,1,1,0.9,0.9242,0.53,0.0896,32,83,115,115,3,Siang
4766,2011-07-22,0,7,11,0,5,1,1,0.9,0.8939,0.5,0.1045,23,86,109,109,3,Siang
4767,2011-07-22,0,7,12,0,5,1,1,0.94,0.9545,0.48,0.1642,20,95,115,115,3,Siang
4768,2011-07-22,0,7,13,0,5,1,1,0.94,0.9848,0.51,0.1642,25,98,123,123,3,Sore
4769,2011-07-22,0,7,14,0,5,1,1,0.96,1.0,0.48,0.2985,24,77,101,101,3,Sore
4770,2011-07-22,0,7,15,0,5,1,1,0.94,0.9848,0.51,0.2985,32,101,133,133,3,Sore
4771,2011-07-22,0,7,16,0,5,1,3,0.9,0.8333,0.39,0.2985,29,153,182,182,3,Sore
4772,2011-07-22,0,7,17,0,5,1,1,0.88,0.8485,0.47,0.1045,35,271,306,306,3,Sore
4773,2011-07-22,0,7,18,0,5,1,1,0.9,0.8182,0.37,0.1642,34,250,284,284,3,Sore
4774,2011-07-22,0,7,19,0,5,1,2,0.86,0.7879,0.41,0.1045,40,210,250,250,3,Malam
4775,2011-07-22,0,7,20,0,5,1,1,0.84,0.8182,0.56,0.0,46,166,212,212,3,Malam
4776,2011-07-22,0,7,21,0,5,1,1,0.82,0.803,0.59,0.0896,38,152,190,190,3,Malam
4777,2011-07-22,0,7,22,0,5,1,2,0.84,0.7879,0.49,0.0896,44,105,149,149,3,Malam
4778,2011-07-22,0,7,23,0,5,1,1,0.8,0.7879,0.63,0.194,19,84,103,103,3,Malam
4779,2011-07-23,0,7,0,0,6,0,1,0.82,0.7879,0.56,0.0,16,85,101,101,3,
4780,2011-07-23,0,7,1,0,6,0,1,0.82,0.7727,0.52,0.1045,13,57,70,70,3,Pagi
4781,2011-07-23,0,7,2,0,6,0,1,0.82,0.7727,0.52,0.0,13,48,61,61,3,Pagi
4782,2011-07-23,0,7,3,0,6,0,1,0.78,0.7576,0.66,0.0896,6,16,22,22,3,Pagi
4783,2011-07-23,0,7,4,0,6,0,1,0.76,0.7273,0.66,0.1045,5,4,9,9,3,Pagi
4784,2011-07-23,0,7,5,0,6,0,1,0.76,0.7121,0.62,0.1343,1,6,7,7,3,Pagi
4785,2011-07-23,0,7,6,0,6,0,1,0.8,0.7424,0.52,0.1343,6,19,25,25,3,Pagi
4786,2011-07-23,0,7,7,0,6,0,1,0.8,0.7424,0.52,0.1045,7,38,45,45,3,Siang
4787,2011-07-23,0,7,8,0,6,0,1,0.84,0.7879,0.49,0.2537,24,85,109,109,3,Siang
4788,2011-07-23,0,7,9,0,6,0,1,0.84,0.7879,0.49,0.1642,30,102,132,132,3,Siang
4789,2011-07-23,0,7,10,0,6,0,1,0.86,0.7879,0.41,0.2239,61,137,198,198,3,Siang
4790,2011-07-23,0,7,11,0,6,0,1,0.9,0.8182,0.37,0.194,62,154,216,216,3,Siang
4791,2011-07-23,0,7,12,0,6,0,1,0.92,0.8636,0.37,0.1045,71,164,235,235,3,Siang
4792,2011-07-23,0,7,13,0,6,0,1,0.94,0.8788,0.38,0.1642,78,167,245,245,3,Sore
4793,2011-07-23,0,7,14,0,6,0,1,0.92,0.8939,0.42,0.0,84,152,236,236,3,Sore
4794,2011-07-23,0,7,15,0,6,0,1,0.94,0.8788,0.38,0.0,78,137,215,215,3,Sore
4795,2011-07-23,0,7,16,0,6,0,1,0.94,0.8788,0.38,0.1343,70,151,221,221,3,Sore
4796,2011-07-23,0,7,17,0,6,0,1,0.94,0.8788,0.38,0.1343,70,127,197,197,3,Sore
4797,2011-07-23,0,7,18,0,6,0,1,0.92,0.8788,0.4,0.2239,62,134,196,196,3,Sore
4798,2011-07-23,0,7,19,0,6,0,2,0.82,0.803,0.59,0.1343,80,137,217,217,3,Malam
4799,2011-07-23,0,7,20,0,6,0,1,0.82,0.803,0.59,0.2239,47,98,145,145,3,Malam
4800,2011-07-23,0,7,21,0,6,0,1,0.82,0.803,0.59,0.2239,39,115,154,154,3,Malam
4801,2011-07-23,0,7,22,0,6,0,1,0.8,0.7727,0.59,0.194,37,88,125,125,3,Malam
4802,2011-07-23,0,7,23,0,6,0,1,0.8,0.7727,0.59,0.1045,27,77,104,104,3,Malam
4803,2011-07-24,0,7,0,0,0,0,1,0.8,0.7727,0.59,0.1045,42,77,119,119,3,
4804,2011-07-24,0,7,1,0,0,0,1,0.78,0.7576,0.66,0.1045,33,63,96,96,3,Pagi
4805,2011-07-24,0,7,2,0,0,0,1,0.8,0.7879,0.63,0.0896,12,48,60,60,3,Pagi
4806,2011-07-24,0,7,3,0,0,0,1,0.8,0.7879,0.63,0.0896,17,20,37,37,3,Pagi
4807,2011-07-24,0,7,4,0,0,0,1,0.78,0.7576,0.66,0.1045,1,5,6,6,3,Pagi
4808,2011-07-24,0,7,5,0,0,0,1,0.78,0.7576,0.66,0.0896,5,3,8,8,3,Pagi
4809,2011-07-24,0,7,6,0,0,0,2,0.8,0.7879,0.63,0.0896,9,13,22,22,3,Pagi
4810,2011-07-24,0,7,7,0,0,0,1,0.8,0.7727,0.59,0.1343,6,29,35,35,3,Siang
4811,2011-07-24,0,7,8,0,0,0,1,0.82,0.7879,0.56,0.2836,22,82,104,104,3,Siang
4812,2011-07-24,0,7,9,0,0,0,1,0.82,0.7879,0.56,0.3881,42,112,154,154,3,Siang
4813,2011-07-24,0,7,10,0,0,0,1,0.86,0.8182,0.5,0.3284,61,165,226,226,3,Siang
4814,2011-07-24,0,7,11,0,0,0,1,0.84,0.803,0.53,0.2537,74,169,243,243,3,Siang
4815,2011-07-24,0,7,12,0,0,0,1,0.9,0.8636,0.45,0.1642,85,161,246,246,3,Siang
4816,2011-07-24,0,7,13,0,0,0,1,0.86,0.803,0.47,0.2239,90,162,252,252,3,Sore
4817,2011-07-24,0,7,14,0,0,0,1,0.86,0.8182,0.5,0.2836,79,204,283,283,3,Sore
4818,2011-07-24,0,7,15,0,0,0,1,0.9,0.8485,0.42,0.2537,68,170,238,238,3,Sore
4819,2011-07-24,0,7,16,0,0,0,1,0.9,0.8485,0.42,0.2537,62,187,249,249,3,Sore
4820,2011-07-24,0,7,17,0,0,0,1,0.9,0.8333,0.39,0.1045,75,174,249,249,3,Sore
4821,2011-07-24,0,7,18,0,0,0,1,0.88,0.8182,0.42,0.1642,67,176,243,243,3,Sore
4822,2011-07-24,0,7,19,0,0,0,1,0.86,0.803,0.47,0.1642,70,170,240,240,3,Malam
4823,2011-07-24,0,7,20,0,0,0,1,0.84,0.7879,0.49,0.1642,52,143,195,195,3,Malam
4824,2011-07-24,0,7,21,0,0,0,1,0.8,0.7879,0.63,0.1343,42,111,153,153,3,Malam
4825,2011-07-24,0,7,22,0,0,0,1,0.78,0.7576,0.66,0.0,23,75,98,98,3,Malam
4826,2011-07-24,0,7,23,0,0,0,2,0.76,0.7273,0.7,0.0896,13,37,50,50,3,Malam
4827,2011-07-25,0,7,0,0,1,1,2,0.76,0.7273,0.7,0.0,17,17,34,34,3,
4828,2011-07-25,0,7,1,0,1,1,2,0.76,0.7424,0.75,0.0896,4,8,12,12,3,Pagi
4829,2011-07-25,0,7,2,0,1,1,2,0.74,0.7121,0.79,0.0896,3,3,6,6,3,Pagi
4830,2011-07-25,0,7,3,0,1,1,1,0.74,0.7121,0.79,0.0,2,2,4,4,3,Pagi
4831,2011-07-25,0,7,4,0,1,1,1,0.72,0.7121,0.84,0.0896,0,6,6,6,3,Pagi
4832,2011-07-25,0,7,5,0,1,1,1,0.72,0.7121,0.84,0.0896,2,22,24,24,3,Pagi
4833,2011-07-25,0,7,6,0,1,1,2,0.72,0.7121,0.84,0.0896,7,100,107,107,3,Pagi
4834,2011-07-25,0,7,7,0,1,1,2,0.74,0.7121,0.79,0.0,20,257,277,277,3,Siang
4835,2011-07-25,0,7,8,0,1,1,2,0.76,0.7424,0.75,0.0,34,353,387,387,3,Siang
4836,2011-07-25,0,7,9,0,1,1,1,0.8,0.803,0.66,0.0,11,124,135,135,3,Siang
4837,2011-07-25,0,7,10,0,1,1,1,0.82,0.803,0.59,0.0,30,54,84,84,3,Siang
4838,2011-07-25,0,7,11,0,1,1,2,0.84,0.8333,0.59,0.194,24,83,107,107,3,Siang
4839,2011-07-25,0,7,12,0,1,1,2,0.84,0.8333,0.59,0.194,17,50,67,67,3,Siang
4840,2011-07-25,0,7,13,0,1,1,2,0.74,0.7121,0.74,0.1343,14,64,78,78,3,Sore
4841,2011-07-25,0,7,14,0,1,1,2,0.72,0.697,0.79,0.194,28,62,90,90,3,Sore
4842,2011-07-25,0,7,15,0,1,1,1,0.7,0.6667,0.84,0.3881,16,96,112,112,3,Sore
4843,2011-07-25,0,7,16,0,1,1,1,0.7,0.6667,0.84,0.2239,37,161,198,198,3,Sore
4844,2011-07-25,0,7,17,0,1,1,1,0.72,0.697,0.74,0.0,48,437,485,485,3,Sore
4845,2011-07-25,0,7,18,0,1,1,1,0.74,0.7121,0.74,0.0896,60,473,533,533,3,Sore
4846,2011-07-25,0,7,19,0,1,1,1,0.74,0.697,0.7,0.0896,62,324,386,386,3,Malam
4847,2011-07-25,0,7,20,0,1,1,1,0.72,0.697,0.74,0.1343,55,247,302,302,3,Malam
4848,2011-07-25,0,7,21,0,1,1,1,0.7,0.6667,0.84,0.0,41,153,194,194,3,Malam
4849,2011-07-25,0,7,22,0,1,1,1,0.7,0.6667,0.84,0.0,13,112,125,125,3,Malam
4850,2011-07-25,0,7,23,0,1,1,1,0.7,0.6667,0.84,0.0896,23,64,87,87,3,Malam
4851,2011-07-26,0,7,0,0,2,1,1,0.7,0.6667,0.79,0.1045,8,20,28,28,3,
4852,2011-07-26,0,7,1,0,2,1,1,0.7,0.6667,0.79,0.1045,6,6,12,12,3,Pagi
4853,2011-07-26,0,7,2,0,2,1,1,0.68,0.6364,0.89,0.1045,1,6,7,7,3,Pagi
4854,2011-07-26,0,7,3,0,2,1,1,0.68,0.6364,0.89,0.1343,2,2,4,4,3,Pagi
4855,2011-07-26,0,7,4,0,2,1,1,0.68,0.6364,0.88,0.1642,0,6,6,6,3,Pagi
4856,2011-07-26,0,7,5,0,2,1,1,0.66,0.5909,0.89,0.0896,3,24,27,27,3,Pagi
4857,2011-07-26,0,7,6,0,2,1,1,0.68,0.6364,0.83,0.2239,2,108,110,110,3,Pagi
4858,2011-07-26,0,7,7,0,2,1,1,0.72,0.6818,0.66,0.2836,30,288,318,318,3,Siang
4859,2011-07-26,0,7,8,0,2,1,1,0.74,0.6818,0.55,0.194,32,392,424,424,3,Siang
4860,2011-07-26,0,7,9,0,2,1,1,0.76,0.6818,0.4,0.2239,25,162,187,187,3,Siang
4861,2011-07-26,0,7,10,0,2,1,1,0.8,0.697,0.31,0.2239,42,96,138,138,3,Siang
4862,2011-07-26,0,7,11,0,2,1,1,0.82,0.7121,0.3,0.0,49,102,151,151,3,Siang
4863,2011-07-26,0,7,12,0,2,1,1,0.84,0.7273,0.28,0.0,25,122,147,147,3,Siang
4864,2011-07-26,0,7,13,0,2,1,1,0.84,0.7273,0.32,0.2985,43,139,182,182,3,Sore
4865,2011-07-26,0,7,14,0,2,1,1,0.86,0.7424,0.3,0.2836,46,101,147,147,3,Sore
4866,2011-07-26,0,7,15,0,2,1,1,0.88,0.7576,0.28,0.3284,49,114,163,163,3,Sore
4867,2011-07-26,0,7,16,0,2,1,1,0.86,0.7576,0.36,0.2836,41,213,254,254,3,Sore
4868,2011-07-26,0,7,17,0,2,1,1,0.86,0.7576,0.36,0.3582,72,465,537,537,3,Sore
4869,2011-07-26,0,7,18,0,2,1,1,0.84,0.7424,0.39,0.3881,68,478,546,546,3,Sore
4870,2011-07-26,0,7,19,0,2,1,1,0.82,0.7424,0.43,0.2985,69,329,398,398,3,Malam
4871,2011-07-26,0,7,20,0,2,1,1,0.8,0.7273,0.46,0.2537,47,243,290,290,3,Malam
4872,2011-07-26,0,7,21,0,2,1,1,0.78,0.7121,0.49,0.2239,45,222,267,267,3,Malam
4873,2011-07-26,0,7,22,0,2,1,1,0.76,0.697,0.55,0.1343,27,131,158,158,3,Malam
4874,2011-07-26,0,7,23,0,2,1,1,0.76,0.7121,0.58,0.1045,18,71,89,89,3,Malam
4875,2011-07-27,0,7,0,0,3,1,2,0.78,0.7121,0.52,0.1642,19,26,45,45,3,
4876,2011-07-27,0,7,1,0,3,1,1,0.78,0.7121,0.49,0.194,1,9,10,10,3,Pagi
4877,2011-07-27,0,7,2,0,3,1,1,0.76,0.697,0.52,0.2985,1,5,6,6,3,Pagi
4878,2011-07-27,0,7,3,0,3,1,1,0.72,0.6667,0.58,0.1642,0,4,4,4,3,Pagi
4879,2011-07-27,0,7,4,0,3,1,1,0.72,0.6667,0.51,0.194,1,3,4,4,3,Pagi
4880,2011-07-27,0,7,5,0,3,1,1,0.7,0.6515,0.54,0.2836,0,18,18,18,3,Pagi
4881,2011-07-27,0,7,6,0,3,1,1,0.7,0.6515,0.54,0.2239,4,119,123,123,3,Pagi
4882,2011-07-27,0,7,7,0,3,1,1,0.72,0.6667,0.48,0.2537,34,313,347,347,3,Siang
4883,2011-07-27,0,7,8,0,3,1,1,0.74,0.6667,0.42,0.2537,28,405,433,433,3,Siang
4884,2011-07-27,0,7,9,0,3,1,1,0.76,0.6667,0.35,0.2537,27,189,216,216,3,Siang
4885,2011-07-27,0,7,10,0,3,1,1,0.78,0.6818,0.33,0.0,32,82,114,114,3,Siang
4886,2011-07-27,0,7,11,0,3,1,1,0.8,0.697,0.31,0.0,42,94,136,136,3,Siang
4887,2011-07-27,0,7,12,0,3,1,1,0.82,0.7121,0.3,0.2836,37,132,169,169,3,Siang
4888,2011-07-27,0,7,13,0,3,1,1,0.84,0.7273,0.3,0.3582,29,151,180,180,3,Sore
4889,2011-07-27,0,7,14,0,3,1,1,0.84,0.7273,0.28,0.2239,20,107,127,127,3,Sore
4890,2011-07-27,0,7,15,0,3,1,1,0.86,0.7424,0.26,0.2537,37,103,140,140,3,Sore
4891,2011-07-27,0,7,16,0,3,1,1,0.86,0.7273,0.25,0.1642,40,228,268,268,3,Sore
4892,2011-07-27,0,7,17,0,3,1,1,0.84,0.7121,0.26,0.2239,81,491,572,572,3,Sore
4893,2011-07-27,0,7,18,0,3,1,1,0.82,0.7121,0.28,0.1045,78,463,541,541,3,Sore
4894,2011-07-27,0,7,19,0,3,1,1,0.8,0.697,0.29,0.0896,87,288,375,375,3,Malam
4895,2011-07-27,0,7,20,0,3,1,1,0.76,0.6818,0.45,0.2239,55,239,294,294,3,Malam
4896,2011-07-27,0,7,21,0,3,1,1,0.74,0.6667,0.48,0.1045,49,196,245,245,3,Malam
4897,2011-07-27,0,7,22,0,3,1,1,0.72,0.6667,0.48,0.0,37,143,180,180,3,Malam
4898,2011-07-27,0,7,23,0,3,1,1,0.74,0.6667,0.45,0.0896,16,93,109,109,3,Malam
4899,2011-07-28,0,7,0,0,4,1,1,0.7,0.6515,0.51,0.1343,14,31,45,45,3,
4900,2011-07-28,0,7,1,0,4,1,1,0.72,0.6667,0.51,0.0,3,26,29,29,3,Pagi
4901,2011-07-28,0,7,2,0,4,1,1,0.72,0.6667,0.54,0.1045,2,5,7,7,3,Pagi
4902,2011-07-28,0,7,3,0,4,1,1,0.72,0.6667,0.54,0.0,0,5,5,5,3,Pagi
4903,2011-07-28,0,7,4,0,4,1,1,0.7,0.6515,0.61,0.1045,0,6,6,6,3,Pagi
4904,2011-07-28,0,7,5,0,4,1,1,0.7,0.6515,0.65,0.1045,1,26,27,27,3,Pagi
4905,2011-07-28,0,7,6,0,4,1,1,0.7,0.6515,0.7,0.0896,6,110,116,116,3,Pagi
4906,2011-07-28,0,7,7,0,4,1,1,0.72,0.6818,0.7,0.1642,27,278,305,305,3,Siang
4907,2011-07-28,0,7,8,0,4,1,1,0.74,0.697,0.66,0.1642,47,409,456,456,3,Siang
4908,2011-07-28,0,7,9,0,4,1,1,0.78,0.7424,0.59,0.194,21,189,210,210,3,Siang
4909,2011-07-28,0,7,10,0,4,1,1,0.8,0.7576,0.55,0.2836,30,86,116,116,3,Siang
4910,2011-07-28,0,7,11,0,4,1,1,0.84,0.8182,0.56,0.2836,41,113,154,154,3,Siang
4911,2011-07-28,0,7,12,0,4,1,1,0.84,0.803,0.53,0.2537,35,151,186,186,3,Siang
4912,2011-07-28,0,7,13,0,4,1,1,0.86,0.803,0.47,0.2537,26,126,152,152,3,Sore
4913,2011-07-28,0,7,14,0,4,1,2,0.84,0.7879,0.49,0.2537,27,111,138,138,3,Sore
4914,2011-07-28,0,7,15,0,4,1,1,0.86,0.8182,0.5,0.194,22,124,146,146,3,Sore
4915,2011-07-28,0,7,16,0,4,1,1,0.86,0.803,0.47,0.1642,42,214,256,256,3,Sore
4916,2011-07-28,0,7,17,0,4,1,1,0.84,0.803,0.53,0.194,45,423,468,468,3,Sore
4917,2011-07-28,0,7,18,0,4,1,1,0.84,0.8182,0.56,0.2239,55,428,483,483,3,Sore
4918,2011-07-28,0,7,19,0,4,1,1,0.82,0.803,0.59,0.194,37,285,322,322,3,Malam
4919,2011-07-28,0,7,20,0,4,1,1,0.8,0.7879,0.63,0.194,41,229,270,270,3,Malam
4920,2011-07-28,0,7,21,0,4,1,1,0.78,0.7576,0.66,0.2836,31,165,196,196,3,Malam
4921,2011-07-28,0,7,22,0,4,1,1,0.76,0.7273,0.7,0.2537,25,149,174,174,3,Malam
4922,2011-07-28,0,7,23,0,4,1,1,0.76,0.7424,0.75,0.194,28,95,123,123,3,Malam
4923,2011-07-29,0,7,0,0,5,1,1,0.74,0.7121,0.79,0.1642,12,45,57,57,3,
4924,2011-07-29,0,7,1,0,5,1,1,0.74,0.7121,0.79,0.1343,12,22,34,34,3,Pagi
4925,2011-07-29,0,7,2,0,5,1,1,0.74,0.7121,0.79,0.0,3,10,13,13,3,Pagi
4926,2011-07-29,0,7,3,0,5,1,1,0.74,0.7121,0.79,0.0,2,9,11,11,3,Pagi
4927,2011-07-29,0,7,4,0,5,1,1,0.72,0.7121,0.84,0.1343,2,4,6,6,3,Pagi
4928,2011-07-29,0,7,5,0,5,1,1,0.72,0.7121,0.84,0.0,4,23,27,27,3,Pagi
4929,2011-07-29,0,7,6,0,5,1,2,0.72,0.7121,0.84,0.0,7,83,90,90,3,Pagi
4930,2011-07-29,0,7,7,0,5,1,2,0.74,0.7121,0.79,0.0896,26,228,254,254,3,Siang
4931,2011-07-29,0,7,8,0,5,1,2,0.76,0.7727,0.77,0.0,30,354,384,384,3,Siang
4932,2011-07-29,0,7,9,0,5,1,1,0.86,0.803,0.47,0.2537,28,151,179,179,3,Siang
4933,2011-07-29,0,7,10,0,5,1,1,0.9,0.8485,0.42,0.2836,37,69,106,106,3,Siang
4934,2011-07-29,0,7,11,0,5,1,1,0.92,0.8788,0.4,0.2985,43,118,161,161,3,Siang
4935,2011-07-29,0,7,12,0,5,1,1,0.96,0.8636,0.31,0.2836,40,95,135,135,3,Siang
4936,2011-07-29,0,7,13,0,5,1,1,0.94,0.8333,0.31,0.0,42,114,156,156,3,Sore
4937,2011-07-29,0,7,14,0,5,1,1,0.96,0.8636,0.3,0.2239,34,114,148,148,3,Sore
4938,2011-07-29,0,7,15,0,5,1,1,0.96,0.8636,0.3,0.2537,40,129,169,169,3,Sore
4939,2011-07-29,0,7,16,0,5,1,1,0.96,0.8636,0.3,0.3881,35,198,233,233,3,Sore
4940,2011-07-29,0,7,17,0,5,1,1,0.96,0.8636,0.3,0.2985,47,374,421,421,3,Sore
4941,2011-07-29,0,7,18,0,5,1,1,0.92,0.8636,0.37,0.3284,49,313,362,362,3,Sore
4942,2011-07-29,0,7,19,0,5,1,1,0.9,0.8485,0.42,0.2239,22,219,241,241,3,Malam
4943,2011-07-29,0,7,20,0,5,1,1,0.86,0.7879,0.41,0.3284,53,153,206,206,3,Malam
4944,2011-07-29,0,7,21,0,5,1,1,0.82,0.7576,0.46,0.1642,29,134,163,163,3,Malam
4945,2011-07-29,0,7,22,0,5,1,1,0.8,0.7424,0.49,0.2239,47,127,174,174,3,Malam
4946,2011-07-29,0,7,23,0,5,1,1,0.78,0.7121,0.52,0.1045,26,90,116,116,3,Malam
4947,2011-07-30,0,7,0,0,6,0,1,0.76,0.697,0.55,0.194,60,73,133,133,3,
4948,2011-07-30,0,7,1,0,6,0,1,0.76,0.697,0.55,0.0896,15,75,90,90,3,Pagi
4949,2011-07-30,0,7,2,0,6,0,1,0.76,0.697,0.55,0.1045,11,31,42,42,3,Pagi
4950,2011-07-30,0,7,3,0,6,0,1,0.74,0.6818,0.62,0.1642,18,25,43,43,3,Pagi
4951,2011-07-30,0,7,4,0,6,0,1,0.72,0.6818,0.66,0.1642,4,6,10,10,3,Pagi
4952,2011-07-30,0,7,5,0,6,0,1,0.72,0.6818,0.7,0.2836,4,9,13,13,3,Pagi
4953,2011-07-30,0,7,6,0,6,0,1,0.72,0.6818,0.7,0.2985,6,18,24,24,3,Pagi
4954,2011-07-30,0,7,7,0,6,0,1,0.76,0.7273,0.66,0.194,3,39,42,42,3,Siang
4955,2011-07-30,0,7,8,0,6,0,1,0.78,0.7424,0.59,0.2239,27,87,114,114,3,Siang
4956,2011-07-30,0,7,9,0,6,0,1,0.82,0.7576,0.46,0.2985,49,125,174,174,3,Siang
4957,2011-07-30,0,7,10,0,6,0,1,0.82,0.7424,0.41,0.2985,79,182,261,261,3,Siang
4958,2011-07-30,0,7,11,0,6,0,1,0.84,0.7424,0.36,0.194,111,206,317,317,3,Siang
4959,2011-07-30,0,7,12,0,6,0,1,0.84,0.7273,0.32,0.1642,111,230,341,341,3,Siang
4960,2011-07-30,0,7,13,0,6,0,1,0.88,0.7576,0.29,0.0,125,183,308,308,3,Sore
4961,2011-07-30,0,7,14,0,6,0,1,0.9,0.7879,0.29,0.0,112,193,305,305,3,Sore
4962,2011-07-30,0,7,15,0,6,0,1,0.9,0.803,0.31,0.1343,113,189,302,302,3,Sore
4963,2011-07-30,0,7,16,0,6,0,1,0.9,0.7879,0.27,0.2239,126,176,302,302,3,Sore
4964,2011-07-30,0,7,17,0,6,0,1,0.9,0.7879,0.29,0.1045,93,209,302,302,3,Sore
4965,2011-07-30,0,7,18,0,6,0,1,0.88,0.7576,0.28,0.194,92,207,299,299,3,Sore
4966,2011-07-30,0,7,19,0,6,0,1,0.74,0.6515,0.33,0.2239,101,155,256,256,3,Malam
4967,2011-07-30,0,7,20,0,6,0,1,0.82,0.7424,0.43,0.1343,74,132,206,206,3,Malam
4968,2011-07-30,0,7,21,0,6,0,1,0.8,0.7424,0.49,0.1642,82,123,205,205,3,Malam
4969,2011-07-30,0,7,22,0,6,0,1,0.78,0.7121,0.52,0.1045,80,129,209,209,3,Malam
4970,2011-07-30,0,7,23,0,6,0,1,0.76,0.697,0.55,0.0896,63,114,177,177,3,Malam
4971,2011-07-31,0,7,0,0,0,0,1,0.76,0.697,0.55,0.0896,33,80,113,113,3,
4972,2011-07-31,0,7,1,0,0,0,1,0.74,0.6818,0.62,0.0896,8,71,79,79,3,Pagi
4973,2011-07-31,0,7,2,0,0,0,1,0.74,0.697,0.66,0.0896,19,48,67,67,3,Pagi
4974,2011-07-31,0,7,3,0,0,0,1,0.74,0.697,0.66,0.0,24,26,50,50,3,Pagi
4975,2011-07-31,0,7,4,0,0,0,1,0.72,0.6818,0.7,0.0,6,7,13,13,3,Pagi
4976,2011-07-31,0,7,5,0,0,0,1,0.72,0.6818,0.69,0.0,4,4,8,8,3,Pagi
4977,2011-07-31,0,7,6,0,0,0,1,0.74,0.697,0.7,0.0,5,8,13,13,3,Pagi
4978,2011-07-31,0,7,7,0,0,0,1,0.74,0.6818,0.58,0.1343,19,26,45,45,3,Siang
4979,2011-07-31,0,7,8,0,0,0,1,0.76,0.697,0.55,0.2239,54,88,142,142,3,Siang
4980,2011-07-31,0,7,9,0,0,0,1,0.8,0.7424,0.49,0.0,55,128,183,183,3,Siang
4981,2011-07-31,0,7,10,0,0,0,1,0.84,0.7424,0.36,0.1642,91,163,254,254,3,Siang
4982,2011-07-31,0,7,11,0,0,0,1,0.86,0.7424,0.28,0.1642,112,163,275,275,3,Siang
4983,2011-07-31,0,7,12,0,0,0,1,0.9,0.7727,0.25,0.194,146,192,338,338,3,Siang
4984,2011-07-31,0,7,13,0,0,0,1,0.9,0.7727,0.24,0.1343,142,152,294,294,3,Sore
4985,2011-07-31,0,7,14,0,0,0,1,0.9,0.7727,0.24,0.1642,130,196,326,326,3,Sore
4986,2011-07-31,0,7,15,0,0,0,1,0.92,0.7727,0.18,0.2985,109,184,293,293,3,Sore
4987,2011-07-31,0,7,16,0,0,0,1,0.92,0.7727,0.17,0.2836,98,208,306,306,3,Sore
4988,2011-07-31,0,7,17,0,0,0,1,0.92,0.7727,0.16,0.1642,114,206,320,320,3,Sore
4989,2011-07-31,0,7,18,0,0,0,1,0.86,0.7879,0.41,0.2836,91,213,304,304,3,Sore
4990,2011-07-31,0,7,19,0,0,0,1,0.8,0.7576,0.55,0.3284,87,187,274,274,3,Malam
4991,2011-07-31,0,7,20,0,0,0,1,0.8,0.7576,0.55,0.3284,70,205,275,275,3,Malam
4992,2011-07-31,0,7,21,0,0,0,1,0.78,0.7424,0.59,0.2985,68,96,164,164,3,Malam
4993,2011-07-31,0,7,22,0,0,0,1,0.74,0.697,0.7,0.2985,25,71,96,96,3,Malam
4994,2011-07-31,0,7,23,0,0,0,1,0.74,0.697,0.66,0.2239,14,56,70,70,3,Malam
4995,2011-08-01,0,8,0,0,1,1,1,0.72,0.6818,0.7,0.2239,7,22,29,29,3,
4996,2011-08-01,0,8,1,0,1,1,1,0.72,0.697,0.74,0.194,5,12,17,17,3,Pagi
4997,2011-08-01,0,8,2,0,1,1,1,0.7,0.6667,0.74,0.1045,4,7,11,11,3,Pagi
4998,2011-08-01,0,8,3,0,1,1,1,0.7,0.6667,0.79,0.1642,0,4,4,4,3,Pagi
4999,2011-08-01,0,8,4,0,1,1,1,0.66,0.6061,0.83,0.1343,2,2,4,4,3,Pagi
5000,2011-08-01,0,8,5,0,1,1,1,0.66,0.6061,0.83,0.1045,2,24,26,26,3,Pagi
5001,2011-08-01,0,8,6,0,1,1,1,0.66,0.6061,0.83,0.0896,3,97,100,100,3,Pagi
5002,2011-08-01,0,8,7,0,1,1,1,0.74,0.6818,0.62,0.0,24,258,282,282,3,Siang
5003,2011-08-01,0,8,8,0,1,1,1,0.8,0.7273,0.43,0.194,35,347,382,382,3,Siang
5004,2011-08-01,0,8,9,0,1,1,1,0.82,0.7424,0.41,0.0,27,139,166,166,3,Siang
5005,2011-08-01,0,8,10,0,1,1,1,0.86,0.7576,0.36,0.1642,27,70,97,97,3,Siang
5006,2011-08-01,0,8,11,0,1,1,1,0.88,0.7727,0.32,0.1642,53,66,119,119,3,Siang
5007,2011-08-01,0,8,12,0,1,1,1,0.9,0.803,0.33,0.2537,53,115,168,168,3,Siang
5008,2011-08-01,0,8,13,0,1,1,1,0.9,0.803,0.31,0.2985,38,112,150,150,3,Sore
5009,2011-08-01,0,8,14,0,1,1,1,0.92,0.8182,0.29,0.194,37,86,123,123,3,Sore
5010,2011-08-01,0,8,15,0,1,1,1,0.9,0.7879,0.27,0.0,52,77,129,129,3,Sore
5011,2011-08-01,0,8,16,0,1,1,1,0.9,0.7879,0.27,0.0,34,197,231,231,3,Sore
5012,2011-08-01,0,8,17,0,1,1,1,0.76,0.6818,0.45,0.2985,69,445,514,514,3,Sore
5013,2011-08-01,0,8,18,0,1,1,1,0.78,0.697,0.43,0.194,68,475,543,543,3,Sore
5014,2011-08-01,0,8,19,0,1,1,1,0.74,0.6667,0.51,0.2239,63,350,413,413,3,Malam
5015,2011-08-01,0,8,20,0,1,1,1,0.72,0.6818,0.62,0.2239,49,256,305,305,3,Malam
5016,2011-08-01,0,8,21,0,1,1,1,0.7,0.6515,0.7,0.2537,42,178,220,220,3,Malam
5017,2011-08-01,0,8,22,0,1,1,1,0.7,0.6515,0.7,0.0896,21,116,137,137,3,Malam
5018,2011-08-01,0,8,23,0,1,1,1,0.68,0.6364,0.74,0.194,14,82,96,96,3,Malam
5019,2011-08-02,0,8,0,0,2,1,1,0.66,0.6212,0.74,0.0,11,18,29,29,3,
5020,2011-08-02,0,8,1,0,2,1,1,0.66,0.6212,0.74,0.1045,4,8,12,12,3,Pagi
5021,2011-08-02,0,8,2,0,2,1,1,0.68,0.6364,0.69,0.0,2,6,8,8,3,Pagi
5022,2011-08-02,0,8,3,0,2,1,1,0.66,0.6212,0.74,0.194,0,5,5,5,3,Pagi
5023,2011-08-02,0,8,4,0,2,1,1,0.66,0.6212,0.74,0.1045,0,10,10,10,3,Pagi
5024,2011-08-02,0,8,5,0,2,1,1,0.66,0.6212,0.74,0.1343,4,17,21,21,3,Pagi
5025,2011-08-02,0,8,6,0,2,1,1,0.68,0.6364,0.69,0.1045,12,105,117,117,3,Pagi
5026,2011-08-02,0,8,7,0,2,1,1,0.72,0.6667,0.61,0.2836,15,320,335,335,3,Siang
5027,2011-08-02,0,8,8,0,2,1,1,0.74,0.6818,0.58,0.2836,37,398,435,435,3,Siang
5028,2011-08-02,0,8,9,0,2,1,1,0.78,0.697,0.46,0.2985,31,182,213,213,3,Siang
5029,2011-08-02,0,8,10,0,2,1,1,0.82,0.7273,0.36,0.2985,50,90,140,140,3,Siang
5030,2011-08-02,0,8,11,0,2,1,1,0.84,0.7273,0.32,0.4179,32,96,128,128,3,Siang
5031,2011-08-02,0,8,12,0,2,1,1,0.86,0.7424,0.3,0.2836,45,112,157,157,3,Siang
5032,2011-08-02,0,8,13,0,2,1,1,0.86,0.7424,0.3,0.2239,50,153,203,203,3,Sore
5033,2011-08-02,0,8,14,0,2,1,1,0.9,0.7727,0.25,0.2836,45,114,159,159,3,Sore
5034,2011-08-02,0,8,15,0,2,1,1,0.9,0.7727,0.25,0.2836,48,120,168,168,3,Sore
5035,2011-08-02,0,8,16,0,2,1,1,0.9,0.7727,0.25,0.2836,58,216,274,274,3,Sore
5036,2011-08-02,0,8,17,0,2,1,2,0.9,0.7879,0.27,0.1343,63,493,556,556,3,Sore
5037,2011-08-02,0,8,18,0,2,1,2,0.86,0.7576,0.34,0.194,65,491,556,556,3,Sore
5038,2011-08-02,0,8,19,0,2,1,2,0.86,0.7576,0.36,0.2239,85,369,454,454,3,Malam
5039,2011-08-02,0,8,20,0,2,1,2,0.82,0.7576,0.46,0.2537,40,248,288,288,3,Malam
5040,2011-08-02,0,8,21,0,2,1,1,0.8,0.7424,0.52,0.2239,53,201,254,254,3,Malam
5041,2011-08-02,0,8,22,0,2,1,2,0.78,0.7424,0.59,0.1642,22,169,191,191,3,Malam
5042,2011-08-02,0,8,23,0,2,1,2,0.8,0.7424,0.49,0.1642,29,103,132,132,3,Malam
5043,2011-08-03,0,8,0,0,3,1,2,0.8,0.7424,0.49,0.1642,11,32,43,43,3,
5044,2011-08-03,0,8,1,0,3,1,2,0.78,0.7121,0.52,0.1642,7,9,16,16,3,Pagi
5045,2011-08-03,0,8,2,0,3,1,2,0.78,0.7121,0.49,0.1642,2,9,11,11,3,Pagi
5046,2011-08-03,0,8,3,0,3,1,2,0.76,0.697,0.55,0.0896,0,4,4,4,3,Pagi
5047,2011-08-03,0,8,4,0,3,1,2,0.76,0.697,0.52,0.1642,0,7,7,7,3,Pagi
5048,2011-08-03,0,8,5,0,3,1,2,0.76,0.697,0.55,0.0896,2,22,24,24,3,Pagi
5049,2011-08-03,0,8,6,0,3,1,3,0.72,0.6818,0.66,0.4925,9,101,110,110,3,Pagi
5050,2011-08-03,0,8,7,0,3,1,2,0.74,0.6667,0.51,0.2239,19,252,271,271,3,Siang
5051,2011-08-03,0,8,8,0,3,1,2,0.74,0.6667,0.51,0.1642,29,408,437,437,3,Siang
5052,2011-08-03,0,8,9,0,3,1,2,0.74,0.6818,0.55,0.194,23,172,195,195,3,Siang
5053,2011-08-03,0,8,10,0,3,1,3,0.74,0.6818,0.58,0.0896,9,59,68,68,3,Siang
5054,2011-08-03,0,8,11,0,3,1,2,0.74,0.6818,0.58,0.1045,29,93,122,122,3,Siang
5055,2011-08-03,0,8,12,0,3,1,3,0.76,0.697,0.55,0.1343,19,142,161,161,3,Siang
5056,2011-08-03,0,8,13,0,3,1,2,0.76,0.7121,0.58,0.2239,37,107,144,144,3,Sore
5057,2011-08-03,0,8,14,0,3,1,2,0.76,0.7121,0.58,0.2239,43,104,147,147,3,Sore
5058,2011-08-03,0,8,15,0,3,1,2,0.7,0.6667,0.79,0.1343,31,87,118,118,3,Sore
5059,2011-08-03,0,8,16,0,3,1,3,0.68,0.6364,0.79,0.0,21,129,150,150,3,Sore
5060,2011-08-03,0,8,17,0,3,1,2,0.7,0.6667,0.79,0.0,47,378,425,425,3,Sore
5061,2011-08-03,0,8,18,0,3,1,3,0.7,0.6667,0.84,0.0,49,443,492,492,3,Sore
5062,2011-08-03,0,8,19,0,3,1,3,0.7,0.6667,0.84,0.0,51,270,321,321,3,Malam
5063,2011-08-03,0,8,20,0,3,1,3,0.7,0.6667,0.84,0.1045,7,80,87,87,3,Malam
5064,2011-08-03,0,8,21,0,3,1,2,0.68,0.6364,0.89,0.1343,7,81,88,88,3,Malam
5065,2011-08-03,0,8,22,0,3,1,3,0.68,0.6364,0.89,0.1045,11,66,77,77,3,Malam
5066,2011-08-03,0,8,23,0,3,1,2,0.68,0.6364,0.89,0.0896,4,52,56,56,3,Malam
5067,2011-08-04,0,8,0,0,4,1,2,0.68,0.6364,0.89,0.0896,2,15,17,17,3,
5068,2011-08-04,0,8,1,0,4,1,2,0.66,0.5909,0.94,0.0896,3,14,17,17,3,Pagi
5069,2011-08-04,0,8,2,0,4,1,2,0.66,0.5909,0.94,0.0896,2,5,7,7,3,Pagi
5070,2011-08-04,0,8,3,0,4,1,3,0.66,0.5909,0.94,0.0896,0,3,3,3,3,Pagi
5071,2011-08-04,0,8,4,0,4,1,2,0.68,0.6364,0.89,0.0,0,7,7,7,3,Pagi
5072,2011-08-04,0,8,5,0,4,1,2,0.68,0.6364,0.89,0.0,3,17,20,20,3,Pagi
5073,2011-08-04,0,8,6,0,4,1,2,0.68,0.6364,0.89,0.2985,7,90,97,97,3,Pagi
5074,2011-08-04,0,8,7,0,4,1,2,0.68,0.6364,0.89,0.2985,11,271,282,282,3,Siang
5075,2011-08-04,0,8,8,0,4,1,2,0.7,0.6515,0.82,0.3582,29,369,398,398,3,Siang
5076,2011-08-04,0,8,9,0,4,1,1,0.72,0.697,0.74,0.3284,25,162,187,187,3,Siang
5077,2011-08-04,0,8,10,0,4,1,1,0.72,0.6667,0.71,0.2985,24,89,113,113,3,Siang
5078,2011-08-04,0,8,11,0,4,1,2,0.74,0.697,0.66,0.2239,37,112,149,149,3,Siang
5079,2011-08-04,0,8,12,0,4,1,2,0.76,0.7121,0.62,0.2239,53,152,205,205,3,Siang
5080,2011-08-04,0,8,13,0,4,1,1,0.76,0.7121,0.58,0.0,63,142,205,205,3,Sore
5081,2011-08-04,0,8,14,0,4,1,1,0.8,0.7576,0.55,0.1642,53,114,167,167,3,Sore
5082,2011-08-04,0,8,15,0,4,1,1,0.8,0.7576,0.55,0.2537,50,115,165,165,3,Sore
5083,2011-08-04,0,8,16,0,4,1,1,0.76,0.7121,0.62,0.3284,70,220,290,290,3,Sore
5084,2011-08-04,0,8,17,0,4,1,1,0.76,0.7121,0.62,0.3284,91,464,555,555,3,Sore
5085,2011-08-04,0,8,18,0,4,1,1,0.7,0.6667,0.74,0.2985,88,435,523,523,3,Sore
5086,2011-08-04,0,8,19,0,4,1,1,0.7,0.6667,0.74,0.2836,65,301,366,366,3,Malam
5087,2011-08-04,0,8,20,0,4,1,2,0.7,0.6667,0.74,0.194,41,245,286,286,3,Malam
5088,2011-08-04,0,8,21,0,4,1,2,0.7,0.6667,0.74,0.194,25,186,211,211,3,Malam
5089,2011-08-04,0,8,22,0,4,1,1,0.68,0.6364,0.74,0.194,33,141,174,174,3,Malam
5090,2011-08-04,0,8,23,0,4,1,1,0.66,0.6212,0.74,0.1045,24,108,132,132,3,Malam
5091,2011-08-05,0,8,0,0,5,1,1,0.66,0.6212,0.74,0.1045,13,41,54,54,3,
5092,2011-08-05,0,8,1,0,5,1,1,0.64,0.5909,0.78,0.0896,3,16,19,19,3,Pagi
5093,2011-08-05,0,8,2,0,5,1,1,0.66,0.6212,0.69,0.0,5,14,19,19,3,Pagi
5094,2011-08-05,0,8,3,0,5,1,1,0.64,0.5909,0.78,0.0896,0,6,6,6,3,Pagi
5095,2011-08-05,0,8,4,0,5,1,1,0.64,0.5909,0.78,0.1343,1,6,7,7,3,Pagi
5096,2011-08-05,0,8,5,0,5,1,1,0.64,0.5909,0.78,0.0896,0,16,16,16,3,Pagi
5097,2011-08-05,0,8,6,0,5,1,1,0.64,0.5909,0.78,0.1343,7,94,101,101,3,Pagi
5098,2011-08-05,0,8,7,0,5,1,1,0.66,0.6061,0.78,0.1343,23,247,270,270,3,Siang
5099,2011-08-05,0,8,8,0,5,1,1,0.7,0.6515,0.65,0.2239,39,415,454,454,3,Siang
5100,2011-08-05,0,8,9,0,5,1,1,0.72,0.6667,0.58,0.1045,43,183,226,226,3,Siang
5101,2011-08-05,0,8,10,0,5,1,1,0.74,0.6818,0.55,0.1343,50,113,163,163,3,Siang
5102,2011-08-05,0,8,11,0,5,1,2,0.76,0.697,0.52,0.2537,44,103,147,147,3,Siang
5103,2011-08-05,0,8,12,0,5,1,1,0.76,0.697,0.52,0.2537,57,159,216,216,3,Siang
5104,2011-08-05,0,8,13,0,5,1,1,0.78,0.7121,0.52,0.2537,40,164,204,204,3,Sore
5105,2011-08-05,0,8,14,0,5,1,2,0.78,0.7121,0.52,0.2537,81,164,245,245,3,Sore
5106,2011-08-05,0,8,15,0,5,1,1,0.76,0.697,0.55,0.2537,50,160,210,210,3,Sore
5107,2011-08-05,0,8,16,0,5,1,1,0.8,0.7424,0.49,0.2537,76,254,330,330,3,Sore
5108,2011-08-05,0,8,17,0,5,1,1,0.78,0.7121,0.49,0.2985,84,466,550,550,3,Sore
5109,2011-08-05,0,8,18,0,5,1,1,0.76,0.697,0.52,0.2537,105,361,466,466,3,Sore
5110,2011-08-05,0,8,19,0,5,1,1,0.74,0.6818,0.55,0.2537,90,282,372,372,3,Malam
5111,2011-08-05,0,8,20,0,5,1,1,0.72,0.6667,0.58,0.2239,70,221,291,291,3,Malam
5112,2011-08-05,0,8,21,0,5,1,1,0.7,0.6515,0.65,0.194,54,119,173,173,3,Malam
5113,2011-08-05,0,8,22,0,5,1,1,0.7,0.6515,0.65,0.2239,51,137,188,188,3,Malam
5114,2011-08-05,0,8,23,0,5,1,1,0.68,0.6364,0.69,0.2239,37,102,139,139,3,Malam
5115,2011-08-06,0,8,0,0,6,0,1,0.66,0.6061,0.78,0.194,29,104,133,133,3,
5116,2011-08-06,0,8,1,0,6,0,1,0.66,0.6061,0.78,0.1642,17,50,67,67,3,Pagi
5117,2011-08-06,0,8,2,0,6,0,1,0.66,0.6061,0.78,0.2239,14,39,53,53,3,Pagi
5118,2011-08-06,0,8,3,0,6,0,2,0.66,0.6061,0.78,0.1642,14,28,42,42,3,Pagi
5119,2011-08-06,0,8,4,0,6,0,2,0.66,0.6061,0.83,0.1642,5,5,10,10,3,Pagi
5120,2011-08-06,0,8,5,0,6,0,1,0.64,0.5758,0.89,0.0896,2,4,6,6,3,Pagi
5121,2011-08-06,0,8,6,0,6,0,1,0.64,0.5758,0.89,0.1045,5,22,27,27,3,Pagi
5122,2011-08-06,0,8,7,0,6,0,1,0.68,0.6364,0.83,0.1642,14,49,63,63,3,Siang
5123,2011-08-06,0,8,8,0,6,0,1,0.68,0.6364,0.83,0.1642,27,94,121,121,3,Siang
5124,2011-08-06,0,8,9,0,6,0,1,0.74,0.697,0.7,0.2239,60,155,215,215,3,Siang
5125,2011-08-06,0,8,10,0,6,0,2,0.74,0.697,0.7,0.2836,91,199,290,290,3,Siang
5126,2011-08-06,0,8,11,0,6,0,1,0.78,0.7424,0.62,0.2239,138,211,349,349,3,Siang
5127,2011-08-06,0,8,12,0,6,0,1,0.8,0.7576,0.55,0.2239,130,252,382,382,3,Siang
5128,2011-08-06,0,8,13,0,6,0,2,0.8,0.7727,0.59,0.3284,176,265,441,441,3,Sore
5129,2011-08-06,0,8,14,0,6,0,1,0.82,0.7727,0.52,0.2537,176,204,380,380,3,Sore
5130,2011-08-06,0,8,15,0,6,0,2,0.84,0.803,0.53,0.2537,130,232,362,362,3,Sore
5131,2011-08-06,0,8,16,0,6,0,3,0.74,0.7121,0.79,0.1642,155,188,343,343,3,Sore
5132,2011-08-06,0,8,17,0,6,0,3,0.74,0.7121,0.79,0.1642,61,88,149,149,3,Sore
5133,2011-08-06,0,8,18,0,6,0,2,0.72,0.697,0.79,0.4478,81,130,211,211,3,Sore
5134,2011-08-06,0,8,19,0,6,0,3,0.72,0.7121,0.84,0.2537,57,114,171,171,3,Malam
5135,2011-08-06,0,8,20,0,6,0,3,0.72,0.697,0.79,0.2836,58,79,137,137,3,Malam
5136,2011-08-06,0,8,21,0,6,0,2,0.7,0.6667,0.84,0.3284,28,86,114,114,3,Malam
5137,2011-08-06,0,8,22,0,6,0,2,0.7,0.6667,0.84,0.3284,24,96,120,120,3,Malam
5138,2011-08-06,0,8,23,0,6,0,3,0.7,0.6667,0.84,0.2836,29,79,108,108,3,Malam
5139,2011-08-07,0,8,0,0,0,0,2,0.7,0.6667,0.84,0.2836,14,66,80,80,3,
5140,2011-08-07,0,8,1,0,0,0,2,0.7,0.6667,0.84,0.2537,10,63,73,73,3,Pagi
5141,2011-08-07,0,8,2,0,0,0,2,0.7,0.6667,0.84,0.2239,18,48,66,66,3,Pagi
5142,2011-08-07,0,8,3,0,0,0,2,0.7,0.6667,0.84,0.1343,9,23,32,32,3,Pagi
5143,2011-08-07,0,8,4,0,0,0,1,0.7,0.6667,0.84,0.1343,1,5,6,6,3,Pagi
5144,2011-08-07,0,8,5,0,0,0,1,0.7,0.6667,0.89,0.194,1,4,5,5,3,Pagi
5145,2011-08-07,0,8,6,0,0,0,1,0.7,0.6667,0.89,0.1642,3,10,13,13,3,Pagi
5146,2011-08-07,0,8,7,0,0,0,1,0.7,0.6667,0.84,0.194,11,28,39,39,3,Siang
5147,2011-08-07,0,8,8,0,0,0,1,0.72,0.697,0.79,0.194,23,66,89,89,3,Siang
5148,2011-08-07,0,8,9,0,0,0,1,0.76,0.7424,0.75,0.1045,82,102,184,184,3,Siang
5149,2011-08-07,0,8,10,0,0,0,1,0.8,0.803,0.66,0.1343,88,178,266,266,3,Siang
5150,2011-08-07,0,8,11,0,0,0,1,0.82,0.8333,0.63,0.0,113,156,269,269,3,Siang
5151,2011-08-07,0,8,12,0,0,0,1,0.9,0.8485,0.42,0.2985,161,209,370,370,3,Siang
5152,2011-08-07,0,8,13,0,0,0,1,0.9,0.8485,0.42,0.2985,118,206,324,324,3,Sore
5153,2011-08-07,0,8,14,0,0,0,1,0.86,0.803,0.47,0.194,130,192,322,322,3,Sore
5154,2011-08-07,0,8,15,0,0,0,3,0.72,0.697,0.74,0.2985,118,208,326,326,3,Sore
5155,2011-08-07,0,8,16,0,0,0,3,0.72,0.697,0.74,0.2985,74,119,193,193,3,Sore
5156,2011-08-07,0,8,17,0,0,0,3,0.74,0.7121,0.74,0.6418,63,131,194,194,3,Sore
5157,2011-08-07,0,8,18,0,0,0,1,0.72,0.697,0.74,0.0896,74,155,229,229,3,Sore
5158,2011-08-07,0,8,19,0,0,0,1,0.72,0.697,0.79,0.1642,68,160,228,228,3,Malam
5159,2011-08-07,0,8,20,0,0,0,1,0.72,0.7121,0.84,0.1343,50,133,183,183,3,Malam
5160,2011-08-07,0,8,21,0,0,0,1,0.72,0.7121,0.84,0.1045,36,100,136,136,3,Malam
5161,2011-08-07,0,8,22,0,0,0,1,0.7,0.6667,0.89,0.194,21,82,103,103,3,Malam
5162,2011-08-07,0,8,23,0,0,0,1,0.7,0.6667,0.79,0.1045,12,43,55,55,3,Malam
5163,2011-08-08,0,8,0,0,1,1,1,0.7,0.6667,0.79,0.1045,13,17,30,30,3,
5164,2011-08-08,0,8,1,0,1,1,1,0.68,0.6364,0.83,0.1343,4,8,12,12,3,Pagi
5165,2011-08-08,0,8,2,0,1,1,1,0.66,0.5909,0.89,0.0,4,3,7,7,3,Pagi
5166,2011-08-08,0,8,3,0,1,1,1,0.66,0.5909,0.89,0.0,1,0,1,1,3,Pagi
5167,2011-08-08,0,8,4,0,1,1,1,0.66,0.5909,0.89,0.1045,2,8,10,10,3,Pagi
5168,2011-08-08,0,8,5,0,1,1,1,0.7,0.6667,0.79,0.0896,1,14,15,15,3,Pagi
5169,2011-08-08,0,8,6,0,1,1,1,0.7,0.6515,0.65,0.2836,8,87,95,95,3,Pagi
5170,2011-08-08,0,8,7,0,1,1,1,0.72,0.6818,0.62,0.2985,18,249,267,267,3,Siang
5171,2011-08-08,0,8,8,0,1,1,1,0.74,0.6818,0.58,0.3284,29,320,349,349,3,Siang
5172,2011-08-08,0,8,9,0,1,1,1,0.76,0.697,0.55,0.3881,37,146,183,183,3,Siang
5173,2011-08-08,0,8,10,0,1,1,1,0.8,0.7424,0.52,0.3881,62,62,124,124,3,Siang
5174,2011-08-08,0,8,11,0,1,1,1,0.82,0.7424,0.48,0.3582,90,89,179,179,3,Siang
5175,2011-08-08,0,8,12,0,1,1,1,0.82,0.7576,0.46,0.2537,48,134,182,182,3,Siang
5176,2011-08-08,0,8,13,0,1,1,1,0.84,0.7576,0.44,0.2985,43,108,151,151,3,Sore
5177,2011-08-08,0,8,14,0,1,1,1,0.82,0.7424,0.43,0.2985,41,109,150,150,3,Sore
5178,2011-08-08,0,8,15,0,1,1,1,0.84,0.7576,0.41,0.2985,40,86,126,126,3,Sore
5179,2011-08-08,0,8,16,0,1,1,1,0.86,0.7727,0.39,0.2836,64,218,282,282,3,Sore
5180,2011-08-08,0,8,17,0,1,1,1,0.86,0.7727,0.39,0.1642,67,460,527,527,3,Sore
5181,2011-08-08,0,8,18,0,1,1,1,0.84,0.7576,0.41,0.1343,64,465,529,529,3,Sore
5182,2011-08-08,0,8,19,0,1,1,1,0.82,0.7424,0.43,0.1045,64,352,416,416,3,Malam
5183,2011-08-08,0,8,20,0,1,1,1,0.8,0.7576,0.55,0.0,71,215,286,286,3,Malam
5184,2011-08-08,0,8,21,0,1,1,1,0.76,0.7121,0.58,0.0896,30,156,186,186,3,Malam
5185,2011-08-08,0,8,22,0,1,1,1,0.76,0.7121,0.58,0.1045,26,121,147,147,3,Malam
5186,2011-08-08,0,8,23,0,1,1,1,0.74,0.697,0.66,0.1045,19,53,72,72,3,Malam
5187,2011-08-09,0,8,0,0,2,1,1,0.72,0.697,0.79,0.1343,10,25,35,35,3,
5188,2011-08-09,0,8,1,0,2,1,1,0.72,0.6818,0.66,0.0,5,9,14,14,3,Pagi
5189,2011-08-09,0,8,2,0,2,1,1,0.72,0.6818,0.7,0.0,9,3,12,12,3,Pagi
5190,2011-08-09,0,8,3,0,2,1,1,0.72,0.6818,0.62,0.0,0,3,3,3,3,Pagi
5191,2011-08-09,0,8,4,0,2,1,1,0.7,0.6667,0.74,0.0,1,6,7,7,3,Pagi
5192,2011-08-09,0,8,5,0,2,1,1,0.7,0.6515,0.65,0.0896,5,25,30,30,3,Pagi
5193,2011-08-09,0,8,6,0,2,1,1,0.72,0.6667,0.64,0.0,6,95,101,101,3,Pagi
5194,2011-08-09,0,8,7,0,2,1,1,0.72,0.697,0.74,0.1045,30,313,343,343,3,Siang
5195,2011-08-09,0,8,8,0,2,1,1,0.74,0.697,0.66,0.0,40,352,392,392,3,Siang
5196,2011-08-09,0,8,9,0,2,1,2,0.78,0.7424,0.62,0.1343,34,141,175,175,3,Siang
5197,2011-08-09,0,8,10,0,2,1,2,0.8,0.7727,0.59,0.2239,55,89,144,144,3,Siang
5198,2011-08-09,0,8,11,0,2,1,1,0.8,0.7727,0.59,0.2239,61,88,149,149,3,Siang
5199,2011-08-09,0,8,12,0,2,1,1,0.82,0.7879,0.56,0.194,60,125,185,185,3,Siang
5200,2011-08-09,0,8,13,0,2,1,1,0.84,0.7879,0.49,0.1642,48,127,175,175,3,Sore
5201,2011-08-09,0,8,14,0,2,1,1,0.86,0.7879,0.44,0.2836,53,95,148,148,3,Sore
5202,2011-08-09,0,8,15,0,2,1,1,0.86,0.7727,0.39,0.2836,58,106,164,164,3,Sore
5203,2011-08-09,0,8,16,0,2,1,1,0.86,0.7727,0.39,0.2985,57,228,285,285,3,Sore
5204,2011-08-09,0,8,17,0,2,1,1,0.8,0.7576,0.55,0.1642,79,453,532,532,3,Sore
5205,2011-08-09,0,8,18,0,2,1,1,0.8,0.7576,0.55,0.194,97,488,585,585,3,Sore
5206,2011-08-09,0,8,19,0,2,1,1,0.8,0.7424,0.49,0.1045,69,302,371,371,3,Malam
5207,2011-08-09,0,8,20,0,2,1,1,0.8,0.7273,0.43,0.194,34,258,292,292,3,Malam
5208,2011-08-09,0,8,21,0,2,1,1,0.78,0.697,0.46,0.2537,46,184,230,230,3,Malam
5209,2011-08-09,0,8,22,0,2,1,1,0.78,0.697,0.46,0.2985,28,127,155,155,3,Malam
5210,2011-08-09,0,8,23,0,2,1,1,0.76,0.6818,0.48,0.2836,22,53,75,75,3,Malam
5211,2011-08-10,0,8,0,0,3,1,1,0.74,0.6667,0.51,0.2239,19,18,37,37,3,
5212,2011-08-10,0,8,1,0,3,1,1,0.72,0.6667,0.54,0.194,7,10,17,17,3,Pagi
5213,2011-08-10,0,8,2,0,3,1,1,0.72,0.6667,0.54,0.1642,1,10,11,11,3,Pagi
5214,2011-08-10,0,8,3,0,3,1,1,0.7,0.6515,0.58,0.1642,1,3,4,4,3,Pagi
5215,2011-08-10,0,8,4,0,3,1,1,0.7,0.6515,0.54,0.1343,1,4,5,5,3,Pagi
5216,2011-08-10,0,8,5,0,3,1,1,0.68,0.6364,0.61,0.0896,2,30,32,32,3,Pagi
5217,2011-08-10,0,8,6,0,3,1,1,0.68,0.6364,0.61,0.0,9,110,119,119,3,Pagi
5218,2011-08-10,0,8,7,0,3,1,1,0.7,0.6515,0.58,0.0896,16,289,305,305,3,Siang
5219,2011-08-10,0,8,8,0,3,1,1,0.74,0.6667,0.51,0.194,38,361,399,399,3,Siang
5220,2011-08-10,0,8,9,0,3,1,1,0.76,0.6818,0.48,0.2239,32,148,180,180,3,Siang
5221,2011-08-10,0,8,10,0,3,1,1,0.8,0.7273,0.43,0.2239,41,72,113,113,3,Siang
5222,2011-08-10,0,8,11,0,3,1,1,0.8,0.7121,0.41,0.3881,54,95,149,149,3,Siang
5223,2011-08-10,0,8,12,0,3,1,1,0.82,0.7273,0.38,0.2985,74,166,240,240,3,Siang
5224,2011-08-10,0,8,13,0,3,1,1,0.82,0.7273,0.38,0.2836,41,150,191,191,3,Sore
5225,2011-08-10,0,8,14,0,3,1,1,0.84,0.7273,0.34,0.3284,62,116,178,178,3,Sore
5226,2011-08-10,0,8,15,0,3,1,1,0.86,0.7424,0.3,0.3284,53,141,194,194,3,Sore
5227,2011-08-10,0,8,16,0,3,1,1,0.86,0.7424,0.26,0.2985,76,206,282,282,3,Sore
5228,2011-08-10,0,8,17,0,3,1,1,0.84,0.7121,0.26,0.2985,71,513,584,584,3,Sore
5229,2011-08-10,0,8,18,0,3,1,1,0.82,0.7121,0.28,0.2985,70,489,559,559,3,Sore
5230,2011-08-10,0,8,19,0,3,1,1,0.8,0.697,0.26,0.2537,79,334,413,413,3,Malam
5231,2011-08-10,0,8,20,0,3,1,1,0.76,0.6667,0.31,0.1343,59,253,312,312,3,Malam
5232,2011-08-10,0,8,21,0,3,1,1,0.76,0.6667,0.33,0.1045,47,162,209,209,3,Malam
5233,2011-08-10,0,8,22,0,3,1,1,0.74,0.6515,0.37,0.0,17,122,139,139,3,Malam
5234,2011-08-10,0,8,23,0,3,1,1,0.74,0.6515,0.37,0.0896,14,94,108,108,3,Malam
5235,2011-08-11,0,8,0,0,4,1,1,0.7,0.6364,0.45,0.1045,6,40,46,46,3,
5236,2011-08-11,0,8,1,0,4,1,1,0.7,0.6364,0.45,0.1343,9,17,26,26,3,Pagi
5237,2011-08-11,0,8,2,0,4,1,1,0.66,0.6212,0.54,0.1343,3,8,11,11,3,Pagi
5238,2011-08-11,0,8,3,0,4,1,1,0.64,0.6212,0.57,0.1343,2,7,9,9,3,Pagi
5239,2011-08-11,0,8,4,0,4,1,1,0.64,0.6212,0.57,0.1642,1,4,5,5,3,Pagi
5240,2011-08-11,0,8,5,0,4,1,1,0.64,0.6212,0.61,0.194,2,23,25,25,3,Pagi
5241,2011-08-11,0,8,6,0,4,1,1,0.62,0.6061,0.65,0.1642,5,101,106,106,3,Pagi
5242,2011-08-11,0,8,7,0,4,1,1,0.66,0.6212,0.54,0.1343,15,292,307,307,3,Siang
5243,2011-08-11,0,8,8,0,4,1,1,0.7,0.6364,0.45,0.1642,29,361,390,390,3,Siang
5244,2011-08-11,0,8,9,0,4,1,1,0.72,0.6515,0.39,0.2239,31,166,197,197,3,Siang
5245,2011-08-11,0,8,10,0,4,1,1,0.74,0.6515,0.37,0.2537,36,96,132,132,3,Siang
5246,2011-08-11,0,8,11,0,4,1,1,0.76,0.6667,0.35,0.2537,59,128,187,187,3,Siang
5247,2011-08-11,0,8,12,0,4,1,1,0.78,0.6818,0.31,0.2537,50,164,214,214,3,Siang
5248,2011-08-11,0,8,13,0,4,1,1,0.76,0.6667,0.31,0.2239,51,166,217,217,3,Sore
5249,2011-08-11,0,8,14,0,4,1,1,0.8,0.697,0.29,0.0,39,103,142,142,3,Sore
5250,2011-08-11,0,8,15,0,4,1,1,0.8,0.697,0.29,0.2985,52,126,178,178,3,Sore
5251,2011-08-11,0,8,16,0,4,1,1,0.8,0.697,0.27,0.194,57,241,298,298,3,Sore
5252,2011-08-11,0,8,17,0,4,1,1,0.8,0.697,0.29,0.2537,96,486,582,582,3,Sore
5253,2011-08-11,0,8,18,0,4,1,1,0.78,0.6818,0.29,0.0896,74,497,571,571,3,Sore
5254,2011-08-11,0,8,19,0,4,1,1,0.74,0.6515,0.35,0.194,48,323,371,371,3,Malam
5255,2011-08-11,0,8,20,0,4,1,1,0.72,0.6515,0.37,0.1343,56,232,288,288,3,Malam
5256,2011-08-11,0,8,21,0,4,1,1,0.7,0.6515,0.48,0.0896,35,171,206,206,3,Malam
5257,2011-08-11,0,8,22,0,4,1,1,0.7,0.6515,0.48,0.0,34,123,157,157,3,Malam
5258,2011-08-11,0,8,23,0,4,1,1,0.66,0.6212,0.5,0.1642,22,105,127,127,3,Malam
5259,2011-08-12,0,8,0,0,5,1,1,0.64,0.6212,0.53,0.1642,12,53,65,65,3,
5260,2011-08-12,0,8,1,0,5,1,1,0.64,0.6212,0.53,0.1343,4,19,23,23,3,Pagi
5261,2011-08-12,0,8,2,0,5,1,1,0.62,0.6212,0.57,0.194,0,15,15,15,3,Pagi
5262,2011-08-12,0,8,3,0,5,1,1,0.62,0.6212,0.53,0.1642,0,9,9,9,3,Pagi
5263,2011-08-12,0,8,4,0,5,1,1,0.62,0.6212,0.53,0.1343,0,5,5,5,3,Pagi
5264,2011-08-12,0,8,5,0,5,1,1,0.6,0.6212,0.56,0.1343,2,24,26,26,3,Pagi
5265,2011-08-12,0,8,6,0,5,1,1,0.62,0.6212,0.5,0.1343,3,73,76,76,3,Pagi
5266,2011-08-12,0,8,7,0,5,1,1,0.64,0.6212,0.44,0.1642,17,247,264,264,3,Siang
5267,2011-08-12,0,8,8,0,5,1,1,0.68,0.6364,0.39,0.2239,29,397,426,426,3,Siang
5268,2011-08-12,0,8,9,0,5,1,1,0.72,0.6515,0.34,0.1343,27,178,205,205,3,Siang
5269,2011-08-12,0,8,10,0,5,1,1,0.74,0.6515,0.33,0.1045,44,86,130,130,3,Siang
5270,2011-08-12,0,8,11,0,5,1,1,0.76,0.6667,0.29,0.0,48,108,156,156,3,Siang
5271,2011-08-12,0,8,12,0,5,1,1,0.8,0.697,0.27,0.0,55,167,222,222,3,Siang
5272,2011-08-12,0,8,13,0,5,1,1,0.78,0.6818,0.29,0.0896,74,179,253,253,3,Sore
5273,2011-08-12,0,8,14,0,5,1,1,0.8,0.697,0.29,0.194,51,135,186,186,3,Sore
5274,2011-08-12,0,8,15,0,5,1,1,0.8,0.697,0.29,0.1642,59,190,249,249,3,Sore
5275,2011-08-12,0,8,16,0,5,1,1,0.82,0.7121,0.28,0.0,68,266,334,334,3,Sore
5276,2011-08-12,0,8,17,0,5,1,1,0.82,0.7121,0.26,0.0,93,423,516,516,3,Sore
5277,2011-08-12,0,8,18,0,5,1,1,0.76,0.6818,0.4,0.2985,89,376,465,465,3,Sore
5278,2011-08-12,0,8,19,0,5,1,1,0.74,0.6667,0.42,0.2239,101,284,385,385,3,Malam
5279,2011-08-12,0,8,20,0,5,1,1,0.72,0.6515,0.42,0.2239,77,210,287,287,3,Malam
5280,2011-08-12,0,8,21,0,5,1,1,0.7,0.6515,0.48,0.1343,73,153,226,226,3,Malam
5281,2011-08-12,0,8,22,0,5,1,1,0.68,0.6364,0.51,0.0,74,157,231,231,3,Malam
5282,2011-08-12,0,8,23,0,5,1,1,0.68,0.6364,0.51,0.0,51,100,151,151,3,Malam
5283,2011-08-13,0,8,0,0,6,0,1,0.68,0.6364,0.51,0.1045,15,69,84,84,3,
5284,2011-08-13,0,8,1,0,6,0,2,0.68,0.6364,0.57,0.0896,13,64,77,77,3,Pagi
5285,2011-08-13,0,8,2,0,6,0,1,0.68,0.6364,0.57,0.0,16,58,74,74,3,Pagi
5286,2011-08-13,0,8,3,0,6,0,1,0.66,0.6212,0.65,0.1343,9,18,27,27,3,Pagi
5287,2011-08-13,0,8,4,0,6,0,2,0.64,0.6061,0.73,0.1343,5,5,10,10,3,Pagi
5288,2011-08-13,0,8,5,0,6,0,1,0.64,0.6061,0.73,0.1045,3,15,18,18,3,Pagi
5289,2011-08-13,0,8,6,0,6,0,1,0.64,0.6061,0.73,0.0896,3,19,22,22,3,Pagi
5290,2011-08-13,0,8,7,0,6,0,2,0.66,0.6212,0.74,0.194,10,34,44,44,3,Siang
5291,2011-08-13,0,8,8,0,6,0,2,0.7,0.6515,0.65,0.1642,28,90,118,118,3,Siang
5292,2011-08-13,0,8,9,0,6,0,2,0.7,0.6667,0.74,0.1642,70,138,208,208,3,Siang
5293,2011-08-13,0,8,10,0,6,0,2,0.72,0.697,0.74,0.2239,97,163,260,260,3,Siang
5294,2011-08-13,0,8,11,0,6,0,2,0.74,0.697,0.7,0.194,122,192,314,314,3,Siang
5295,2011-08-13,0,8,12,0,6,0,2,0.66,0.5909,0.89,0.1642,175,246,421,421,3,Siang
5296,2011-08-13,0,8,13,0,6,0,2,0.74,0.7121,0.74,0.3284,61,92,153,153,3,Sore
5297,2011-08-13,0,8,14,0,6,0,1,0.74,0.697,0.7,0.2537,113,146,259,259,3,Sore
5298,2011-08-13,0,8,15,0,6,0,3,0.68,0.6364,0.79,0.3582,150,208,358,358,3,Sore
5299,2011-08-13,0,8,16,0,6,0,2,0.7,0.6667,0.74,0.2836,148,133,281,281,3,Sore
5300,2011-08-13,0,8,17,0,6,0,2,0.72,0.697,0.74,0.2537,97,172,269,269,3,Sore
5301,2011-08-13,0,8,18,0,6,0,1,0.7,0.6667,0.74,0.2239,123,169,292,292,3,Sore
5302,2011-08-13,0,8,19,0,6,0,2,0.68,0.6364,0.79,0.2836,67,170,237,237,3,Malam
5303,2011-08-13,0,8,20,0,6,0,2,0.68,0.6364,0.83,0.2239,78,105,183,183,3,Malam
5304,2011-08-13,0,8,21,0,6,0,2,0.68,0.6364,0.83,0.3881,40,127,167,167,3,Malam
5305,2011-08-13,0,8,22,0,6,0,2,0.68,0.6364,0.83,0.3881,36,118,154,154,3,Malam
5306,2011-08-13,0,8,23,0,6,0,2,0.66,0.6061,0.83,0.3284,25,95,120,120,3,Malam
5307,2011-08-14,0,8,0,0,0,0,3,0.66,0.6061,0.83,0.2985,19,71,90,90,3,
5308,2011-08-14,0,8,1,0,0,0,3,0.64,0.5758,0.89,0.2239,16,57,73,73,3,Pagi
5309,2011-08-14,0,8,2,0,0,0,3,0.64,0.5758,0.89,0.2239,13,49,62,62,3,Pagi
5310,2011-08-14,0,8,3,0,0,0,2,0.64,0.5606,0.94,0.2537,5,22,27,27,3,Pagi
5311,2011-08-14,0,8,4,0,0,0,3,0.64,0.5606,0.94,0.194,1,2,3,3,3,Pagi
5312,2011-08-14,0,8,5,0,0,0,2,0.64,0.5606,0.94,0.1642,1,9,10,10,3,Pagi
5313,2011-08-14,0,8,6,0,0,0,2,0.64,0.5606,0.94,0.1045,2,4,6,6,3,Pagi
5314,2011-08-14,0,8,7,0,0,0,2,0.66,0.5909,0.89,0.194,4,20,24,24,3,Siang
5315,2011-08-14,0,8,8,0,0,0,2,0.66,0.5909,0.89,0.2836,20,21,41,41,3,Siang
5316,2011-08-14,0,8,9,0,0,0,3,0.66,0.5909,0.89,0.2836,27,76,103,103,3,Siang
5317,2011-08-14,0,8,10,0,0,0,1,0.7,0.6667,0.79,0.2239,67,116,183,183,3,Siang
5318,2011-08-14,0,8,11,0,0,0,1,0.7,0.6667,0.79,0.194,81,117,198,198,3,Siang
5319,2011-08-14,0,8,12,0,0,0,2,0.7,0.6667,0.79,0.2239,98,183,281,281,3,Siang
5320,2011-08-14,0,8,13,0,0,0,1,0.72,0.697,0.74,0.2537,144,233,377,377,3,Sore
5321,2011-08-14,0,8,14,0,0,0,1,0.74,0.697,0.7,0.194,126,244,370,370,3,Sore
5322,2011-08-14,0,8,15,0,0,0,1,0.74,0.697,0.66,0.194,128,203,331,331,3,Sore
5323,2011-08-14,0,8,16,0,0,0,1,0.74,0.697,0.66,0.1642,116,176,292,292,3,Sore
5324,2011-08-14,0,8,17,0,0,0,1,0.76,0.7121,0.62,0.1343,133,196,329,329,3,Sore
5325,2011-08-14,0,8,18,0,0,0,1,0.74,0.697,0.66,0.1642,125,222,347,347,3,Sore
5326,2011-08-14,0,8,19,0,0,0,1,0.72,0.697,0.74,0.2239,75,184,259,259,3,Malam
5327,2011-08-14,0,8,20,0,0,0,1,0.7,0.6667,0.84,0.1642,67,126,193,193,3,Malam
5328,2011-08-14,0,8,21,0,0,0,3,0.6,0.5455,0.88,0.4925,51,104,155,155,3,Malam
5329,2011-08-14,0,8,22,0,0,0,3,0.6,0.5455,0.88,0.4925,14,25,39,39,3,Malam
5330,2011-08-14,0,8,23,0,0,0,3,0.6,0.5606,0.83,0.0,5,22,27,27,3,Malam
5331,2011-08-15,0,8,0,0,1,1,3,0.6,0.5455,0.88,0.0896,7,18,25,25,3,
5332,2011-08-15,0,8,1,0,1,1,2,0.6,0.5455,0.88,0.1343,1,9,10,10,3,Pagi
5333,2011-08-15,0,8,2,0,1,1,2,0.6,0.5606,0.83,0.0,0,3,3,3,3,Pagi
5334,2011-08-15,0,8,3,0,1,1,1,0.6,0.5606,0.83,0.194,1,6,7,7,3,Pagi
5335,2011-08-15,0,8,4,0,1,1,1,0.6,0.5606,0.83,0.1343,1,4,5,5,3,Pagi
5336,2011-08-15,0,8,5,0,1,1,2,0.6,0.5455,0.88,0.194,3,14,17,17,3,Pagi
5337,2011-08-15,0,8,6,0,1,1,1,0.6,0.5455,0.88,0.2537,3,87,90,90,3,Pagi
5338,2011-08-15,0,8,7,0,1,1,1,0.6,0.5455,0.88,0.2537,10,248,258,258,3,Siang
5339,2011-08-15,0,8,8,0,1,1,1,0.64,0.5909,0.78,0.3284,29,326,355,355,3,Siang
5340,2011-08-15,0,8,9,0,1,1,1,0.64,0.5909,0.78,0.3284,52,170,222,222,3,Siang
5341,2011-08-15,0,8,10,0,1,1,1,0.68,0.6364,0.69,0.2836,54,87,141,141,3,Siang
5342,2011-08-15,0,8,11,0,1,1,2,0.72,0.6818,0.62,0.2537,41,112,153,153,3,Siang
5343,2011-08-15,0,8,12,0,1,1,1,0.74,0.6818,0.58,0.2836,62,116,178,178,3,Siang
5344,2011-08-15,0,8,13,0,1,1,1,0.78,0.7121,0.52,0.2836,53,140,193,193,3,Sore
5345,2011-08-15,0,8,14,0,1,1,1,0.74,0.6818,0.55,0.0896,56,95,151,151,3,Sore
5346,2011-08-15,0,8,15,0,1,1,3,0.74,0.6818,0.55,0.2985,49,133,182,182,3,Sore
5347,2011-08-15,0,8,16,0,1,1,1,0.74,0.6818,0.55,0.3284,58,225,283,283,3,Sore
5348,2011-08-15,0,8,17,0,1,1,1,0.74,0.6667,0.51,0.2836,59,471,530,530,3,Sore
5349,2011-08-15,0,8,18,0,1,1,1,0.7,0.6515,0.65,0.194,70,413,483,483,3,Sore
5350,2011-08-15,0,8,19,0,1,1,1,0.7,0.6515,0.65,0.0,54,343,397,397,3,Malam
5351,2011-08-15,0,8,20,0,1,1,1,0.66,0.6212,0.74,0.1343,45,240,285,285,3,Malam
5352,2011-08-15,0,8,21,0,1,1,1,0.66,0.6212,0.65,0.194,34,150,184,184,3,Malam
5353,2011-08-15,0,8,22,0,1,1,1,0.66,0.6212,0.69,0.2537,22,76,98,98,3,Malam
5354,2011-08-15,0,8,23,0,1,1,1,0.64,0.6061,0.69,0.2239,11,77,88,88,3,Malam
5355,2011-08-16,0,8,0,0,2,1,1,0.64,0.6061,0.69,0.1045,8,23,31,31,3,
5356,2011-08-16,0,8,1,0,2,1,1,0.64,0.6061,0.69,0.1642,4,12,16,16,3,Pagi
5357,2011-08-16,0,8,2,0,2,1,1,0.62,0.5909,0.73,0.2239,1,3,4,4,3,Pagi
5358,2011-08-16,0,8,3,0,2,1,1,0.62,0.5909,0.73,0.2239,1,5,6,6,3,Pagi
5359,2011-08-16,0,8,4,0,2,1,1,0.64,0.6061,0.69,0.2985,0,5,5,5,3,Pagi
5360,2011-08-16,0,8,5,0,2,1,1,0.62,0.5909,0.73,0.2836,1,29,30,30,3,Pagi
5361,2011-08-16,0,8,6,0,2,1,1,0.62,0.5909,0.73,0.3284,4,115,119,119,3,Pagi
5362,2011-08-16,0,8,7,0,2,1,1,0.64,0.6061,0.69,0.2537,18,328,346,346,3,Siang
5363,2011-08-16,0,8,8,0,2,1,1,0.7,0.6515,0.58,0.4478,24,417,441,441,3,Siang
5364,2011-08-16,0,8,9,0,2,1,1,0.68,0.6364,0.61,0.2836,27,171,198,198,3,Siang
5365,2011-08-16,0,8,10,0,2,1,1,0.7,0.6515,0.58,0.3881,28,83,111,111,3,Siang
5366,2011-08-16,0,8,11,0,2,1,1,0.74,0.6667,0.51,0.2239,40,110,150,150,3,Siang
5367,2011-08-16,0,8,12,0,2,1,1,0.76,0.6818,0.48,0.3284,42,120,162,162,3,Siang
5368,2011-08-16,0,8,13,0,2,1,1,0.76,0.6818,0.48,0.2985,45,147,192,192,3,Sore
5369,2011-08-16,0,8,14,0,2,1,1,0.76,0.6818,0.45,0.4179,65,117,182,182,3,Sore
5370,2011-08-16,0,8,15,0,2,1,1,0.8,0.7121,0.41,0.2985,36,123,159,159,3,Sore
5371,2011-08-16,0,8,16,0,2,1,1,0.8,0.7121,0.41,0.2239,55,248,303,303,3,Sore
5372,2011-08-16,0,8,17,0,2,1,1,0.76,0.6818,0.45,0.3284,75,525,600,600,3,Sore
5373,2011-08-16,0,8,18,0,2,1,1,0.76,0.6818,0.45,0.2239,54,516,570,570,3,Sore
5374,2011-08-16,0,8,19,0,2,1,1,0.74,0.6667,0.48,0.194,56,320,376,376,3,Malam
5375,2011-08-16,0,8,20,0,2,1,1,0.74,0.6667,0.51,0.0,48,232,280,280,3,Malam
5376,2011-08-16,0,8,21,0,2,1,1,0.72,0.6667,0.54,0.0,38,177,215,215,3,Malam
5377,2011-08-16,0,8,22,0,2,1,1,0.7,0.6515,0.61,0.0,31,121,152,152,3,Malam
5378,2011-08-16,0,8,23,0,2,1,1,0.66,0.6212,0.65,0.1343,20,57,77,77,3,Malam
5379,2011-08-17,0,8,0,0,3,1,1,0.66,0.6212,0.69,0.0896,8,16,24,24,3,
5380,2011-08-17,0,8,1,0,3,1,1,0.64,0.6061,0.73,0.1642,2,12,14,14,3,Pagi
5381,2011-08-17,0,8,2,0,3,1,1,0.66,0.6212,0.69,0.0,0,6,6,6,3,Pagi
5382,2011-08-17,0,8,3,0,3,1,1,0.64,0.5909,0.78,0.0,1,4,5,5,3,Pagi
5383,2011-08-17,0,8,4,0,3,1,1,0.64,0.6061,0.73,0.0,0,5,5,5,3,Pagi
5384,2011-08-17,0,8,5,0,3,1,1,0.64,0.6061,0.73,0.0,0,28,28,28,3,Pagi
5385,2011-08-17,0,8,6,0,3,1,1,0.62,0.5909,0.78,0.0,4,101,105,105,3,Pagi
5386,2011-08-17,0,8,7,0,3,1,1,0.66,0.6212,0.65,0.0896,12,296,308,308,3,Siang
5387,2011-08-17,0,8,8,0,3,1,1,0.7,0.6515,0.54,0.1642,35,452,487,487,3,Siang
5388,2011-08-17,0,8,9,0,3,1,1,0.74,0.6667,0.48,0.0896,31,178,209,209,3,Siang
5389,2011-08-17,0,8,10,0,3,1,1,0.76,0.6818,0.43,0.0896,27,91,118,118,3,Siang
5390,2011-08-17,0,8,11,0,3,1,1,0.78,0.697,0.43,0.1045,20,108,128,128,3,Siang
5391,2011-08-17,0,8,12,0,3,1,1,0.8,0.7273,0.43,0.2836,26,163,189,189,3,Siang
5392,2011-08-17,0,8,13,0,3,1,1,0.8,0.7121,0.41,0.194,38,138,176,176,3,Sore
5393,2011-08-17,0,8,14,0,3,1,1,0.82,0.7273,0.36,0.1642,54,138,192,192,3,Sore
5394,2011-08-17,0,8,15,0,3,1,1,0.8,0.7273,0.43,0.1343,42,117,159,159,3,Sore
5395,2011-08-17,0,8,16,0,3,1,1,0.82,0.7424,0.43,0.2239,62,238,300,300,3,Sore
5396,2011-08-17,0,8,17,0,3,1,1,0.8,0.7424,0.49,0.2239,46,506,552,552,3,Sore
5397,2011-08-17,0,8,18,0,3,1,1,0.76,0.697,0.55,0.2537,86,470,556,556,3,Sore
5398,2011-08-17,0,8,19,0,3,1,1,0.76,0.697,0.55,0.2239,50,297,347,347,3,Malam
5399,2011-08-17,0,8,20,0,3,1,1,0.74,0.6818,0.58,0.2537,37,243,280,280,3,Malam
5400,2011-08-17,0,8,21,0,3,1,1,0.72,0.6818,0.62,0.2239,38,192,230,230,3,Malam
5401,2011-08-17,0,8,22,0,3,1,1,0.7,0.6515,0.65,0.194,29,142,171,171,3,Malam
5402,2011-08-17,0,8,23,0,3,1,1,0.7,0.6515,0.65,0.2836,20,85,105,105,3,Malam
5403,2011-08-18,0,8,0,0,4,1,1,0.68,0.6364,0.65,0.1343,18,38,56,56,3,
5404,2011-08-18,0,8,1,0,4,1,2,0.66,0.6212,0.65,0.1642,13,11,24,24,3,Pagi
5405,2011-08-18,0,8,2,0,4,1,1,0.66,0.6212,0.65,0.2239,2,4,6,6,3,Pagi
5406,2011-08-18,0,8,3,0,4,1,1,0.66,0.6212,0.69,0.2836,0,6,6,6,3,Pagi
5407,2011-08-18,0,8,4,0,4,1,1,0.64,0.6061,0.73,0.2239,0,9,9,9,3,Pagi
5408,2011-08-18,0,8,5,0,4,1,1,0.64,0.5909,0.78,0.2836,0,27,27,27,3,Pagi
5409,2011-08-18,0,8,6,0,4,1,2,0.64,0.5909,0.78,0.2537,6,97,103,103,3,Pagi
5410,2011-08-18,0,8,7,0,4,1,1,0.64,0.5909,0.78,0.2985,19,289,308,308,3,Siang
5411,2011-08-18,0,8,8,0,4,1,1,0.66,0.6212,0.74,0.2836,27,393,420,420,3,Siang
5412,2011-08-18,0,8,9,0,4,1,1,0.72,0.6818,0.66,0.2537,42,186,228,228,3,Siang
5413,2011-08-18,0,8,10,0,4,1,1,0.74,0.697,0.66,0.2537,37,92,129,129,3,Siang
5414,2011-08-18,0,8,11,0,4,1,1,0.76,0.7121,0.58,0.2537,44,97,141,141,3,Siang
5415,2011-08-18,0,8,12,0,4,1,1,0.8,0.7424,0.52,0.2836,34,139,173,173,3,Siang
5416,2011-08-18,0,8,13,0,4,1,1,0.8,0.7424,0.52,0.3582,33,154,187,187,3,Sore
5417,2011-08-18,0,8,14,0,4,1,1,0.82,0.7576,0.46,0.3284,67,115,182,182,3,Sore
5418,2011-08-18,0,8,15,0,4,1,1,0.8,0.7273,0.46,0.3582,56,118,174,174,3,Sore
5419,2011-08-18,0,8,16,0,4,1,1,0.8,0.7273,0.46,0.3582,49,196,245,245,3,Sore
5420,2011-08-18,0,8,17,0,4,1,3,0.8,0.7273,0.46,0.2985,44,365,409,409,3,Sore
5421,2011-08-18,0,8,18,0,4,1,3,0.76,0.697,0.55,0.2537,48,226,274,274,3,Sore
5422,2011-08-18,0,8,19,0,4,1,1,0.66,0.6061,0.83,0.1045,26,115,141,141,3,Malam
5423,2011-08-18,0,8,20,0,4,1,1,0.66,0.6061,0.83,0.1045,24,141,165,165,3,Malam
5424,2011-08-18,0,8,21,0,4,1,2,0.68,0.6364,0.79,0.0,12,137,149,149,3,Malam
5425,2011-08-18,0,8,22,0,4,1,2,0.7,0.6667,0.74,0.1045,18,117,135,135,3,Malam
5426,2011-08-18,0,8,23,0,4,1,2,0.7,0.6667,0.74,0.1343,20,94,114,114,3,Malam
5427,2011-08-19,0,8,0,0,5,1,3,0.68,0.6364,0.69,0.194,9,53,62,62,3,
5428,2011-08-19,0,8,1,0,5,1,3,0.64,0.5758,0.89,0.0,1,19,20,20,3,Pagi
5429,2011-08-19,0,8,2,0,5,1,3,0.64,0.5758,0.83,0.0,0,8,8,8,3,Pagi
5430,2011-08-19,0,8,3,0,5,1,1,0.64,0.5909,0.78,0.0,2,1,3,3,3,Pagi
5431,2011-08-19,0,8,4,0,5,1,1,0.64,0.5758,0.83,0.0,1,7,8,8,3,Pagi
5432,2011-08-19,0,8,5,0,5,1,1,0.64,0.5758,0.83,0.0,1,16,17,17,3,Pagi
5433,2011-08-19,0,8,6,0,5,1,1,0.64,0.5758,0.83,0.0,2,91,93,93,3,Pagi
5434,2011-08-19,0,8,7,0,5,1,2,0.66,0.6061,0.83,0.0896,12,251,263,263,3,Siang
5435,2011-08-19,0,8,8,0,5,1,2,0.66,0.6061,0.83,0.0,30,368,398,398,3,Siang
5436,2011-08-19,0,8,9,0,5,1,1,0.7,0.6515,0.65,0.1343,31,187,218,218,3,Siang
5437,2011-08-19,0,8,10,0,5,1,1,0.72,0.6818,0.62,0.0896,57,108,165,165,3,Siang
5438,2011-08-19,0,8,11,0,5,1,2,0.72,0.6818,0.66,0.0896,45,120,165,165,3,Siang
5439,2011-08-19,0,8,12,0,5,1,2,0.74,0.6818,0.62,0.0896,54,168,222,222,3,Siang
5440,2011-08-19,0,8,13,0,5,1,2,0.76,0.7121,0.62,0.194,63,169,232,232,3,Sore
5441,2011-08-19,0,8,14,0,5,1,1,0.78,0.7273,0.55,0.194,78,142,220,220,3,Sore
5442,2011-08-19,0,8,15,0,5,1,1,0.8,0.7424,0.49,0.1045,66,156,222,222,3,Sore
5443,2011-08-19,0,8,16,0,5,1,1,0.8,0.7424,0.49,0.0,66,261,327,327,3,Sore
5444,2011-08-19,0,8,17,0,5,1,1,0.76,0.7121,0.58,0.5224,85,442,527,527,3,Sore
5445,2011-08-19,0,8,18,0,5,1,1,0.76,0.7121,0.58,0.5224,88,337,425,425,3,Sore
5446,2011-08-19,0,8,19,0,5,1,3,0.62,0.5909,0.73,0.4627,33,132,165,165,3,Malam
5447,2011-08-19,0,8,20,0,5,1,3,0.62,0.5758,0.83,0.2985,12,46,58,58,3,Malam
5448,2011-08-19,0,8,21,0,5,1,1,0.62,0.5758,0.83,0.1343,18,89,107,107,3,Malam
5449,2011-08-19,0,8,22,0,5,1,1,0.6,0.5455,0.88,0.1343,25,97,122,122,3,Malam
5450,2011-08-19,0,8,23,0,5,1,2,0.6,0.5455,0.88,0.0896,18,88,106,106,3,Malam
5451,2011-08-20,0,8,0,0,6,0,1,0.6,0.5455,0.88,0.0,21,107,128,128,3,
5452,2011-08-20,0,8,1,0,6,0,1,0.62,0.5758,0.83,0.0,12,35,47,47,3,Pagi
5453,2011-08-20,0,8,2,0,6,0,1,0.62,0.5909,0.78,0.0,10,59,69,69,3,Pagi
5454,2011-08-20,0,8,3,0,6,0,1,0.62,0.5909,0.78,0.0,9,42,51,51,3,Pagi
5455,2011-08-20,0,8,4,0,6,0,2,0.6,0.5455,0.88,0.0,1,6,7,7,3,Pagi
5456,2011-08-20,0,8,5,0,6,0,1,0.6,0.5606,0.83,0.0,0,8,8,8,3,Pagi
5457,2011-08-20,0,8,6,0,6,0,2,0.6,0.5606,0.83,0.1343,6,18,24,24,3,Pagi
5458,2011-08-20,0,8,7,0,6,0,1,0.62,0.5758,0.83,0.0,8,36,44,44,3,Siang
5459,2011-08-20,0,8,8,0,6,0,1,0.66,0.6212,0.69,0.0,27,106,133,133,3,Siang
5460,2011-08-20,0,8,9,0,6,0,1,0.7,0.6515,0.65,0.0,51,139,190,190,3,Siang
5461,2011-08-20,0,8,10,0,6,0,1,0.72,0.6818,0.62,0.1045,114,192,306,306,3,Siang
5462,2011-08-20,0,8,11,0,6,0,1,0.72,0.6667,0.58,0.0,115,223,338,338,3,Siang
5463,2011-08-20,0,8,12,0,6,0,1,0.74,0.6818,0.58,0.1343,156,253,409,409,3,Siang
5464,2011-08-20,0,8,13,0,6,0,1,0.76,0.697,0.55,0.1343,158,220,378,378,3,Sore
5465,2011-08-20,0,8,14,0,6,0,1,0.8,0.7424,0.49,0.194,147,228,375,375,3,Sore
5466,2011-08-20,0,8,15,0,6,0,1,0.8,0.7273,0.43,0.194,175,215,390,390,3,Sore
5467,2011-08-20,0,8,16,0,6,0,1,0.8,0.7273,0.46,0.194,151,222,373,373,3,Sore
5468,2011-08-20,0,8,17,0,6,0,1,0.8,0.7424,0.49,0.194,180,203,383,383,3,Sore
5469,2011-08-20,0,8,18,0,6,0,1,0.76,0.7121,0.58,0.2537,169,225,394,394,3,Sore
5470,2011-08-20,0,8,19,0,6,0,1,0.74,0.6818,0.62,0.194,109,182,291,291,3,Malam
5471,2011-08-20,0,8,20,0,6,0,1,0.74,0.6818,0.62,0.2239,78,170,248,248,3,Malam
5472,2011-08-20,0,8,21,0,6,0,1,0.72,0.6818,0.7,0.2239,81,144,225,225,3,Malam
5473,2011-08-20,0,8,22,0,6,0,2,0.7,0.6667,0.74,0.194,77,146,223,223,3,Malam
5474,2011-08-20,0,8,23,0,6,0,1,0.7,0.6667,0.74,0.1343,59,98,157,157,3,Malam
5475,2011-08-21,0,8,0,0,0,0,1,0.7,0.6667,0.74,0.194,6,68,74,74,3,
5476,2011-08-21,0,8,1,0,0,0,1,0.68,0.6364,0.79,0.2239,17,69,86,86,3,Pagi
5477,2011-08-21,0,8,2,0,0,0,1,0.68,0.6364,0.79,0.194,13,51,64,64,3,Pagi
5478,2011-08-21,0,8,3,0,0,0,1,0.66,0.6061,0.83,0.2239,25,26,51,51,3,Pagi
5479,2011-08-21,0,8,4,0,0,0,1,0.68,0.6364,0.83,0.2239,1,5,6,6,3,Pagi
5480,2011-08-21,0,8,5,0,0,0,1,0.66,0.5909,0.89,0.2985,0,8,8,8,3,Pagi
5481,2011-08-21,0,8,6,0,0,0,1,0.66,0.5909,0.89,0.2836,4,10,14,14,3,Pagi
5482,2011-08-21,0,8,7,0,0,0,1,0.68,0.6364,0.83,0.2985,12,19,31,31,3,Siang
5483,2011-08-21,0,8,8,0,0,0,1,0.7,0.6667,0.79,0.2239,30,62,92,92,3,Siang
5484,2011-08-21,0,8,9,0,0,0,1,0.72,0.697,0.74,0.2239,80,151,231,231,3,Siang
5485,2011-08-21,0,8,10,0,0,0,1,0.74,0.7121,0.74,0.2537,97,177,274,274,3,Siang
5486,2011-08-21,0,8,11,0,0,0,1,0.8,0.7879,0.63,0.2836,132,181,313,313,3,Siang
5487,2011-08-21,0,8,12,0,0,0,1,0.82,0.803,0.59,0.2836,135,239,374,374,3,Siang
5488,2011-08-21,0,8,13,0,0,0,1,0.8,0.7727,0.59,0.4179,94,216,310,310,3,Sore
5489,2011-08-21,0,8,14,0,0,0,3,0.7,0.6667,0.79,0.3881,78,157,235,235,3,Sore
5490,2011-08-21,0,8,15,0,0,0,1,0.7,0.6667,0.84,0.2836,17,51,68,68,3,Sore
5491,2011-08-21,0,8,16,0,0,0,1,0.72,0.697,0.79,0.1642,97,161,258,258,3,Sore
5492,2011-08-21,0,8,17,0,0,0,1,0.72,0.697,0.79,0.1343,91,179,270,270,3,Sore
5493,2011-08-21,0,8,18,0,0,0,1,0.72,0.697,0.79,0.2537,96,215,311,311,3,Sore
5494,2011-08-21,0,8,19,0,0,0,1,0.72,0.6818,0.7,0.2537,81,201,282,282,3,Malam
5495,2011-08-21,0,8,20,0,0,0,1,0.7,0.6667,0.79,0.2537,41,140,181,181,3,Malam
5496,2011-08-21,0,8,21,0,0,0,1,0.7,0.6667,0.79,0.2537,45,93,138,138,3,Malam
5497,2011-08-21,0,8,22,0,0,0,2,0.7,0.6667,0.79,0.194,37,97,134,134,3,Malam
5498,2011-08-21,0,8,23,0,0,0,1,0.7,0.6667,0.74,0.1642,20,48,68,68,3,Malam
5499,2011-08-22,0,8,0,0,1,1,1,0.68,0.6364,0.79,0.1642,18,22,40,40,3,
5500,2011-08-22,0,8,1,0,1,1,1,0.68,0.6364,0.79,0.0896,8,13,21,21,3,Pagi
5501,2011-08-22,0,8,2,0,1,1,2,0.7,0.6515,0.65,0.1045,2,6,8,8,3,Pagi
5502,2011-08-22,0,8,3,0,1,1,3,0.7,0.6515,0.65,0.1343,0,5,5,5,3,Pagi
5503,2011-08-22,0,8,4,0,1,1,1,0.68,0.6364,0.65,0.194,2,10,12,12,3,Pagi
5504,2011-08-22,0,8,5,0,1,1,1,0.66,0.6212,0.65,0.3582,1,23,24,24,3,Pagi
5505,2011-08-22,0,8,6,0,1,1,1,0.66,0.6212,0.61,0.2985,6,106,112,112,3,Pagi
5506,2011-08-22,0,8,7,0,1,1,1,0.66,0.6212,0.61,0.3284,11,270,281,281,3,Siang
5507,2011-08-22,0,8,8,0,1,1,1,0.66,0.6212,0.61,0.3284,20,331,351,351,3,Siang
5508,2011-08-22,0,8,9,0,1,1,1,0.68,0.6364,0.54,0.2537,36,151,187,187,3,Siang
5509,2011-08-22,0,8,10,0,1,1,1,0.7,0.6515,0.48,0.2836,36,85,121,121,3,Siang
5510,2011-08-22,0,8,11,0,1,1,1,0.72,0.6515,0.34,0.3284,46,85,131,131,3,Siang
5511,2011-08-22,0,8,12,0,1,1,1,0.74,0.6515,0.35,0.3881,54,153,207,207,3,Siang
5512,2011-08-22,0,8,13,0,1,1,1,0.74,0.6515,0.3,0.4627,47,158,205,205,3,Sore
5513,2011-08-22,0,8,14,0,1,1,1,0.74,0.6515,0.3,0.3881,88,137,225,225,3,Sore
5514,2011-08-22,0,8,15,0,1,1,1,0.74,0.6515,0.3,0.2985,72,127,199,199,3,Sore
5515,2011-08-22,0,8,16,0,1,1,1,0.74,0.6515,0.3,0.3881,66,254,320,320,3,Sore
5516,2011-08-22,0,8,17,0,1,1,1,0.74,0.6515,0.27,0.3284,82,509,591,591,3,Sore
5517,2011-08-22,0,8,18,0,1,1,1,0.72,0.6515,0.28,0.2985,72,537,609,609,3,Sore
5518,2011-08-22,0,8,19,0,1,1,1,0.7,0.6364,0.3,0.2836,66,350,416,416,3,Malam
5519,2011-08-22,0,8,20,0,1,1,1,0.66,0.6212,0.34,0.194,21,247,268,268,3,Malam
5520,2011-08-22,0,8,21,0,1,1,1,0.64,0.6212,0.38,0.194,28,180,208,208,3,Malam
5521,2011-08-22,0,8,22,0,1,1,1,0.64,0.6212,0.38,0.2985,32,121,153,153,3,Malam
5522,2011-08-22,0,8,23,0,1,1,1,0.62,0.6212,0.41,0.2537,19,45,64,64,3,Malam
5523,2011-08-23,0,8,0,0,2,1,1,0.6,0.6212,0.43,0.194,13,22,35,35,3,
5524,2011-08-23,0,8,1,0,2,1,1,0.58,0.5455,0.49,0.194,6,13,19,19,3,Pagi
5525,2011-08-23,0,8,2,0,2,1,1,0.56,0.5303,0.52,0.194,2,4,6,6,3,Pagi
5526,2011-08-23,0,8,3,0,2,1,1,0.56,0.5303,0.52,0.2836,2,4,6,6,3,Pagi
5527,2011-08-23,0,8,4,0,2,1,1,0.54,0.5152,0.56,0.1642,0,5,5,5,3,Pagi
5528,2011-08-23,0,8,5,0,2,1,1,0.54,0.5152,0.56,0.194,1,35,36,36,3,Pagi
5529,2011-08-23,0,8,6,0,2,1,1,0.54,0.5152,0.6,0.194,3,111,114,114,3,Pagi
5530,2011-08-23,0,8,7,0,2,1,1,0.6,0.6212,0.49,0.194,11,333,344,344,3,Siang
5531,2011-08-23,0,8,8,0,2,1,2,0.62,0.6212,0.5,0.0,43,461,504,504,3,Siang
5532,2011-08-23,0,8,9,0,2,1,2,0.66,0.6212,0.44,0.0,34,191,225,225,3,Siang
5533,2011-08-23,0,8,10,0,2,1,1,0.7,0.6364,0.37,0.0,56,92,148,148,3,Siang
5534,2011-08-23,0,8,11,0,2,1,1,0.7,0.6364,0.34,0.1045,62,124,186,186,3,Siang
5535,2011-08-23,0,8,12,0,2,1,1,0.7,0.6364,0.39,0.0896,60,177,237,237,3,Siang
5536,2011-08-23,0,8,13,0,2,1,1,0.72,0.6515,0.3,0.1045,70,164,234,234,3,Sore
5537,2011-08-23,0,8,14,0,2,1,1,0.72,0.6515,0.3,0.0896,149,502,651,651,3,Sore
5538,2011-08-23,0,8,15,0,2,1,1,0.72,0.6515,0.34,0.2239,178,423,601,601,3,Sore
5539,2011-08-23,0,8,16,0,2,1,1,0.72,0.6515,0.32,0.1343,133,311,444,444,3,Sore
5540,2011-08-23,0,8,17,0,2,1,1,0.72,0.6515,0.34,0.2239,133,339,472,472,3,Sore
5541,2011-08-23,0,8,18,0,2,1,1,0.72,0.6515,0.34,0.194,98,421,519,519,3,Sore
5542,2011-08-23,0,8,19,0,2,1,1,0.66,0.6212,0.5,0.2239,70,297,367,367,3,Malam
5543,2011-08-23,0,8,20,0,2,1,1,0.64,0.6212,0.53,0.2537,54,206,260,260,3,Malam
5544,2011-08-23,0,8,21,0,2,1,1,0.62,0.6212,0.57,0.0,38,173,211,211,3,Malam
5545,2011-08-23,0,8,22,0,2,1,1,0.62,0.6212,0.57,0.1343,46,145,191,191,3,Malam
5546,2011-08-23,0,8,23,0,2,1,1,0.62,0.6061,0.61,0.1343,19,61,80,80,3,Malam
5547,2011-08-24,0,8,0,0,3,1,1,0.62,0.6212,0.57,0.1343,9,29,38,38,3,
5548,2011-08-24,0,8,1,0,3,1,1,0.6,0.6061,0.6,0.1045,7,17,24,24,3,Pagi
5549,2011-08-24,0,8,2,0,3,1,1,0.58,0.5455,0.68,0.1343,2,4,6,6,3,Pagi
5550,2011-08-24,0,8,3,0,3,1,1,0.58,0.5455,0.68,0.1343,0,1,1,1,3,Pagi
5551,2011-08-24,0,8,4,0,3,1,1,0.56,0.5303,0.73,0.1045,0,7,7,7,3,Pagi
5552,2011-08-24,0,8,5,0,3,1,1,0.56,0.5303,0.73,0.1045,1,26,27,27,3,Pagi
5553,2011-08-24,0,8,6,0,3,1,1,0.56,0.5303,0.73,0.0,3,105,108,108,3,Pagi
5554,2011-08-24,0,8,7,0,3,1,1,0.6,0.6061,0.64,0.0896,11,297,308,308,3,Siang
5555,2011-08-24,0,8,8,0,3,1,1,0.62,0.6061,0.69,0.1343,32,436,468,468,3,Siang
5556,2011-08-24,0,8,9,0,3,1,1,0.64,0.6061,0.69,0.2537,44,169,213,213,3,Siang
5557,2011-08-24,0,8,10,0,3,1,1,0.7,0.6515,0.58,0.2836,51,95,146,146,3,Siang
5558,2011-08-24,0,8,11,0,3,1,1,0.72,0.6667,0.54,0.2985,57,128,185,185,3,Siang
5559,2011-08-24,0,8,12,0,3,1,1,0.74,0.6818,0.55,0.3284,60,175,235,235,3,Siang
5560,2011-08-24,0,8,13,0,3,1,1,0.76,0.6818,0.48,0.4179,56,180,236,236,3,Sore
5561,2011-08-24,0,8,14,0,3,1,1,0.76,0.6818,0.48,0.4179,77,127,204,204,3,Sore
5562,2011-08-24,0,8,15,0,3,1,1,0.76,0.6818,0.48,0.4478,63,141,204,204,3,Sore
5563,2011-08-24,0,8,16,0,3,1,1,0.76,0.697,0.52,0.4179,49,222,271,271,3,Sore
5564,2011-08-24,0,8,17,0,3,1,1,0.76,0.697,0.52,0.3582,83,484,567,567,3,Sore
5565,2011-08-24,0,8,18,0,3,1,1,0.74,0.6818,0.55,0.2985,102,519,621,621,3,Sore
5566,2011-08-24,0,8,19,0,3,1,1,0.74,0.6818,0.55,0.2985,93,347,440,440,3,Malam
5567,2011-08-24,0,8,20,0,3,1,1,0.72,0.6667,0.58,0.2985,45,289,334,334,3,Malam
5568,2011-08-24,0,8,21,0,3,1,1,0.7,0.6515,0.61,0.3582,47,189,236,236,3,Malam
5569,2011-08-24,0,8,22,0,3,1,1,0.7,0.6515,0.65,0.3582,41,140,181,181,3,Malam
5570,2011-08-24,0,8,23,0,3,1,1,0.68,0.6364,0.69,0.2985,16,54,70,70,3,Malam
5571,2011-08-25,0,8,0,0,4,1,1,0.68,0.6364,0.74,0.2985,11,41,52,52,3,
5572,2011-08-25,0,8,1,0,4,1,1,0.68,0.6364,0.69,0.3881,4,11,15,15,3,Pagi
5573,2011-08-25,0,8,2,0,4,1,1,0.68,0.6364,0.69,0.3881,3,2,5,5,3,Pagi
5574,2011-08-25,0,8,3,0,4,1,1,0.66,0.6212,0.74,0.3284,2,2,4,4,3,Pagi
5575,2011-08-25,0,8,4,0,4,1,1,0.66,0.6061,0.78,0.3881,1,6,7,7,3,Pagi
5576,2011-08-25,0,8,5,0,4,1,1,0.66,0.6061,0.83,0.4179,1,25,26,26,3,Pagi
5577,2011-08-25,0,8,6,0,4,1,1,0.66,0.6061,0.83,0.3284,1,101,102,102,3,Pagi
5578,2011-08-25,0,8,7,0,4,1,2,0.68,0.6364,0.79,0.3284,17,296,313,313,3,Siang
5579,2011-08-25,0,8,8,0,4,1,2,0.7,0.6667,0.74,0.2985,23,461,484,484,3,Siang
5580,2011-08-25,0,8,9,0,4,1,2,0.72,0.6818,0.7,0.2985,21,141,162,162,3,Siang
5581,2011-08-25,0,8,10,0,4,1,2,0.74,0.697,0.66,0.2985,37,105,142,142,3,Siang
5582,2011-08-25,0,8,11,0,4,1,3,0.7,0.6667,0.79,0.0,39,112,151,151,3,Siang
5583,2011-08-25,0,8,12,0,4,1,3,0.7,0.6667,0.79,0.0,9,32,41,41,3,Siang
5584,2011-08-25,0,8,13,0,4,1,1,0.7,0.6667,0.79,0.1045,7,30,37,37,3,Sore
5585,2011-08-25,0,8,14,0,4,1,2,0.72,0.697,0.74,0.0,27,86,113,113,3,Sore
5586,2011-08-25,0,8,15,0,4,1,2,0.74,0.697,0.7,0.0,28,104,132,132,3,Sore
5587,2011-08-25,0,8,16,0,4,1,1,0.72,0.7121,0.84,0.0,16,105,121,121,3,Sore
5588,2011-08-25,0,8,17,0,4,1,1,0.72,0.7121,0.84,0.0,28,284,312,312,3,Sore
5589,2011-08-25,0,8,18,0,4,1,2,0.72,0.7121,0.84,0.1343,31,377,408,408,3,Sore
5590,2011-08-25,0,8,19,0,4,1,2,0.66,0.6061,0.78,0.3284,31,241,272,272,3,Malam
5591,2011-08-25,0,8,20,0,4,1,1,0.64,0.5909,0.78,0.3582,33,192,225,225,3,Malam
5592,2011-08-25,0,8,21,0,4,1,1,0.64,0.5909,0.78,0.2836,29,158,187,187,3,Malam
5593,2011-08-25,0,8,22,0,4,1,1,0.62,0.5758,0.83,0.0,21,126,147,147,3,Malam
5594,2011-08-25,0,8,23,0,4,1,1,0.62,0.5758,0.83,0.0896,15,69,84,84,3,Malam
5595,2011-08-26,0,8,0,0,5,1,1,0.62,0.5758,0.83,0.1343,9,42,51,51,3,
5596,2011-08-26,0,8,1,0,5,1,1,0.62,0.5758,0.83,0.0,10,13,23,23,3,Pagi
5597,2011-08-26,0,8,2,0,5,1,1,0.62,0.5606,0.88,0.1343,4,16,20,20,3,Pagi
5598,2011-08-26,0,8,3,0,5,1,1,0.6,0.5455,0.88,0.1045,3,8,11,11,3,Pagi
5599,2011-08-26,0,8,4,0,5,1,1,0.62,0.5606,0.88,0.0,2,6,8,8,3,Pagi
5600,2011-08-26,0,8,5,0,5,1,2,0.62,0.5606,0.88,0.0,3,23,26,26,3,Pagi
5601,2011-08-26,0,8,6,0,5,1,1,0.62,0.5606,0.88,0.0,5,100,105,105,3,Pagi
5602,2011-08-26,0,8,7,0,5,1,1,0.64,0.5758,0.83,0.0,3,263,266,266,3,Siang
5603,2011-08-26,0,8,8,0,5,1,1,0.66,0.6061,0.83,0.1045,17,387,404,404,3,Siang
5604,2011-08-26,0,8,9,0,5,1,1,0.7,0.6667,0.74,0.0,39,191,230,230,3,Siang
5605,2011-08-26,0,8,10,0,5,1,1,0.74,0.697,0.66,0.0896,34,89,123,123,3,Siang
5606,2011-08-26,0,8,11,0,5,1,2,0.76,0.7121,0.62,0.0,63,151,214,214,3,Siang
5607,2011-08-26,0,8,12,0,5,1,2,0.76,0.7273,0.66,0.1045,70,173,243,243,3,Siang
5608,2011-08-26,0,8,13,0,5,1,2,0.78,0.7424,0.59,0.1045,72,165,237,237,3,Sore
5609,2011-08-26,0,8,14,0,5,1,1,0.8,0.7727,0.59,0.0,55,164,219,219,3,Sore
5610,2011-08-26,0,8,15,0,5,1,2,0.8,0.7727,0.59,0.194,53,196,249,249,3,Sore
5611,2011-08-26,0,8,16,0,5,1,1,0.78,0.7424,0.62,0.1045,50,293,343,343,3,Sore
5612,2011-08-26,0,8,17,0,5,1,1,0.74,0.7121,0.74,0.2537,56,433,489,489,3,Sore
5613,2011-08-26,0,8,18,0,5,1,2,0.74,0.7121,0.74,0.1343,40,370,410,410,3,Sore
5614,2011-08-26,0,8,19,0,5,1,1,0.72,0.697,0.79,0.1045,55,235,290,290,3,Malam
5615,2011-08-26,0,8,20,0,5,1,1,0.72,0.697,0.79,0.0896,39,183,222,222,3,Malam
5616,2011-08-26,0,8,21,0,5,1,1,0.72,0.697,0.79,0.1642,38,152,190,190,3,Malam
5617,2011-08-26,0,8,22,0,5,1,1,0.72,0.697,0.79,0.1045,26,126,152,152,3,Malam
5618,2011-08-26,0,8,23,0,5,1,1,0.7,0.6667,0.84,0.0896,22,114,136,136,3,Malam
5619,2011-08-27,0,8,0,0,6,0,1,0.7,0.6667,0.84,0.1045,33,112,145,145,3,
5620,2011-08-27,0,8,1,0,6,0,1,0.7,0.6667,0.84,0.1642,13,51,64,64,3,Pagi
5621,2011-08-27,0,8,2,0,6,0,1,0.7,0.6667,0.84,0.194,18,59,77,77,3,Pagi
5622,2011-08-27,0,8,3,0,6,0,2,0.7,0.6667,0.84,0.2239,8,22,30,30,3,Pagi
5623,2011-08-27,0,8,4,0,6,0,2,0.7,0.6667,0.84,0.2239,1,3,4,4,3,Pagi
5624,2011-08-27,0,8,5,0,6,0,2,0.7,0.6667,0.84,0.2985,1,11,12,12,3,Pagi
5625,2011-08-27,0,8,6,0,6,0,2,0.7,0.6667,0.84,0.2985,3,15,18,18,3,Pagi
5626,2011-08-27,0,8,7,0,6,0,2,0.7,0.6667,0.84,0.3582,2,26,28,28,3,Siang
5627,2011-08-27,0,8,8,0,6,0,2,0.7,0.6667,0.84,0.2537,14,62,76,76,3,Siang
5628,2011-08-27,0,8,9,0,6,0,2,0.7,0.6667,0.84,0.4179,28,128,156,156,3,Siang
5629,2011-08-27,0,8,10,0,6,0,2,0.7,0.6667,0.79,0.4627,51,154,205,205,3,Siang
5630,2011-08-27,0,8,11,0,6,0,3,0.66,0.5909,0.89,0.4179,15,73,88,88,3,Siang
5631,2011-08-27,0,8,12,0,6,0,3,0.66,0.6061,0.83,0.4925,11,65,76,76,3,Siang
5632,2011-08-27,0,8,13,0,6,0,3,0.66,0.6061,0.83,0.3881,10,33,43,43,3,Sore
5633,2011-08-27,0,8,14,0,6,0,3,0.64,0.5758,0.89,0.5522,4,19,23,23,3,Sore
5634,2011-08-27,0,8,15,0,6,0,3,0.64,0.5758,0.89,0.5522,2,28,30,30,3,Sore
5635,2011-08-27,0,8,16,0,6,0,3,0.64,0.5758,0.89,0.5224,10,14,24,24,3,Sore
5636,2011-08-27,0,8,17,0,6,0,3,0.64,0.5758,0.89,0.8358,2,14,16,16,3,Sore
5637,2011-08-28,0,8,7,0,0,0,3,0.62,0.5758,0.83,0.3582,0,1,1,1,3,Siang
5638,2011-08-28,0,8,8,0,0,0,3,0.62,0.5758,0.83,0.4179,2,6,8,8,3,Siang
5639,2011-08-28,0,8,9,0,0,0,1,0.66,0.6212,0.74,0.4179,7,46,53,53,3,Siang
5640,2011-08-28,0,8,10,0,0,0,1,0.7,0.6515,0.61,0.6119,27,115,142,142,3,Siang
5641,2011-08-28,0,8,11,0,0,0,1,0.7,0.6515,0.58,0.3881,59,178,237,237,3,Siang
5642,2011-08-28,0,8,12,0,0,0,1,0.74,0.6667,0.51,0.3881,88,218,306,306,3,Siang
5643,2011-08-28,0,8,13,0,0,0,1,0.76,0.6818,0.45,0.3582,129,302,431,431,3,Sore
5644,2011-08-28,0,8,14,0,0,0,1,0.78,0.697,0.43,0.4179,157,290,447,447,3,Sore
5645,2011-08-28,0,8,15,0,0,0,1,0.78,0.697,0.43,0.3582,155,314,469,469,3,Sore
5646,2011-08-28,0,8,16,0,0,0,1,0.8,0.7121,0.36,0.3881,196,295,491,491,3,Sore
5647,2011-08-28,0,8,17,0,0,0,1,0.76,0.6818,0.4,0.2985,145,253,398,398,3,Sore
5648,2011-08-28,0,8,18,0,0,0,1,0.74,0.6667,0.42,0.2239,145,257,402,402,3,Sore
5649,2011-08-28,0,8,19,0,0,0,1,0.72,0.6667,0.48,0.1045,140,247,387,387,3,Malam
5650,2011-08-28,0,8,20,0,0,0,1,0.72,0.6515,0.45,0.1045,64,150,214,214,3,Malam
5651,2011-08-28,0,8,21,0,0,0,1,0.66,0.6212,0.61,0.1343,60,126,186,186,3,Malam
5652,2011-08-28,0,8,22,0,0,0,1,0.64,0.6061,0.69,0.1045,25,73,98,98,3,Malam
5653,2011-08-28,0,8,23,0,0,0,1,0.62,0.5909,0.73,0.1045,16,48,64,64,3,Malam
5654,2011-08-29,0,8,0,0,1,1,1,0.62,0.5909,0.73,0.1045,13,21,34,34,3,
5655,2011-08-29,0,8,1,0,1,1,1,0.6,0.5909,0.69,0.1045,5,15,20,20,3,Pagi
5656,2011-08-29,0,8,2,0,1,1,1,0.6,0.5909,0.69,0.194,8,5,13,13,3,Pagi
5657,2011-08-29,0,8,3,0,1,1,1,0.6,0.5909,0.69,0.1045,1,5,6,6,3,Pagi
5658,2011-08-29,0,8,4,0,1,1,1,0.56,0.5303,0.68,0.1343,0,3,3,3,3,Pagi
5659,2011-08-29,0,8,5,0,1,1,1,0.56,0.5303,0.73,0.1343,0,17,17,17,3,Pagi
5660,2011-08-29,0,8,6,0,1,1,1,0.56,0.5303,0.73,0.1343,3,99,102,102,3,Pagi
5661,2011-08-29,0,8,7,0,1,1,1,0.6,0.6061,0.6,0.2239,11,273,284,284,3,Siang
5662,2011-08-29,0,8,8,0,1,1,1,0.62,0.6212,0.57,0.2537,20,384,404,404,3,Siang
5663,2011-08-29,0,8,9,0,1,1,1,0.62,0.6212,0.53,0.2537,22,166,188,188,3,Siang
5664,2011-08-29,0,8,10,0,1,1,1,0.66,0.6212,0.47,0.2239,42,73,115,115,3,Siang
5665,2011-08-29,0,8,11,0,1,1,1,0.66,0.6212,0.47,0.1642,38,100,138,138,3,Siang
5666,2011-08-29,0,8,12,0,1,1,2,0.68,0.6364,0.44,0.1642,48,159,207,207,3,Siang
5667,2011-08-29,0,8,13,0,1,1,2,0.7,0.6364,0.39,0.0,48,170,218,218,3,Sore
5668,2011-08-29,0,8,14,0,1,1,1,0.7,0.6364,0.42,0.0,55,127,182,182,3,Sore
5669,2011-08-29,0,8,15,0,1,1,1,0.7,0.6364,0.42,0.1642,56,164,220,220,3,Sore
5670,2011-08-29,0,8,16,0,1,1,1,0.72,0.6515,0.42,0.1642,56,226,282,282,3,Sore
5671,2011-08-29,0,8,17,0,1,1,2,0.7,0.6364,0.47,0.2239,67,524,591,591,3,Sore
5672,2011-08-29,0,8,18,0,1,1,1,0.66,0.6212,0.47,0.2537,60,487,547,547,3,Sore
5673,2011-08-29,0,8,19,0,1,1,1,0.66,0.6212,0.47,0.2537,50,317,367,367,3,Malam
5674,2011-08-29,0,8,20,0,1,1,1,0.64,0.6212,0.53,0.1642,50,227,277,277,3,Malam
5675,2011-08-29,0,8,21,0,1,1,1,0.64,0.6212,0.53,0.194,34,168,202,202,3,Malam
5676,2011-08-29,0,8,22,0,1,1,1,0.62,0.6212,0.57,0.1343,23,119,142,142,3,Malam
5677,2011-08-29,0,8,23,0,1,1,1,0.6,0.6061,0.6,0.0896,19,56,75,75,3,Malam
5678,2011-08-30,0,8,0,0,2,1,1,0.56,0.5303,0.73,0.1343,10,17,27,27,3,
5679,2011-08-30,0,8,1,0,2,1,1,0.56,0.5303,0.68,0.1045,6,7,13,13,3,Pagi
5680,2011-08-30,0,8,2,0,2,1,1,0.54,0.5152,0.73,0.1045,2,8,10,10,3,Pagi
5681,2011-08-30,0,8,3,0,2,1,1,0.54,0.5152,0.73,0.194,2,2,4,4,3,Pagi
5682,2011-08-30,0,8,4,0,2,1,1,0.52,0.5,0.77,0.1642,0,6,6,6,3,Pagi
5683,2011-08-30,0,8,5,0,2,1,1,0.52,0.5,0.77,0.0896,1,27,28,28,3,Pagi
5684,2011-08-30,0,8,6,0,2,1,1,0.54,0.5152,0.73,0.1045,4,115,119,119,3,Pagi
5685,2011-08-30,0,8,7,0,2,1,1,0.56,0.5303,0.68,0.1343,19,338,357,357,3,Siang
5686,2011-08-30,0,8,8,0,2,1,1,0.62,0.6212,0.57,0.1343,34,459,493,493,3,Siang
5687,2011-08-30,0,8,9,0,2,1,1,0.66,0.6212,0.5,0.2239,38,180,218,218,3,Siang
5688,2011-08-30,0,8,10,0,2,1,1,0.7,0.6364,0.39,0.2239,28,109,137,137,3,Siang
5689,2011-08-30,0,8,11,0,2,1,1,0.72,0.6515,0.37,0.194,60,115,175,175,3,Siang
5690,2011-08-30,0,8,12,0,2,1,1,0.72,0.6515,0.37,0.0,65,172,237,237,3,Siang
5691,2011-08-30,0,8,13,0,2,1,1,0.74,0.6515,0.35,0.1045,59,170,229,229,3,Sore
5692,2011-08-30,0,8,14,0,2,1,1,0.74,0.6515,0.33,0.1642,58,151,209,209,3,Sore
5693,2011-08-30,0,8,15,0,2,1,1,0.74,0.6515,0.35,0.2239,34,162,196,196,3,Sore
5694,2011-08-30,0,8,16,0,2,1,1,0.74,0.6515,0.37,0.1642,42,295,337,337,3,Sore
5695,2011-08-30,0,8,17,0,2,1,1,0.72,0.6515,0.42,0.194,62,549,611,611,3,Sore
5696,2011-08-30,0,8,18,0,2,1,1,0.7,0.6364,0.45,0.1642,60,516,576,576,3,Sore
5697,2011-08-30,0,8,19,0,2,1,1,0.66,0.6212,0.5,0.0896,68,397,465,465,3,Malam
5698,2011-08-30,0,8,20,0,2,1,1,0.66,0.6212,0.5,0.0,39,259,298,298,3,Malam
5699,2011-08-30,0,8,21,0,2,1,1,0.64,0.6061,0.65,0.0896,43,180,223,223,3,Malam
5700,2011-08-30,0,8,22,0,2,1,1,0.62,0.6061,0.61,0.0,22,121,143,143,3,Malam
5701,2011-08-30,0,8,23,0,2,1,1,0.62,0.6061,0.61,0.0,19,74,93,93,3,Malam
5702,2011-08-31,0,8,0,0,3,1,1,0.6,0.5909,0.69,0.0,8,24,32,32,3,
5703,2011-08-31,0,8,1,0,3,1,1,0.6,0.5909,0.69,0.0,2,13,15,15,3,Pagi
5704,2011-08-31,0,8,2,0,3,1,1,0.56,0.5303,0.73,0.0,1,5,6,6,3,Pagi
5705,2011-08-31,0,8,3,0,3,1,1,0.56,0.5303,0.78,0.0,2,4,6,6,3,Pagi
5706,2011-08-31,0,8,4,0,3,1,1,0.56,0.5303,0.73,0.0,0,5,5,5,3,Pagi
5707,2011-08-31,0,8,5,0,3,1,1,0.54,0.5152,0.83,0.0896,2,25,27,27,3,Pagi
5708,2011-08-31,0,8,6,0,3,1,1,0.54,0.5152,0.77,0.0,4,107,111,111,3,Pagi
5709,2011-08-31,0,8,7,0,3,1,1,0.6,0.5758,0.78,0.0,12,316,328,328,3,Siang
5710,2011-08-31,0,8,8,0,3,1,1,0.62,0.6061,0.69,0.0,27,440,467,467,3,Siang
5711,2011-08-31,0,8,9,0,3,1,1,0.64,0.6061,0.69,0.0896,27,217,244,244,3,Siang
5712,2011-08-31,0,8,10,0,3,1,1,0.7,0.6364,0.45,0.1045,33,105,138,138,3,Siang
5713,2011-08-31,0,8,11,0,3,1,1,0.72,0.6515,0.42,0.1343,28,143,171,171,3,Siang
5714,2011-08-31,0,8,12,0,3,1,1,0.74,0.6667,0.43,0.1343,68,192,260,260,3,Siang
5715,2011-08-31,0,8,13,0,3,1,1,0.74,0.6515,0.37,0.1045,39,182,221,221,3,Sore
5716,2011-08-31,0,8,14,0,3,1,1,0.74,0.6515,0.4,0.1343,48,148,196,196,3,Sore
5717,2011-08-31,0,8,15,0,3,1,1,0.74,0.6515,0.4,0.1343,34,138,172,172,3,Sore
5718,2011-08-31,0,8,16,0,3,1,1,0.74,0.6667,0.42,0.1343,46,263,309,309,3,Sore
5719,2011-08-31,0,8,17,0,3,1,1,0.72,0.6515,0.45,0.1343,83,525,608,608,3,Sore
5720,2011-08-31,0,8,18,0,3,1,1,0.7,0.6515,0.51,0.2239,70,495,565,565,3,Sore
5721,2011-08-31,0,8,19,0,3,1,1,0.84,0.7727,0.47,0.2537,53,393,446,446,3,Malam
5722,2011-08-31,0,8,20,0,3,1,1,0.66,0.6212,0.57,0.1343,30,259,289,289,3,Malam
5723,2011-08-31,0,8,21,0,3,1,1,0.66,0.6212,0.61,0.0896,27,174,201,201,3,Malam
5724,2011-08-31,0,8,22,0,3,1,1,0.64,0.6061,0.69,0.0,20,137,157,157,3,Malam
5725,2011-08-31,0,8,23,0,3,1,1,0.6,0.5758,0.78,0.1045,24,60,84,84,3,Malam
5726,2011-09-01,0,9,0,0,4,1,1,0.6,0.5758,0.78,0.1045,18,33,51,51,3,
5727,2011-09-01,0,9,1,0,4,1,1,0.6,0.5909,0.73,0.0896,7,14,21,21,3,Pagi
5728,2011-09-01,0,9,2,0,4,1,1,0.58,0.5455,0.78,0.0896,14,11,25,25,3,Pagi
5729,2011-09-01,0,9,3,0,4,1,1,0.58,0.5455,0.78,0.0896,7,7,14,14,3,Pagi
5730,2011-09-01,0,9,4,0,4,1,1,0.56,0.5303,0.83,0.0896,0,7,7,7,3,Pagi
5731,2011-09-01,0,9,5,0,4,1,1,0.56,0.5303,0.73,0.0896,1,22,23,23,3,Pagi
5732,2011-09-01,0,9,6,0,4,1,1,0.6,0.5758,0.78,0.0,2,103,105,105,3,Pagi
5733,2011-09-01,0,9,7,0,4,1,1,0.6,0.5758,0.78,0.0,7,335,342,342,3,Siang
5734,2011-09-01,0,9,8,0,4,1,1,0.62,0.5909,0.73,0.1343,31,467,498,498,3,Siang
5735,2011-09-01,0,9,9,0,4,1,1,0.64,0.6061,0.69,0.1045,29,178,207,207,3,Siang
5736,2011-09-01,0,9,10,0,4,1,1,0.68,0.6364,0.61,0.1343,46,92,138,138,3,Siang
5737,2011-09-01,0,9,11,0,4,1,1,0.72,0.6667,0.51,0.1343,51,141,192,192,3,Siang
5738,2011-09-01,0,9,12,0,4,1,2,0.72,0.6667,0.51,0.1343,64,165,229,229,3,Siang
5739,2011-09-01,0,9,13,0,4,1,2,0.72,0.6667,0.48,0.0896,50,169,219,219,3,Sore
5740,2011-09-01,0,9,14,0,4,1,3,0.72,0.6667,0.54,0.2537,54,144,198,198,3,Sore
5741,2011-09-01,0,9,15,0,4,1,1,0.72,0.6667,0.51,0.1343,39,135,174,174,3,Sore
5742,2011-09-01,0,9,16,0,4,1,1,0.74,0.6667,0.51,0.194,55,253,308,308,3,Sore
5743,2011-09-01,0,9,17,0,4,1,1,0.72,0.6667,0.54,0.2537,61,567,628,628,3,Sore
5744,2011-09-01,0,9,18,0,4,1,1,0.72,0.6667,0.54,0.2239,69,462,531,531,3,Sore
5745,2011-09-01,0,9,19,0,4,1,1,0.7,0.6515,0.58,0.1642,79,364,443,443,3,Malam
5746,2011-09-01,0,9,20,0,4,1,1,0.66,0.6212,0.61,0.2239,33,247,280,280,3,Malam
5747,2011-09-01,0,9,21,0,4,1,2,0.66,0.6212,0.57,0.194,17,160,177,177,3,Malam
5748,2011-09-01,0,9,22,0,4,1,2,0.66,0.6212,0.57,0.2239,34,145,179,179,3,Malam
5749,2011-09-01,0,9,23,0,4,1,1,0.64,0.6061,0.65,0.2537,15,111,126,126,3,Malam
5750,2011-09-02,0,9,0,0,5,1,1,0.64,0.6061,0.65,0.194,6,58,64,64,3,
5751,2011-09-02,0,9,1,0,5,1,3,0.62,0.5909,0.73,0.1045,4,28,32,32,3,Pagi
5752,2011-09-02,0,9,2,0,5,1,3,0.62,0.5909,0.73,0.1045,9,11,20,20,3,Pagi
5753,2011-09-02,0,9,3,0,5,1,2,0.6,0.5606,0.83,0.1642,4,4,8,8,3,Pagi
5754,2011-09-02,0,9,4,0,5,1,1,0.6,0.5606,0.83,0.0896,2,2,4,4,3,Pagi
5755,2011-09-02,0,9,5,0,5,1,2,0.6,0.5606,0.83,0.1343,0,20,20,20,3,Pagi
5756,2011-09-02,0,9,6,0,5,1,1,0.6,0.5606,0.83,0.1343,3,73,76,76,3,Pagi
5757,2011-09-02,0,9,7,0,5,1,1,0.6,0.5606,0.83,0.1045,6,253,259,259,3,Siang
5758,2011-09-02,0,9,8,0,5,1,1,0.62,0.5909,0.78,0.194,22,434,456,456,3,Siang
5759,2011-09-02,0,9,9,0,5,1,2,0.62,0.5758,0.83,0.1045,30,190,220,220,3,Siang
5760,2011-09-02,0,9,10,0,5,1,2,0.64,0.6061,0.76,0.1642,34,106,140,140,3,Siang
5761,2011-09-02,0,9,11,0,5,1,2,0.66,0.6212,0.74,0.1045,51,141,192,192,3,Siang
5762,2011-09-02,0,9,12,0,5,1,2,0.66,0.6212,0.69,0.2239,82,178,260,260,3,Siang
5763,2011-09-02,0,9,13,0,5,1,2,0.68,0.6364,0.65,0.1343,72,207,279,279,3,Sore
5764,2011-09-02,0,9,14,0,5,1,2,0.7,0.6515,0.61,0.1045,75,208,283,283,3,Sore
5765,2011-09-02,0,9,15,0,5,1,2,0.7,0.6515,0.61,0.2537,69,277,346,346,3,Sore
5766,2011-09-02,0,9,16,0,5,1,2,0.7,0.6515,0.61,0.1343,82,299,381,381,3,Sore
5767,2011-09-02,0,9,17,0,5,1,2,0.68,0.6364,0.65,0.1642,78,377,455,455,3,Sore
5768,2011-09-02,0,9,18,0,5,1,2,0.68,0.6364,0.65,0.194,50,305,355,355,3,Sore
5769,2011-09-02,0,9,19,0,5,1,1,0.66,0.6212,0.69,0.1343,67,220,287,287,3,Malam
5770,2011-09-02,0,9,20,0,5,1,1,0.64,0.6061,0.73,0.0,38,158,196,196,3,Malam
5771,2011-09-02,0,9,21,0,5,1,2,0.64,0.6061,0.73,0.0896,28,121,149,149,3,Malam
5772,2011-09-02,0,9,22,0,5,1,2,0.64,0.6061,0.73,0.1642,33,114,147,147,3,Malam
5773,2011-09-02,0,9,23,0,5,1,2,0.64,0.6061,0.73,0.1642,30,68,98,98,3,Malam
5774,2011-09-03,0,9,0,0,6,0,2,0.64,0.6061,0.73,0.1045,22,65,87,87,3,
5775,2011-09-03,0,9,1,0,6,0,2,0.64,0.6061,0.69,0.2537,17,57,74,74,3,Pagi
5776,2011-09-03,0,9,2,0,6,0,2,0.64,0.6061,0.69,0.2239,15,26,41,41,3,Pagi
5777,2011-09-03,0,9,3,0,6,0,1,0.62,0.5909,0.73,0.1642,17,18,35,35,3,Pagi
5778,2011-09-03,0,9,4,0,6,0,1,0.62,0.5909,0.73,0.1642,3,4,7,7,3,Pagi
5779,2011-09-03,0,9,5,0,6,0,1,0.62,0.6061,0.69,0.194,3,9,12,12,3,Pagi
5780,2011-09-03,0,9,6,0,6,0,1,0.62,0.5909,0.73,0.1642,4,19,23,23,3,Pagi
5781,2011-09-03,0,9,7,0,6,0,1,0.62,0.5909,0.73,0.194,5,33,38,38,3,Siang
5782,2011-09-03,0,9,8,0,6,0,1,0.64,0.6061,0.69,0.1642,24,65,89,89,3,Siang
5783,2011-09-03,0,9,9,0,6,0,2,0.66,0.6212,0.69,0.2537,83,118,201,201,3,Siang
5784,2011-09-03,0,9,10,0,6,0,3,0.66,0.6212,0.65,0.2537,90,168,258,258,3,Siang
5785,2011-09-03,0,9,11,0,6,0,3,0.66,0.6212,0.69,0.2836,66,128,194,194,3,Siang
5786,2011-09-03,0,9,12,0,6,0,1,0.7,0.6515,0.61,0.2239,97,160,257,257,3,Siang
5787,2011-09-03,0,9,13,0,6,0,1,0.7,0.6515,0.65,0.2239,153,200,353,353,3,Sore
5788,2011-09-03,0,9,14,0,6,0,2,0.72,0.6818,0.66,0.1642,204,176,380,380,3,Sore
5789,2011-09-03,0,9,15,0,6,0,1,0.72,0.6818,0.7,0.1642,187,201,388,388,3,Sore
5790,2011-09-03,0,9,16,0,6,0,1,0.72,0.6818,0.7,0.194,186,188,374,374,3,Sore
5791,2011-09-03,0,9,17,0,6,0,1,0.72,0.6818,0.7,0.2239,170,201,371,371,3,Sore
5792,2011-09-03,0,9,18,0,6,0,1,0.72,0.6818,0.7,0.1642,160,179,339,339,3,Sore
5793,2011-09-03,0,9,19,0,6,0,1,0.7,0.6667,0.74,0.1343,147,148,295,295,3,Malam
5794,2011-09-03,0,9,20,0,6,0,1,0.7,0.6667,0.79,0.1642,99,120,219,219,3,Malam
5795,2011-09-03,0,9,21,0,6,0,1,0.68,0.6364,0.83,0.1343,71,93,164,164,3,Malam
5796,2011-09-03,0,9,22,0,6,0,1,0.68,0.6364,0.83,0.1045,66,96,162,162,3,Malam
5797,2011-09-03,0,9,23,0,6,0,1,0.66,0.6212,0.85,0.1343,46,77,123,123,3,Malam
5798,2011-09-04,0,9,0,0,0,0,1,0.66,0.5909,0.89,0.194,33,76,109,109,3,
5799,2011-09-04,0,9,1,0,0,0,1,0.66,0.6061,0.83,0.1343,37,38,75,75,3,Pagi
5800,2011-09-04,0,9,2,0,0,0,1,0.66,0.6061,0.83,0.194,17,43,60,60,3,Pagi
5801,2011-09-04,0,9,3,0,0,0,1,0.64,0.5758,0.89,0.194,20,23,43,43,3,Pagi
5802,2011-09-04,0,9,4,0,0,0,1,0.64,0.5758,0.83,0.1642,0,4,4,4,3,Pagi
5803,2011-09-04,0,9,5,0,0,0,1,0.64,0.5758,0.83,0.1343,1,5,6,6,3,Pagi
5804,2011-09-04,0,9,6,0,0,0,1,0.64,0.5758,0.84,0.2239,0,3,3,3,3,Pagi
5805,2011-09-04,0,9,7,0,0,0,1,0.66,0.6061,0.78,0.194,10,20,30,30,3,Siang
5806,2011-09-04,0,9,8,0,0,0,1,0.66,0.6061,0.78,0.1642,21,49,70,70,3,Siang
5807,2011-09-04,0,9,9,0,0,0,1,0.66,0.6061,0.78,0.1642,87,102,189,189,3,Siang
5808,2011-09-04,0,9,10,0,0,0,1,0.7,0.6667,0.74,0.1343,150,147,297,297,3,Siang
5809,2011-09-04,0,9,11,0,0,0,1,0.74,0.697,0.7,0.1642,174,163,337,337,3,Siang
5810,2011-09-04,0,9,12,0,0,0,1,0.76,0.7273,0.66,0.1642,214,221,435,435,3,Siang
5811,2011-09-04,0,9,13,0,0,0,2,0.78,0.7424,0.62,0.2836,245,174,419,419,3,Sore
5812,2011-09-04,0,9,14,0,0,0,1,0.78,0.7576,0.66,0.3284,205,156,361,361,3,Sore
5813,2011-09-04,0,9,15,0,0,0,1,0.78,0.7576,0.66,0.2836,218,192,410,410,3,Sore
5814,2011-09-04,0,9,16,0,0,0,1,0.8,0.7727,0.59,0.2239,196,141,337,337,3,Sore
5815,2011-09-04,0,9,17,0,0,0,1,0.76,0.7273,0.66,0.2239,204,172,376,376,3,Sore
5816,2011-09-04,0,9,18,0,0,0,1,0.76,0.7273,0.66,0.194,187,169,356,356,3,Sore
5817,2011-09-04,0,9,19,0,0,0,1,0.74,0.697,0.7,0.194,178,150,328,328,3,Malam
5818,2011-09-04,0,9,20,0,0,0,1,0.74,0.697,0.7,0.2985,104,125,229,229,3,Malam
5819,2011-09-04,0,9,21,0,0,0,1,0.72,0.697,0.74,0.2537,104,103,207,207,3,Malam
5820,2011-09-04,0,9,22,0,0,0,2,0.72,0.697,0.74,0.2836,70,85,155,155,3,Malam
5821,2011-09-04,0,9,23,0,0,0,2,0.72,0.6818,0.7,0.1642,46,58,104,104,3,Malam
5822,2011-09-05,0,9,0,1,1,0,2,0.7,0.6667,0.74,0.2239,31,66,97,97,3,
5823,2011-09-05,0,9,1,1,1,0,2,0.68,0.6364,0.79,0.1045,19,35,54,54,3,Pagi
5824,2011-09-05,0,9,2,1,1,0,2,0.68,0.6364,0.79,0.1642,17,22,39,39,3,Pagi
5825,2011-09-05,0,9,3,1,1,0,2,0.68,0.6364,0.74,0.2985,4,12,16,16,3,Pagi
5826,2011-09-05,0,9,4,1,1,0,2,0.68,0.6364,0.69,0.2836,3,5,8,8,3,Pagi
5827,2011-09-05,0,9,5,1,1,0,2,0.66,0.6212,0.74,0.1642,2,4,6,6,3,Pagi
5828,2011-09-05,0,9,6,1,1,0,2,0.66,0.6212,0.74,0.1343,6,5,11,11,3,Pagi
5829,2011-09-05,0,9,7,1,1,0,1,0.66,0.6212,0.74,0.1642,11,30,41,41,3,Siang
5830,2011-09-05,0,9,8,1,1,0,2,0.66,0.6061,0.78,0.194,45,56,101,101,3,Siang
5831,2011-09-05,0,9,9,1,1,0,3,0.68,0.6364,0.74,0.1642,63,89,152,152,3,Siang
5832,2011-09-05,0,9,10,1,1,0,2,0.7,0.6515,0.7,0.1642,107,137,244,244,3,Siang
5833,2011-09-05,0,9,11,1,1,0,2,0.7,0.6667,0.74,0.1642,101,207,308,308,3,Siang
5834,2011-09-05,0,9,12,1,1,0,2,0.72,0.6818,0.7,0.194,141,212,353,353,3,Siang
5835,2011-09-05,0,9,13,1,1,0,2,0.74,0.697,0.7,0.1343,154,235,389,389,3,Sore
5836,2011-09-05,0,9,14,1,1,0,1,0.74,0.697,0.7,0.1642,145,212,357,357,3,Sore
5837,2011-09-05,0,9,15,1,1,0,2,0.68,0.6364,0.79,0.2836,111,142,253,253,3,Sore
5838,2011-09-05,0,9,16,1,1,0,2,0.68,0.6364,0.79,0.2836,92,192,284,284,3,Sore
5839,2011-09-05,0,9,17,1,1,0,2,0.66,0.5909,0.89,0.1045,37,77,114,114,3,Sore
5840,2011-09-05,0,9,18,1,1,0,1,0.66,0.5909,0.89,0.0896,31,92,123,123,3,Sore
5841,2011-09-05,0,9,19,1,1,0,3,0.66,0.5909,0.94,0.1045,52,123,175,175,3,Malam
5842,2011-09-05,0,9,20,1,1,0,3,0.66,0.5909,0.94,0.2537,26,56,82,82,3,Malam
5843,2011-09-05,0,9,21,1,1,0,2,0.66,0.5909,0.94,0.2985,20,40,60,60,3,Malam
5844,2011-09-05,0,9,22,1,1,0,2,0.6,0.5455,0.88,0.5821,15,49,64,64,3,Malam
5845,2011-09-05,0,9,23,1,1,0,3,0.56,0.5303,0.88,0.3881,3,17,20,20,3,Malam
5846,2011-09-06,0,9,0,0,2,1,3,0.54,0.5152,0.94,0.3582,1,7,8,8,3,
5847,2011-09-06,0,9,2,0,2,1,3,0.54,0.5152,0.94,0.2537,0,2,2,2,3,Pagi
5848,2011-09-06,0,9,3,0,2,1,3,0.54,0.5152,0.94,0.2985,1,0,1,1,3,Pagi
5849,2011-09-06,0,9,4,0,2,1,2,0.54,0.5152,0.94,0.2985,1,3,4,4,3,Pagi
5850,2011-09-06,0,9,5,0,2,1,3,0.54,0.5152,0.88,0.3582,1,20,21,21,3,Pagi
5851,2011-09-06,0,9,6,0,2,1,2,0.54,0.5152,0.88,0.3284,0,72,72,72,3,Pagi
5852,2011-09-06,0,9,7,0,2,1,2,0.54,0.5152,0.83,0.3582,6,166,172,172,3,Siang
5853,2011-09-06,0,9,8,0,2,1,3,0.54,0.5152,0.83,0.3881,15,349,364,364,3,Siang
5854,2011-09-06,0,9,9,0,2,1,2,0.54,0.5152,0.81,0.4179,18,167,185,185,3,Siang
5855,2011-09-06,0,9,10,0,2,1,3,0.54,0.5152,0.83,0.3582,16,90,106,106,3,Siang
5856,2011-09-06,0,9,11,0,2,1,3,0.54,0.5152,0.83,0.3881,11,78,89,89,3,Siang
5857,2011-09-06,0,9,12,0,2,1,3,0.54,0.5152,0.83,0.3881,16,51,67,67,3,Siang
5858,2011-09-06,0,9,13,0,2,1,3,0.54,0.5152,0.88,0.2985,5,24,29,29,3,Sore
5859,2011-09-06,0,9,14,0,2,1,3,0.54,0.5152,0.88,0.2836,3,21,24,24,3,Sore
5860,2011-09-06,0,9,15,0,2,1,3,0.54,0.5152,0.94,0.3881,18,71,89,89,3,Sore
5861,2011-09-06,0,9,16,0,2,1,3,0.54,0.5152,0.94,0.3881,11,95,106,106,3,Sore
5862,2011-09-06,0,9,17,0,2,1,2,0.54,0.5152,0.88,0.3881,15,276,291,291,3,Sore
5863,2011-09-06,0,9,18,0,2,1,2,0.54,0.5152,0.88,0.3881,22,351,373,373,3,Sore
5864,2011-09-06,0,9,19,0,2,1,2,0.54,0.5152,0.88,0.4179,12,269,281,281,3,Malam
5865,2011-09-06,0,9,20,0,2,1,3,0.54,0.5152,0.88,0.2985,13,150,163,163,3,Malam
5866,2011-09-06,0,9,21,0,2,1,3,0.54,0.5152,0.88,0.2836,12,109,121,121,3,Malam
5867,2011-09-06,0,9,22,0,2,1,2,0.54,0.5152,0.94,0.3284,5,79,84,84,3,Malam
5868,2011-09-06,0,9,23,0,2,1,3,0.54,0.5152,0.94,0.2537,2,56,58,58,3,Malam
5869,2011-09-07,0,9,0,0,3,1,2,0.54,0.5152,0.94,0.2239,1,12,13,13,3,
5870,2011-09-07,0,9,1,0,3,1,3,0.54,0.5152,0.94,0.2537,2,3,5,5,3,Pagi
5871,2011-09-07,0,9,2,0,3,1,2,0.54,0.5152,0.94,0.2239,2,4,6,6,3,Pagi
5872,2011-09-07,0,9,3,0,3,1,3,0.56,0.5303,0.94,0.1343,1,1,2,2,3,Pagi
5873,2011-09-07,0,9,4,0,3,1,3,0.56,0.5303,0.94,0.1642,0,4,4,4,3,Pagi
5874,2011-09-07,0,9,5,0,3,1,2,0.56,0.5303,1.0,0.1343,1,15,16,16,3,Pagi
5875,2011-09-07,0,9,6,0,3,1,3,0.6,0.5455,0.88,0.1045,1,74,75,75,3,Pagi
5876,2011-09-07,0,9,7,0,3,1,3,0.6,0.5455,0.88,0.0896,3,83,86,86,3,Siang
5877,2011-09-07,0,9,8,0,3,1,3,0.62,0.5455,0.94,0.0896,9,319,328,328,3,Siang
5878,2011-09-07,0,9,9,0,3,1,3,0.6,0.5455,0.88,0.1343,14,176,190,190,3,Siang
5879,2011-09-07,0,9,10,0,3,1,3,0.6,0.5455,0.88,0.1343,3,63,66,66,3,Siang
5880,2011-09-07,0,9,11,0,3,1,3,0.6,0.5152,0.94,0.0,1,9,10,10,3,Siang
5881,2011-09-07,0,9,12,0,3,1,3,0.56,0.5303,0.94,0.0,1,21,22,22,3,Siang
5882,2011-09-07,0,9,13,0,3,1,3,0.6,0.5455,0.88,0.0,2,9,11,11,3,Sore
5883,2011-09-07,0,9,14,0,3,1,3,0.6,0.5152,0.93,0.0,1,24,25,25,3,Sore
5884,2011-09-07,0,9,15,0,3,1,3,0.62,0.5455,0.94,0.1045,3,55,58,58,3,Sore
5885,2011-09-07,0,9,16,0,3,1,1,0.64,0.5758,0.89,0.0,7,137,144,144,3,Sore
5886,2011-09-07,0,9,17,0,3,1,3,0.64,0.5758,0.89,0.0,21,264,285,285,3,Sore
5887,2011-09-07,0,9,18,0,3,1,3,0.64,0.5758,0.89,0.0,18,219,237,237,3,Sore
5888,2011-09-07,0,9,19,0,3,1,2,0.64,0.5758,0.89,0.0,14,212,226,226,3,Malam
5889,2011-09-07,0,9,20,0,3,1,3,0.64,0.5758,0.89,0.0896,3,93,96,96,3,Malam
5890,2011-09-07,0,9,21,0,3,1,3,0.64,0.5758,0.89,0.0896,4,34,38,38,3,Malam
5891,2011-09-07,0,9,22,0,3,1,3,0.62,0.5455,0.94,0.1642,3,26,29,29,3,Malam
5892,2011-09-07,0,9,23,0,3,1,3,0.62,0.5455,0.94,0.194,3,21,24,24,3,Malam
5893,2011-09-08,0,9,0,0,4,1,3,0.6,0.5,1.0,0.194,3,11,14,14,3,
5894,2011-09-08,0,9,1,0,4,1,3,0.62,0.5455,0.94,0.1045,0,4,4,4,3,Pagi
5895,2011-09-08,0,9,3,0,4,1,3,0.62,0.5455,0.94,0.0,0,2,2,2,3,Pagi
5896,2011-09-08,0,9,4,0,4,1,2,0.62,0.5455,0.94,0.0896,0,3,3,3,3,Pagi
5897,2011-09-08,0,9,5,0,4,1,3,0.62,0.5455,0.94,0.0896,1,13,14,14,3,Pagi
5898,2011-09-08,0,9,6,0,4,1,3,0.62,0.5455,0.94,0.1642,1,55,56,56,3,Pagi
5899,2011-09-08,0,9,7,0,4,1,3,0.62,0.5455,0.94,0.1045,7,172,179,179,3,Siang
5900,2011-09-08,0,9,8,0,4,1,3,0.62,0.5455,0.94,0.1343,7,188,195,195,3,Siang
5901,2011-09-08,0,9,9,0,4,1,2,0.62,0.5152,1.0,0.2537,4,65,69,69,3,Siang
5902,2011-09-08,0,9,10,0,4,1,2,0.64,0.5606,0.94,0.1045,8,57,65,65,3,Siang
5903,2011-09-08,0,9,11,0,4,1,2,0.64,0.5606,0.94,0.2239,16,82,98,98,3,Siang
5904,2011-09-08,0,9,12,0,4,1,2,0.66,0.5909,0.94,0.2239,17,85,102,102,3,Siang
5905,2011-09-08,0,9,13,0,4,1,2,0.68,0.6364,0.83,0.3881,14,112,126,126,3,Sore
5906,2011-09-08,0,9,14,0,4,1,2,0.7,0.6667,0.79,0.3582,15,105,120,120,3,Sore
5907,2011-09-08,0,9,15,0,4,1,3,0.66,0.5909,0.89,0.2985,24,115,139,139,3,Sore
5908,2011-09-08,0,9,16,0,4,1,3,0.64,0.5606,0.94,0.2836,5,151,156,156,3,Sore
5909,2011-09-08,0,9,17,0,4,1,3,0.64,0.5606,0.94,0.2836,11,102,113,113,3,Sore
5910,2011-09-08,0,9,18,0,4,1,3,0.64,0.5606,0.94,0.3582,2,66,68,68,3,Sore
5911,2011-09-08,0,9,19,0,4,1,3,0.62,0.5152,1.0,0.3284,1,51,52,52,3,Malam
5912,2011-09-08,0,9,20,0,4,1,2,0.62,0.5455,0.94,0.1642,6,83,89,89,3,Malam
5913,2011-09-08,0,9,21,0,4,1,3,0.64,0.5606,0.94,0.1045,6,76,82,82,3,Malam
5914,2011-09-08,0,9,22,0,4,1,3,0.62,0.5152,1.0,0.0896,5,65,70,70,3,Malam
5915,2011-09-08,0,9,23,0,4,1,3,0.62,0.5152,1.0,0.0896,0,26,26,26,3,Malam
5916,2011-09-09,0,9,0,0,5,1,3,0.64,0.5606,0.94,0.194,1,15,16,16,3,
5917,2011-09-09,0,9,1,0,5,1,2,0.62,0.5152,1.0,0.1642,0,8,8,8,3,Pagi
5918,2011-09-09,0,9,2,0,5,1,2,0.62,0.5152,1.0,0.2537,1,7,8,8,3,Pagi
5919,2011-09-09,0,9,3,0,5,1,2,0.62,0.5455,0.94,0.2537,1,1,2,2,3,Pagi
5920,2011-09-09,0,9,4,0,5,1,3,0.62,0.5455,0.94,0.1642,0,3,3,3,3,Pagi
5921,2011-09-09,0,9,5,0,5,1,2,0.62,0.5455,0.94,0.1343,0,14,14,14,3,Pagi
5922,2011-09-09,0,9,6,0,5,1,2,0.62,0.5152,1.0,0.1343,3,54,57,57,3,Pagi
5923,2011-09-09,0,9,7,0,5,1,3,0.62,0.5152,1.0,0.2537,4,104,108,108,3,Siang
5924,2011-09-09,0,9,8,0,5,1,3,0.62,0.5455,0.94,0.1642,12,276,288,288,3,Siang
5925,2011-09-09,0,9,9,0,5,1,3,0.62,0.5455,0.94,0.1642,5,131,136,136,3,Siang
5926,2011-09-09,0,9,10,0,5,1,2,0.62,0.5152,1.0,0.0,2,27,29,29,3,Siang
5927,2011-09-09,0,9,11,0,5,1,2,0.62,0.5455,0.94,0.0,6,66,72,72,3,Siang
5928,2011-09-09,0,9,12,0,5,1,1,0.64,0.5606,0.94,0.0,4,71,75,75,3,Siang
5929,2011-09-09,0,9,13,0,5,1,1,0.7,0.6667,0.79,0.0896,14,108,122,122,3,Sore
5930,2011-09-09,0,9,14,0,5,1,1,0.72,0.697,0.74,0.0896,29,119,148,148,3,Sore
5931,2011-09-09,0,9,15,0,5,1,1,0.74,0.697,0.66,0.0,27,161,188,188,3,Sore
5932,2011-09-09,0,9,16,0,5,1,1,0.74,0.697,0.66,0.1343,41,244,285,285,3,Sore
5933,2011-09-09,0,9,17,0,5,1,1,0.7,0.6667,0.79,0.2537,54,451,505,505,3,Sore
5934,2011-09-09,0,9,18,0,5,1,1,0.7,0.6667,0.79,0.194,33,377,410,410,3,Sore
5935,2011-09-09,0,9,19,0,5,1,1,0.66,0.5909,0.89,0.1642,33,316,349,349,3,Malam
5936,2011-09-09,0,9,20,0,5,1,1,0.64,0.5606,0.94,0.0896,30,180,210,210,3,Malam
5937,2011-09-09,0,9,21,0,5,1,1,0.66,0.5909,0.89,0.0,49,154,203,203,3,Malam
5938,2011-09-09,0,9,22,0,5,1,1,0.62,0.5455,0.94,0.0,33,127,160,160,3,Malam
5939,2011-09-09,0,9,23,0,5,1,1,0.62,0.5455,0.94,0.0896,35,113,148,148,3,Malam
5940,2011-09-10,0,9,0,0,6,0,1,0.62,0.5455,0.94,0.0,32,84,116,116,3,
5941,2011-09-10,0,9,1,0,6,0,2,0.62,0.5455,0.94,0.0,16,67,83,83,3,Pagi
5942,2011-09-10,0,9,2,0,6,0,2,0.6,0.5,0.97,0.1045,18,46,64,64,3,Pagi
5943,2011-09-10,0,9,3,0,6,0,1,0.58,0.5455,1.0,0.1343,8,29,37,37,3,Pagi
5944,2011-09-10,0,9,4,0,6,0,1,0.58,0.5455,0.94,0.0896,3,4,7,7,3,Pagi
5945,2011-09-10,0,9,5,0,6,0,1,0.58,0.5455,0.94,0.1343,2,6,8,8,3,Pagi
5946,2011-09-10,0,9,6,0,6,0,1,0.58,0.5455,0.94,0.1642,0,6,6,6,3,Pagi
5947,2011-09-10,0,9,7,0,6,0,1,0.6,0.5455,0.88,0.1343,9,43,52,52,3,Siang
5948,2011-09-10,0,9,8,0,6,0,1,0.62,0.5758,0.83,0.1642,16,103,119,119,3,Siang
5949,2011-09-10,0,9,9,0,6,0,1,0.64,0.5909,0.78,0.2985,39,168,207,207,3,Siang
5950,2011-09-10,0,9,10,0,6,0,1,0.7,0.6515,0.65,0.2537,85,233,318,318,3,Siang
5951,2011-09-10,0,9,11,0,6,0,1,0.72,0.6818,0.62,0.2537,108,252,360,360,3,Siang
5952,2011-09-10,0,9,12,0,6,0,1,0.72,0.6818,0.62,0.2239,144,260,404,404,3,Siang
5953,2011-09-10,0,9,13,0,6,0,1,0.74,0.6818,0.55,0.2836,131,239,370,370,3,Sore
5954,2011-09-10,0,9,14,0,6,0,1,0.74,0.6818,0.55,0.2836,129,230,359,359,3,Sore
5955,2011-09-10,0,9,15,0,6,0,1,0.74,0.6818,0.55,0.2239,217,263,480,480,3,Sore
5956,2011-09-10,0,9,16,0,6,0,1,0.74,0.6818,0.55,0.194,170,261,431,431,3,Sore
5957,2011-09-10,0,9,17,0,6,0,1,0.74,0.6818,0.55,0.2239,185,275,460,460,3,Sore
5958,2011-09-10,0,9,18,0,6,0,1,0.72,0.6667,0.58,0.194,119,241,360,360,3,Sore
5959,2011-09-10,0,9,19,0,6,0,1,0.7,0.6515,0.58,0.1343,101,214,315,315,3,Malam
5960,2011-09-10,0,9,20,0,6,0,1,0.66,0.6212,0.69,0.1045,78,167,245,245,3,Malam
5961,2011-09-10,0,9,21,0,6,0,1,0.64,0.5909,0.78,0.0896,59,171,230,230,3,Malam
5962,2011-09-10,0,9,22,0,6,0,1,0.64,0.5909,0.78,0.0,49,126,175,175,3,Malam
5963,2011-09-10,0,9,23,0,6,0,2,0.62,0.5606,0.88,0.0,32,107,139,139,3,Malam
5964,2011-09-11,0,9,0,0,0,0,1,0.62,0.5606,0.88,0.0,29,79,108,108,3,
5965,2011-09-11,0,9,1,0,0,0,2,0.62,0.5606,0.88,0.0,22,66,88,88,3,Pagi
5966,2011-09-11,0,9,2,0,0,0,2,0.62,0.5909,0.78,0.194,16,60,76,76,3,Pagi
5967,2011-09-11,0,9,3,0,0,0,2,0.62,0.5909,0.78,0.0896,15,30,45,45,3,Pagi
5968,2011-09-11,0,9,4,0,0,0,1,0.6,0.5606,0.83,0.1343,3,6,9,9,3,Pagi
5969,2011-09-11,0,9,5,0,0,0,1,0.6,0.5606,0.83,0.1343,15,24,39,39,3,Pagi
5970,2011-09-11,0,9,6,0,0,0,1,0.58,0.5455,0.88,0.1045,4,16,20,20,3,Pagi
5971,2011-09-11,0,9,7,0,0,0,1,0.6,0.5455,0.88,0.0,9,28,37,37,3,Siang
5972,2011-09-11,0,9,8,0,0,0,1,0.64,0.5909,0.78,0.0,25,69,94,94,3,Siang
5973,2011-09-11,0,9,9,0,0,0,1,0.66,0.6212,0.74,0.0,59,168,227,227,3,Siang
5974,2011-09-11,0,9,10,0,0,0,1,0.7,0.6515,0.65,0.0,120,214,334,334,3,Siang
5975,2011-09-11,0,9,11,0,0,0,1,0.7,0.6515,0.65,0.0,144,258,402,402,3,Siang
5976,2011-09-11,0,9,12,0,0,0,1,0.7,0.6515,0.65,0.0,113,298,411,411,3,Siang
5977,2011-09-11,0,9,13,0,0,0,1,0.74,0.6818,0.58,0.1045,119,231,350,350,3,Sore
5978,2011-09-11,0,9,14,0,0,0,1,0.72,0.6667,0.58,0.2836,120,222,342,342,3,Sore
5979,2011-09-11,0,9,15,0,0,0,1,0.74,0.6667,0.51,0.2985,134,270,404,404,3,Sore
5980,2011-09-11,0,9,16,0,0,0,1,0.72,0.6667,0.51,0.2985,180,303,483,483,3,Sore
5981,2011-09-11,0,9,17,0,0,0,1,0.72,0.6667,0.51,0.1343,152,228,380,380,3,Sore
5982,2011-09-11,0,9,18,0,0,0,1,0.68,0.6364,0.65,0.2985,110,229,339,339,3,Sore
5983,2011-09-11,0,9,19,0,0,0,1,0.64,0.6061,0.69,0.1045,101,232,333,333,3,Malam
5984,2011-09-11,0,9,20,0,0,0,1,0.62,0.5909,0.73,0.1045,65,161,226,226,3,Malam
5985,2011-09-11,0,9,21,0,0,0,1,0.64,0.6061,0.69,0.0,45,114,159,159,3,Malam
5986,2011-09-11,0,9,22,0,0,0,1,0.62,0.6061,0.69,0.3881,21,74,95,95,3,Malam
5987,2011-09-11,0,9,23,0,0,0,3,0.58,0.5455,0.78,0.0896,12,33,45,45,3,Malam
5988,2011-09-12,0,9,0,0,1,1,1,0.56,0.5303,0.88,0.0896,5,11,16,16,3,
5989,2011-09-12,0,9,1,0,1,1,1,0.56,0.5303,0.88,0.0,1,11,12,12,3,Pagi
5990,2011-09-12,0,9,2,0,1,1,1,0.56,0.5303,0.88,0.0,2,0,2,2,3,Pagi
5991,2011-09-12,0,9,4,0,1,1,1,0.54,0.5152,0.94,0.1045,0,4,4,4,3,Pagi
5992,2011-09-12,0,9,5,0,1,1,1,0.56,0.5303,0.83,0.0,1,23,24,24,3,Pagi
5993,2011-09-12,0,9,6,0,1,1,1,0.56,0.5303,0.83,0.0,1,108,109,109,3,Pagi
5994,2011-09-12,0,9,7,0,1,1,1,0.58,0.5455,0.83,0.0,12,300,312,312,3,Siang
5995,2011-09-12,0,9,8,0,1,1,1,0.6,0.5758,0.78,0.0896,26,382,408,408,3,Siang
5996,2011-09-12,0,9,9,0,1,1,1,0.64,0.6061,0.69,0.0,21,155,176,176,3,Siang
5997,2011-09-12,0,9,10,0,1,1,1,0.68,0.6364,0.62,0.1642,40,89,129,129,3,Siang
5998,2011-09-12,0,9,11,0,1,1,1,0.7,0.6515,0.58,0.194,34,131,165,165,3,Siang
5999,2011-09-12,0,9,12,0,1,1,1,0.72,0.6667,0.51,0.194,37,147,184,184,3,Siang
6000,2011-09-12,0,9,13,0,1,1,1,0.72,0.6667,0.54,0.1045,43,120,163,163,3,Sore
6001,2011-09-12,0,9,14,0,1,1,1,0.74,0.6667,0.51,0.1642,60,129,189,189,3,Sore
6002,2011-09-12,0,9,15,0,1,1,1,0.74,0.6667,0.48,0.0896,60,152,212,212,3,Sore
6003,2011-09-12,0,9,16,0,1,1,1,0.72,0.6667,0.48,0.0,60,238,298,298,3,Sore
6004,2011-09-12,0,9,17,0,1,1,1,0.72,0.6667,0.51,0.1642,75,515,590,590,3,Sore
6005,2011-09-12,0,9,18,0,1,1,1,0.7,0.6515,0.54,0.194,56,515,571,571,3,Sore
6006,2011-09-12,0,9,19,0,1,1,1,0.68,0.6364,0.57,0.1343,63,373,436,436,3,Malam
6007,2011-09-12,0,9,20,0,1,1,1,0.66,0.6212,0.65,0.0,41,258,299,299,3,Malam
6008,2011-09-12,0,9,21,0,1,1,1,0.64,0.6061,0.73,0.0896,29,166,195,195,3,Malam
6009,2011-09-12,0,9,22,0,1,1,1,0.62,0.5758,0.83,0.1642,16,134,150,150,3,Malam
6010,2011-09-12,0,9,23,0,1,1,1,0.62,0.5758,0.83,0.1045,7,62,69,69,3,Malam
6011,2011-09-13,0,9,0,0,2,1,1,0.6,0.5455,0.88,0.1045,7,19,26,26,3,
6012,2011-09-13,0,9,1,0,2,1,1,0.58,0.5455,0.83,0.1045,4,6,10,10,3,Pagi
6013,2011-09-13,0,9,2,0,2,1,1,0.6,0.5758,0.78,0.0,2,0,2,2,3,Pagi
6014,2011-09-13,0,9,3,0,2,1,1,0.58,0.5455,0.83,0.0,2,2,4,4,3,Pagi
6015,2011-09-13,0,9,4,0,2,1,1,0.56,0.5303,0.88,0.0,2,6,8,8,3,Pagi
6016,2011-09-13,0,9,5,0,2,1,1,0.56,0.5303,0.88,0.0,1,19,20,20,3,Pagi
6017,2011-09-13,0,9,6,0,2,1,1,0.56,0.5303,0.88,0.1045,6,116,122,122,3,Pagi
6018,2011-09-13,0,9,7,0,2,1,1,0.58,0.5455,0.83,0.0896,14,348,362,362,3,Siang
6019,2011-09-13,0,9,8,0,2,1,1,0.6,0.5606,0.81,0.1045,26,399,425,425,3,Siang
6020,2011-09-13,0,9,9,0,2,1,1,0.64,0.6061,0.69,0.0896,35,179,214,214,3,Siang
6021,2011-09-13,0,9,10,0,2,1,1,0.68,0.6364,0.69,0.1343,42,93,135,135,3,Siang
6022,2011-09-13,0,9,11,0,2,1,1,0.7,0.6515,0.61,0.1642,33,120,153,153,3,Siang
6023,2011-09-13,0,9,12,0,2,1,1,0.72,0.6667,0.58,0.2239,43,144,187,187,3,Siang
6024,2011-09-13,0,9,13,0,2,1,1,0.74,0.6667,0.51,0.2836,48,136,184,184,3,Sore
6025,2011-09-13,0,9,14,0,2,1,1,0.74,0.6667,0.51,0.3284,51,139,190,190,3,Sore
6026,2011-09-13,0,9,15,0,2,1,1,0.74,0.6667,0.51,0.2985,35,145,180,180,3,Sore
6027,2011-09-13,0,9,16,0,2,1,1,0.74,0.6667,0.51,0.2239,41,251,292,292,3,Sore
6028,2011-09-13,0,9,17,0,2,1,1,0.74,0.6667,0.51,0.2239,72,507,579,579,3,Sore
6029,2011-09-13,0,9,18,0,2,1,1,0.7,0.6515,0.61,0.1642,67,472,539,539,3,Sore
6030,2011-09-13,0,9,19,0,2,1,1,0.68,0.6364,0.69,0.1642,55,341,396,396,3,Malam
6031,2011-09-13,0,9,20,0,2,1,1,0.66,0.6212,0.74,0.194,31,241,272,272,3,Malam
6032,2011-09-13,0,9,21,0,2,1,1,0.64,0.5909,0.78,0.1642,45,200,245,245,3,Malam
6033,2011-09-13,0,9,22,0,2,1,1,0.64,0.5909,0.78,0.1343,24,120,144,144,3,Malam
6034,2011-09-13,0,9,23,0,2,1,1,0.64,0.5909,0.78,0.1045,15,59,74,74,3,Malam
6035,2011-09-14,0,9,0,0,3,1,1,0.62,0.5909,0.78,0.0896,5,28,33,33,3,
6036,2011-09-14,0,9,1,0,3,1,1,0.62,0.5909,0.78,0.0896,1,7,8,8,3,Pagi
6037,2011-09-14,0,9,2,0,3,1,1,0.6,0.5606,0.83,0.0,1,4,5,5,3,Pagi
6038,2011-09-14,0,9,3,0,3,1,1,0.6,0.5455,0.88,0.1343,1,7,8,8,3,Pagi
6039,2011-09-14,0,9,4,0,3,1,1,0.6,0.5606,0.83,0.0896,1,8,9,9,3,Pagi
6040,2011-09-14,0,9,5,0,3,1,1,0.58,0.5455,0.88,0.1045,1,30,31,31,3,Pagi
6041,2011-09-14,0,9,6,0,3,1,1,0.58,0.5455,0.88,0.1045,7,138,145,145,3,Pagi
6042,2011-09-14,0,9,7,0,3,1,1,0.6,0.5606,0.83,0.1045,20,350,370,370,3,Siang
6043,2011-09-14,0,9,8,0,3,1,1,0.62,0.5758,0.83,0.1642,33,396,429,429,3,Siang
6044,2011-09-14,0,9,9,0,3,1,1,0.64,0.5909,0.78,0.1642,19,183,202,202,3,Siang
6045,2011-09-14,0,9,10,0,3,1,1,0.7,0.6515,0.7,0.1343,27,115,142,142,3,Siang
6046,2011-09-14,0,9,11,0,3,1,1,0.72,0.6818,0.66,0.1642,43,121,164,164,3,Siang
6047,2011-09-14,0,9,12,0,3,1,1,0.74,0.6818,0.58,0.2239,56,156,212,212,3,Siang
6048,2011-09-14,0,9,13,0,3,1,1,0.76,0.697,0.55,0.2537,39,139,178,178,3,Sore
6049,2011-09-14,0,9,14,0,3,1,1,0.78,0.7121,0.52,0.2239,19,105,124,124,3,Sore
6050,2011-09-14,0,9,15,0,3,1,1,0.78,0.7121,0.49,0.2537,30,146,176,176,3,Sore
6051,2011-09-14,0,9,16,0,3,1,1,0.76,0.697,0.52,0.2836,36,241,277,277,3,Sore
6052,2011-09-14,0,9,17,0,3,1,1,0.76,0.697,0.52,0.2836,87,512,599,599,3,Sore
6053,2011-09-14,0,9,18,0,3,1,1,0.72,0.6818,0.62,0.1642,83,503,586,586,3,Sore
6054,2011-09-14,0,9,19,0,3,1,2,0.7,0.6515,0.7,0.1045,44,337,381,381,3,Malam
6055,2011-09-14,0,9,20,0,3,1,2,0.72,0.6667,0.58,0.4179,40,221,261,261,3,Malam
6056,2011-09-14,0,9,21,0,3,1,2,0.66,0.6212,0.65,0.2239,24,189,213,213,3,Malam
6057,2011-09-14,0,9,22,0,3,1,2,0.66,0.6212,0.65,0.1343,20,140,160,160,3,Malam
6058,2011-09-14,0,9,23,0,3,1,2,0.64,0.6061,0.69,0.1045,10,62,72,72,3,Malam
6059,2011-09-15,0,9,0,0,4,1,1,0.64,0.6061,0.69,0.1343,3,34,37,37,3,
6060,2011-09-15,0,9,1,0,4,1,1,0.64,0.6061,0.69,0.1642,0,20,20,20,3,Pagi
6061,2011-09-15,0,9,2,0,4,1,1,0.62,0.5909,0.73,0.1045,0,5,5,5,3,Pagi
6062,2011-09-15,0,9,3,0,4,1,1,0.62,0.5909,0.73,0.0896,3,5,8,8,3,Pagi
6063,2011-09-15,0,9,4,0,4,1,1,0.6,0.5758,0.78,0.1045,2,5,7,7,3,Pagi
6064,2011-09-15,0,9,5,0,4,1,1,0.6,0.5758,0.78,0.0,1,30,31,31,3,Pagi
6065,2011-09-15,0,9,6,0,4,1,2,0.6,0.5606,0.83,0.2537,5,119,124,124,3,Pagi
6066,2011-09-15,0,9,7,0,4,1,2,0.62,0.5909,0.78,0.194,17,321,338,338,3,Siang
6067,2011-09-15,0,9,8,0,4,1,1,0.64,0.6061,0.73,0.1343,27,364,391,391,3,Siang
6068,2011-09-15,0,9,9,0,4,1,2,0.64,0.6061,0.73,0.3582,23,186,209,209,3,Siang
6069,2011-09-15,0,9,10,0,4,1,2,0.66,0.6212,0.69,0.2537,25,96,121,121,3,Siang
6070,2011-09-15,0,9,11,0,4,1,2,0.68,0.6364,0.65,0.1343,39,120,159,159,3,Siang
6071,2011-09-15,0,9,12,0,4,1,2,0.66,0.6212,0.69,0.2985,31,148,179,179,3,Siang
6072,2011-09-15,0,9,13,0,4,1,2,0.64,0.6061,0.65,0.2836,38,151,189,189,3,Sore
6073,2011-09-15,0,9,14,0,4,1,2,0.64,0.6061,0.65,0.4179,36,134,170,170,3,Sore
6074,2011-09-15,0,9,15,0,4,1,2,0.6,0.5909,0.69,0.4179,25,110,135,135,3,Sore
6075,2011-09-15,0,9,16,0,4,1,2,0.54,0.5152,0.77,0.4627,29,193,222,222,3,Sore
6076,2011-09-15,0,9,17,0,4,1,3,0.48,0.4697,0.82,0.4627,31,230,261,261,3,Sore
6077,2011-09-15,0,9,18,0,4,1,3,0.48,0.4697,0.67,0.6119,22,222,244,244,3,Sore
6078,2011-09-15,0,9,19,0,4,1,1,0.46,0.4545,0.67,0.4627,20,212,232,232,3,Malam
6079,2011-09-15,0,9,20,0,4,1,1,0.46,0.4545,0.63,0.3284,25,223,248,248,3,Malam
6080,2011-09-15,0,9,21,0,4,1,1,0.46,0.4545,0.63,0.3284,11,134,145,145,3,Malam
6081,2011-09-15,0,9,22,0,4,1,1,0.44,0.4394,0.67,0.2836,7,108,115,115,3,Malam
6082,2011-09-15,0,9,23,0,4,1,1,0.44,0.4394,0.67,0.2239,8,61,69,69,3,Malam
6083,2011-09-16,0,9,0,0,5,1,1,0.42,0.4242,0.71,0.2239,5,43,48,48,3,
6084,2011-09-16,0,9,1,0,5,1,1,0.42,0.4242,0.67,0.194,7,19,26,26,3,Pagi
6085,2011-09-16,0,9,2,0,5,1,1,0.4,0.4091,0.71,0.2836,3,7,10,10,3,Pagi
6086,2011-09-16,0,9,3,0,5,1,1,0.4,0.4091,0.71,0.2537,2,4,6,6,3,Pagi
6087,2011-09-16,0,9,4,0,5,1,1,0.4,0.4091,0.71,0.2836,1,3,4,4,3,Pagi
6088,2011-09-16,0,9,5,0,5,1,1,0.38,0.3939,0.76,0.194,2,30,32,32,3,Pagi
6089,2011-09-16,0,9,6,0,5,1,1,0.38,0.3939,0.71,0.2239,6,87,93,93,3,Pagi
6090,2011-09-16,0,9,7,0,5,1,1,0.4,0.4091,0.71,0.2836,16,283,299,299,3,Siang
6091,2011-09-16,0,9,8,0,5,1,1,0.42,0.4242,0.67,0.2239,23,386,409,409,3,Siang
6092,2011-09-16,0,9,9,0,5,1,1,0.46,0.4545,0.55,0.2537,21,189,210,210,3,Siang
6093,2011-09-16,0,9,10,0,5,1,2,0.5,0.4848,0.51,0.2836,36,104,140,140,3,Siang
6094,2011-09-16,0,9,11,0,5,1,2,0.5,0.4848,0.51,0.1343,40,139,179,179,3,Siang
6095,2011-09-16,0,9,12,0,5,1,2,0.52,0.5,0.45,0.0,39,212,251,251,3,Siang
6096,2011-09-16,0,9,13,0,5,1,2,0.54,0.5152,0.42,0.0,55,168,223,223,3,Sore
6097,2011-09-16,0,9,14,0,5,1,2,0.54,0.5152,0.45,0.1642,49,176,225,225,3,Sore
6098,2011-09-16,0,9,15,0,5,1,2,0.54,0.5152,0.45,0.2239,38,165,203,203,3,Sore
6099,2011-09-16,0,9,16,0,5,1,2,0.52,0.5,0.48,0.1642,67,291,358,358,3,Sore
6100,2011-09-16,0,9,17,0,5,1,2,0.52,0.5,0.48,0.1343,86,480,566,566,3,Sore
6101,2011-09-16,0,9,18,0,5,1,2,0.52,0.5,0.52,0.1642,55,427,482,482,3,Sore
6102,2011-09-16,0,9,19,0,5,1,2,0.5,0.4848,0.55,0.1642,59,256,315,315,3,Malam
6103,2011-09-16,0,9,20,0,5,1,2,0.5,0.4848,0.55,0.0,41,184,225,225,3,Malam
6104,2011-09-16,0,9,21,0,5,1,2,0.5,0.4848,0.63,0.0,39,124,163,163,3,Malam
6105,2011-09-16,0,9,22,0,5,1,1,0.48,0.4697,0.67,0.0896,32,135,167,167,3,Malam
6106,2011-09-16,0,9,23,0,5,1,1,0.5,0.4848,0.59,0.0,20,106,126,126,3,Malam
6107,2011-09-17,0,9,0,0,6,0,1,0.46,0.4545,0.72,0.1642,28,80,108,108,3,
6108,2011-09-17,0,9,1,0,6,0,1,0.46,0.4545,0.72,0.1045,28,52,80,80,3,Pagi
6109,2011-09-17,0,9,2,0,6,0,1,0.46,0.4545,0.82,0.0896,18,61,79,79,3,Pagi
6110,2011-09-17,0,9,3,0,6,0,1,0.46,0.4545,0.72,0.1343,7,21,28,28,3,Pagi
6111,2011-09-17,0,9,4,0,6,0,1,0.46,0.4545,0.72,0.1343,1,4,5,5,3,Pagi
6112,2011-09-17,0,9,5,0,6,0,1,0.46,0.4545,0.72,0.1642,2,3,5,5,3,Pagi
6113,2011-09-17,0,9,6,0,6,0,2,0.46,0.4545,0.72,0.2239,5,17,22,22,3,Pagi
6114,2011-09-17,0,9,7,0,6,0,2,0.46,0.4545,0.77,0.194,4,33,37,37,3,Siang
6115,2011-09-17,0,9,8,0,6,0,2,0.46,0.4545,0.77,0.2537,27,81,108,108,3,Siang
6116,2011-09-17,0,9,9,0,6,0,2,0.48,0.4697,0.67,0.2239,32,145,177,177,3,Siang
6117,2011-09-17,0,9,10,0,6,0,2,0.5,0.4848,0.68,0.2836,72,177,249,249,3,Siang
6118,2011-09-17,0,9,11,0,6,0,2,0.52,0.5,0.68,0.2239,119,248,367,367,3,Siang
6119,2011-09-17,0,9,12,0,6,0,2,0.52,0.5,0.67,0.2239,115,257,372,372,3,Siang
6120,2011-09-17,0,9,13,0,6,0,2,0.52,0.5,0.68,0.194,124,225,349,349,3,Sore
6121,2011-09-17,0,9,14,0,6,0,2,0.52,0.5,0.72,0.194,123,174,297,297,3,Sore
6122,2011-09-17,0,9,15,0,6,0,2,0.52,0.5,0.72,0.194,148,206,354,354,3,Sore
6123,2011-09-17,0,9,16,0,6,0,1,0.54,0.5152,0.68,0.2537,116,189,305,305,3,Sore
6124,2011-09-17,0,9,17,0,6,0,1,0.52,0.5,0.72,0.2239,141,218,359,359,3,Sore
6125,2011-09-17,0,9,18,0,6,0,2,0.52,0.5,0.72,0.2239,95,234,329,329,3,Sore
6126,2011-09-17,0,9,19,0,6,0,1,0.52,0.5,0.68,0.1343,70,186,256,256,3,Malam
6127,2011-09-17,0,9,20,0,6,0,1,0.52,0.5,0.68,0.1343,43,133,176,176,3,Malam
6128,2011-09-17,0,9,21,0,6,0,2,0.5,0.4848,0.72,0.194,49,121,170,170,3,Malam
6129,2011-09-17,0,9,22,0,6,0,1,0.5,0.4848,0.72,0.2239,31,112,143,143,3,Malam
6130,2011-09-17,0,9,23,0,6,0,1,0.46,0.4545,0.82,0.1642,36,100,136,136,3,Malam
6131,2011-09-18,0,9,0,0,0,0,1,0.46,0.4545,0.77,0.2239,24,88,112,112,3,
6132,2011-09-18,0,9,1,0,0,0,1,0.46,0.4545,0.77,0.2239,13,66,79,79,3,Pagi
6133,2011-09-18,0,9,2,0,0,0,1,0.44,0.4394,0.82,0.2537,21,68,89,89,3,Pagi
6134,2011-09-18,0,9,3,0,0,0,1,0.44,0.4394,0.82,0.194,11,25,36,36,3,Pagi
6135,2011-09-18,0,9,4,0,0,0,1,0.44,0.4394,0.77,0.2239,1,0,1,1,3,Pagi
6136,2011-09-18,0,9,5,0,0,0,1,0.44,0.4394,0.77,0.2239,1,5,6,6,3,Pagi
6137,2011-09-18,0,9,6,0,0,0,1,0.44,0.4394,0.77,0.2537,2,10,12,12,3,Pagi
6138,2011-09-18,0,9,7,0,0,0,1,0.46,0.4545,0.72,0.2239,15,29,44,44,3,Siang
6139,2011-09-18,0,9,8,0,0,0,1,0.46,0.4545,0.72,0.2537,16,53,69,69,3,Siang
6140,2011-09-18,0,9,9,0,0,0,1,0.48,0.4697,0.67,0.2537,46,94,140,140,3,Siang
6141,2011-09-18,0,9,10,0,0,0,1,0.5,0.4848,0.72,0.1642,82,178,260,260,3,Siang
6142,2011-09-18,0,9,11,0,0,0,1,0.52,0.5,0.68,0.2239,116,201,317,317,3,Siang
6143,2011-09-18,0,9,12,0,0,0,1,0.54,0.5152,0.64,0.1343,135,229,364,364,3,Siang
6144,2011-09-18,0,9,13,0,0,0,1,0.56,0.5303,0.6,0.1343,162,214,376,376,3,Sore
6145,2011-09-18,0,9,14,0,0,0,2,0.58,0.5455,0.56,0.1343,127,184,311,311,3,Sore
6146,2011-09-18,0,9,15,0,0,0,2,0.58,0.5455,0.6,0.1343,132,233,365,365,3,Sore
6147,2011-09-18,0,9,16,0,0,0,2,0.56,0.5303,0.64,0.1642,134,235,369,369,3,Sore
6148,2011-09-18,0,9,17,0,0,0,2,0.56,0.5303,0.64,0.194,95,230,325,325,3,Sore
6149,2011-09-18,0,9,18,0,0,0,2,0.56,0.5303,0.6,0.1045,66,223,289,289,3,Sore
6150,2011-09-18,0,9,19,0,0,0,2,0.54,0.5152,0.68,0.1045,54,191,245,245,3,Malam
6151,2011-09-18,0,9,20,0,0,0,2,0.54,0.5152,0.68,0.0896,44,136,180,180,3,Malam
6152,2011-09-18,0,9,21,0,0,0,2,0.54,0.5152,0.68,0.0896,37,110,147,147,3,Malam
6153,2011-09-18,0,9,22,0,0,0,2,0.54,0.5152,0.68,0.0896,9,75,84,84,3,Malam
6154,2011-09-18,0,9,23,0,0,0,1,0.54,0.5152,0.68,0.194,10,44,54,54,3,Malam
6155,2011-09-19,0,9,0,0,1,1,2,0.52,0.5,0.72,0.1642,14,23,37,37,3,
6156,2011-09-19,0,9,1,0,1,1,2,0.52,0.5,0.72,0.1045,3,7,10,10,3,Pagi
6157,2011-09-19,0,9,2,0,1,1,2,0.52,0.5,0.72,0.1343,6,7,13,13,3,Pagi
6158,2011-09-19,0,9,3,0,1,1,2,0.5,0.4848,0.77,0.1343,1,4,5,5,3,Pagi
6159,2011-09-19,0,9,4,0,1,1,2,0.5,0.4848,0.77,0.1642,2,6,8,8,3,Pagi
6160,2011-09-19,0,9,5,0,1,1,2,0.5,0.4848,0.77,0.194,2,26,28,28,3,Pagi
6161,2011-09-19,0,9,6,0,1,1,1,0.5,0.4848,0.77,0.2239,6,107,113,113,3,Pagi
6162,2011-09-19,0,9,7,0,1,1,2,0.5,0.4848,0.82,0.2239,20,312,332,332,3,Siang
6163,2011-09-19,0,9,8,0,1,1,2,0.52,0.5,0.77,0.1343,29,391,420,420,3,Siang
6164,2011-09-19,0,9,9,0,1,1,2,0.54,0.5152,0.68,0.1642,32,183,215,215,3,Siang
6165,2011-09-19,0,9,10,0,1,1,2,0.56,0.5303,0.64,0.1343,21,84,105,105,3,Siang
6166,2011-09-19,0,9,11,0,1,1,2,0.58,0.5455,0.64,0.1642,41,98,139,139,3,Siang
6167,2011-09-19,0,9,12,0,1,1,2,0.58,0.5455,0.6,0.0896,51,138,189,189,3,Siang
6168,2011-09-19,0,9,13,0,1,1,2,0.6,0.6061,0.6,0.0,53,124,177,177,3,Sore
6169,2011-09-19,0,9,14,0,1,1,2,0.6,0.6061,0.6,0.194,45,143,188,188,3,Sore
6170,2011-09-19,0,9,15,0,1,1,2,0.6,0.6061,0.6,0.2239,44,143,187,187,3,Sore
6171,2011-09-19,0,9,16,0,1,1,2,0.6,0.6061,0.6,0.1642,55,208,263,263,3,Sore
6172,2011-09-19,0,9,17,0,1,1,2,0.58,0.5455,0.64,0.1343,85,483,568,568,3,Sore
6173,2011-09-19,0,9,18,0,1,1,2,0.56,0.5303,0.68,0.1343,56,484,540,540,3,Sore
6174,2011-09-19,0,9,19,0,1,1,2,0.56,0.5303,0.68,0.1045,41,333,374,374,3,Malam
6175,2011-09-19,0,9,20,0,1,1,2,0.56,0.5303,0.68,0.1343,27,204,231,231,3,Malam
6176,2011-09-19,0,9,21,0,1,1,2,0.56,0.5303,0.68,0.1642,19,181,200,200,3,Malam
6177,2011-09-19,0,9,22,0,1,1,2,0.56,0.5303,0.68,0.1642,25,104,129,129,3,Malam
6178,2011-09-19,0,9,23,0,1,1,2,0.56,0.5303,0.73,0.194,13,55,68,68,3,Malam
6179,2011-09-20,0,9,0,0,2,1,2,0.56,0.5303,0.73,0.1642,4,21,25,25,3,
6180,2011-09-20,0,9,1,0,2,1,2,0.54,0.5152,0.88,0.1642,3,11,14,14,3,Pagi
6181,2011-09-20,0,9,2,0,2,1,2,0.54,0.5152,0.88,0.1642,1,4,5,5,3,Pagi
6182,2011-09-20,0,9,3,0,2,1,2,0.54,0.5152,0.83,0.2239,0,3,3,3,3,Pagi
6183,2011-09-20,0,9,4,0,2,1,1,0.54,0.5152,0.88,0.194,2,4,6,6,3,Pagi
6184,2011-09-20,0,9,5,0,2,1,2,0.54,0.5152,0.88,0.194,1,21,22,22,3,Pagi
6185,2011-09-20,0,9,6,0,2,1,2,0.54,0.5152,0.88,0.194,3,111,114,114,3,Pagi
6186,2011-09-20,0,9,7,0,2,1,2,0.54,0.5152,0.88,0.1642,23,306,329,329,3,Siang
6187,2011-09-20,0,9,8,0,2,1,3,0.54,0.5152,0.94,0.2537,13,196,209,209,3,Siang
6188,2011-09-20,0,9,9,0,2,1,3,0.54,0.5152,0.94,0.2239,5,64,69,69,3,Siang
6189,2011-09-20,0,9,10,0,2,1,3,0.56,0.5303,0.88,0.1642,4,26,30,30,3,Siang
6190,2011-09-20,0,9,11,0,2,1,3,0.56,0.5303,0.88,0.1642,8,48,56,56,3,Siang
6191,2011-09-20,0,9,12,0,2,1,2,0.56,0.5303,0.94,0.1642,13,47,60,60,3,Siang
6192,2011-09-20,0,9,13,0,2,1,2,0.56,0.5303,0.94,0.1343,22,81,103,103,3,Sore
6193,2011-09-20,0,9,14,0,2,1,2,0.58,0.5455,0.88,0.194,27,85,112,112,3,Sore
6194,2011-09-20,0,9,15,0,2,1,2,0.62,0.5909,0.78,0.1045,34,158,192,192,3,Sore
6195,2011-09-20,0,9,16,0,2,1,2,0.6,0.5606,0.83,0.1642,23,241,264,264,3,Sore
6196,2011-09-20,0,9,17,0,2,1,1,0.6,0.5606,0.83,0.1045,66,445,511,511,3,Sore
6197,2011-09-20,0,9,18,0,2,1,1,0.6,0.5606,0.83,0.1045,39,453,492,492,3,Sore
6198,2011-09-20,0,9,19,0,2,1,1,0.58,0.5455,0.88,0.0,43,294,337,337,3,Malam
6199,2011-09-20,0,9,20,0,2,1,1,0.56,0.5303,0.94,0.0,41,212,253,253,3,Malam
6200,2011-09-20,0,9,21,0,2,1,1,0.56,0.5303,0.94,0.0,29,177,206,206,3,Malam
6201,2011-09-20,0,9,22,0,2,1,1,0.56,0.5303,0.94,0.0,23,125,148,148,3,Malam
6202,2011-09-20,0,9,23,0,2,1,1,0.56,0.5303,0.94,0.0,11,70,81,81,3,Malam
6203,2011-09-21,0,9,0,0,3,1,1,0.54,0.5152,1.0,0.0,7,20,27,27,3,
6204,2011-09-21,0,9,1,0,3,1,1,0.54,0.5152,0.94,0.0,0,17,17,17,3,Pagi
6205,2011-09-21,0,9,2,0,3,1,1,0.54,0.5152,0.94,0.0,1,5,6,6,3,Pagi
6206,2011-09-21,0,9,3,0,3,1,2,0.54,0.5152,0.94,0.0896,0,6,6,6,3,Pagi
6207,2011-09-21,0,9,4,0,3,1,2,0.54,0.5152,1.0,0.1343,2,5,7,7,3,Pagi
6208,2011-09-21,0,9,5,0,3,1,2,0.54,0.5152,1.0,0.1642,1,30,31,31,3,Pagi
6209,2011-09-21,0,9,6,0,3,1,2,0.54,0.5152,1.0,0.194,5,112,117,117,3,Pagi
6210,2011-09-21,0,9,7,0,3,1,2,0.54,0.5152,1.0,0.194,18,312,330,330,3,Siang
6211,2011-09-21,0,9,8,0,3,1,2,0.54,0.5152,1.0,0.1045,18,444,462,462,3,Siang
6212,2011-09-21,0,9,9,0,3,1,2,0.56,0.5303,1.0,0.0896,21,187,208,208,3,Siang
6213,2011-09-21,0,9,10,0,3,1,2,0.6,0.5455,0.88,0.0,30,103,133,133,3,Siang
6214,2011-09-21,0,9,11,0,3,1,2,0.62,0.5758,0.83,0.1642,42,138,180,180,3,Siang
6215,2011-09-21,0,9,12,0,3,1,2,0.64,0.5909,0.78,0.0896,42,151,193,193,3,Siang
6216,2011-09-21,0,9,13,0,3,1,2,0.66,0.6212,0.74,0.1642,37,144,181,181,3,Sore
6217,2011-09-21,0,9,14,0,3,1,2,0.66,0.6212,0.74,0.194,40,139,179,179,3,Sore
6218,2011-09-21,0,9,15,0,3,1,2,0.66,0.6212,0.74,0.1045,43,142,185,185,3,Sore
6219,2011-09-21,0,9,16,0,3,1,2,0.66,0.6212,0.74,0.1045,51,230,281,281,3,Sore
6220,2011-09-21,0,9,17,0,3,1,3,0.66,0.6212,0.74,0.1642,61,475,536,536,3,Sore
6221,2011-09-21,0,9,18,0,3,1,3,0.64,0.5758,0.83,0.1642,24,384,408,408,3,Sore
6222,2011-09-21,0,9,19,0,3,1,3,0.62,0.5455,0.94,0.0,30,253,283,283,3,Malam
6223,2011-09-21,0,9,20,0,3,1,3,0.62,0.5455,0.94,0.0,11,149,160,160,3,Malam
6224,2011-09-21,0,9,21,0,3,1,2,0.6,0.5,1.0,0.0896,25,175,200,200,3,Malam
6225,2011-09-21,0,9,22,0,3,1,2,0.62,0.5455,0.94,0.0,15,112,127,127,3,Malam
6226,2011-09-21,0,9,23,0,3,1,1,0.6,0.5152,0.94,0.1045,15,80,95,95,3,Malam
6227,2011-09-22,0,9,0,0,4,1,1,0.6,0.5152,0.94,0.1045,11,30,41,41,3,
6228,2011-09-22,0,9,1,0,4,1,2,0.6,0.5152,0.94,0.0896,5,6,11,11,3,Pagi
6229,2011-09-22,0,9,2,0,4,1,2,0.6,0.5152,0.94,0.1045,2,8,10,10,3,Pagi
6230,2011-09-22,0,9,3,0,4,1,2,0.6,0.5152,0.94,0.0896,5,7,12,12,3,Pagi
6231,2011-09-22,0,9,4,0,4,1,2,0.6,0.5152,0.94,0.0896,0,2,2,2,3,Pagi
6232,2011-09-22,0,9,5,0,4,1,2,0.6,0.5152,0.94,0.1045,2,28,30,30,3,Pagi
6233,2011-09-22,0,9,6,0,4,1,2,0.6,0.5,1.0,0.1343,7,94,101,101,3,Pagi
6234,2011-09-22,0,9,7,0,4,1,2,0.6,0.5,1.0,0.1045,16,295,311,311,3,Siang
6235,2011-09-22,0,9,8,0,4,1,2,0.6,0.5,1.0,0.1642,26,389,415,415,3,Siang
6236,2011-09-22,0,9,9,0,4,1,2,0.62,0.5455,0.94,0.194,35,168,203,203,3,Siang
6237,2011-09-22,0,9,10,0,4,1,2,0.64,0.5758,0.89,0.2239,19,101,120,120,3,Siang
6238,2011-09-22,0,9,11,0,4,1,2,0.64,0.5758,0.89,0.194,23,142,165,165,3,Siang
6239,2011-09-22,0,9,12,0,4,1,2,0.66,0.6061,0.83,0.1642,25,151,176,176,3,Siang
6240,2011-09-22,0,9,13,0,4,1,2,0.66,0.6061,0.83,0.194,38,155,193,193,3,Sore
6241,2011-09-22,0,9,14,0,4,1,2,0.66,0.6061,0.83,0.2239,41,142,183,183,3,Sore
6242,2011-09-22,0,9,15,0,4,1,2,0.68,0.6364,0.79,0.1642,32,149,181,181,3,Sore
6243,2011-09-22,0,9,16,0,4,1,2,0.68,0.6364,0.74,0.1343,39,262,301,301,3,Sore
6244,2011-09-22,0,9,17,0,4,1,2,0.66,0.6061,0.78,0.0896,50,513,563,563,3,Sore
6245,2011-09-22,0,9,18,0,4,1,2,0.64,0.5758,0.83,0.1045,50,501,551,551,3,Sore
6246,2011-09-22,0,9,19,0,4,1,2,0.64,0.5758,0.89,0.0896,32,388,420,420,3,Malam
6247,2011-09-22,0,9,20,0,4,1,2,0.62,0.5455,0.94,0.1343,35,250,285,285,3,Malam
6248,2011-09-22,0,9,21,0,4,1,2,0.64,0.5758,0.89,0.0896,27,194,221,221,3,Malam
6249,2011-09-22,0,9,22,0,4,1,2,0.62,0.5152,1.0,0.0896,21,166,187,187,3,Malam
6250,2011-09-22,0,9,23,0,4,1,2,0.62,0.5455,0.94,0.0,14,99,113,113,3,Malam
6251,2011-09-23,0,9,0,0,5,1,2,0.62,0.5455,0.94,0.0896,11,41,52,52,4,
6252,2011-09-23,0,9,1,0,5,1,2,0.6,0.5,1.0,0.0,2,29,31,31,4,Pagi
6253,2011-09-23,0,9,2,0,5,1,2,0.6,0.5,1.0,0.1045,6,14,20,20,4,Pagi
6254,2011-09-23,0,9,3,0,5,1,2,0.6,0.5,1.0,0.0,3,5,8,8,4,Pagi
6255,2011-09-23,0,9,4,0,5,1,3,0.6,0.5,1.0,0.0,6,7,13,13,4,Pagi
6256,2011-09-23,0,9,5,0,5,1,2,0.62,0.5455,0.94,0.0,2,20,22,22,4,Pagi
6257,2011-09-23,0,9,6,0,5,1,2,0.62,0.5455,0.94,0.0896,5,99,104,104,4,Pagi
6258,2011-09-23,0,9,7,0,5,1,3,0.62,0.5455,0.94,0.1343,14,240,254,254,4,Siang
6259,2011-09-23,0,9,8,0,5,1,3,0.62,0.5455,0.94,0.1343,20,297,317,317,4,Siang
6260,2011-09-23,0,9,9,0,5,1,3,0.62,0.5152,1.0,0.1343,3,108,111,111,4,Siang
6261,2011-09-23,0,9,10,0,5,1,3,0.62,0.5152,1.0,0.1045,7,28,35,35,4,Siang
6262,2011-09-23,0,9,11,0,5,1,3,0.62,0.5152,1.0,0.1045,1,20,21,21,4,Siang
6263,2011-09-23,0,9,12,0,5,1,3,0.62,0.5455,0.94,0.1045,1,28,29,29,4,Siang
6264,2011-09-23,0,9,13,0,5,1,3,0.6,0.5,1.0,0.0896,7,27,34,34,4,Sore
6265,2011-09-23,0,9,14,0,5,1,3,0.6,0.5,1.0,0.0896,3,21,24,24,4,Sore
6266,2011-09-23,0,9,15,0,5,1,3,0.62,0.5455,0.94,0.1045,9,52,61,61,4,Sore
6267,2011-09-23,0,9,16,0,5,1,3,0.62,0.5455,0.94,0.0,5,51,56,56,4,Sore
6268,2011-09-23,0,9,17,0,5,1,2,0.6,0.5,1.0,0.0,13,86,99,99,4,Sore
6269,2011-09-23,0,9,18,0,5,1,1,0.6,0.5,1.0,0.0,14,220,234,234,4,Sore
6270,2011-09-23,0,9,19,0,5,1,1,0.62,0.5455,0.94,0.1343,16,232,248,248,4,Malam
6271,2011-09-23,0,9,20,0,5,1,1,0.6,0.5152,0.94,0.0,21,158,179,179,4,Malam
6272,2011-09-23,0,9,21,0,5,1,1,0.6,0.5,1.0,0.1642,17,121,138,138,4,Malam
6273,2011-09-23,0,9,22,0,5,1,1,0.6,0.5152,0.94,0.1642,31,126,157,157,4,Malam
6274,2011-09-23,0,9,23,0,5,1,2,0.58,0.5455,1.0,0.1343,41,107,148,148,4,Malam
6275,2011-09-24,0,9,0,0,6,0,1,0.58,0.5455,1.0,0.0896,7,86,93,93,4,
6276,2011-09-24,0,9,1,0,6,0,2,0.58,0.5455,0.94,0.0896,18,61,79,79,4,Pagi
6277,2011-09-24,0,9,2,0,6,0,2,0.58,0.5455,0.94,0.0896,14,54,68,68,4,Pagi
6278,2011-09-24,0,9,3,0,6,0,1,0.58,0.5455,0.94,0.0,4,27,31,31,4,Pagi
6279,2011-09-24,0,9,4,0,6,0,1,0.56,0.5303,0.94,0.1045,1,7,8,8,4,Pagi
6280,2011-09-24,0,9,5,0,6,0,2,0.56,0.5303,0.94,0.1045,2,3,5,5,4,Pagi
6281,2011-09-24,0,9,6,0,6,0,2,0.56,0.5303,0.94,0.1045,6,12,18,18,4,Pagi
6282,2011-09-24,0,9,7,0,6,0,2,0.56,0.5303,0.88,0.1045,12,34,46,46,4,Siang
6283,2011-09-24,0,9,8,0,6,0,2,0.58,0.5455,0.9,0.0896,19,102,121,121,4,Siang
6284,2011-09-24,0,9,9,0,6,0,2,0.6,0.5455,0.88,0.0896,41,134,175,175,4,Siang
6285,2011-09-24,0,9,10,0,6,0,2,0.6,0.5455,0.88,0.0896,90,203,293,293,4,Siang
6286,2011-09-24,0,9,11,0,6,0,2,0.62,0.5758,0.83,0.0896,118,268,386,386,4,Siang
6287,2011-09-24,0,9,12,0,6,0,2,0.62,0.5758,0.83,0.0896,141,266,407,407,4,Siang
6288,2011-09-24,0,9,13,0,6,0,1,0.64,0.5909,0.78,0.0,170,290,460,460,4,Sore
6289,2011-09-24,0,9,14,0,6,0,2,0.66,0.6212,0.74,0.1343,164,226,390,390,4,Sore
6290,2011-09-24,0,9,15,0,6,0,2,0.66,0.6212,0.74,0.1343,168,284,452,452,4,Sore
6291,2011-09-24,0,9,16,0,6,0,2,0.64,0.5909,0.78,0.0896,167,282,449,449,4,Sore
6292,2011-09-24,0,9,17,0,6,0,1,0.66,0.6212,0.74,0.1045,180,246,426,426,4,Sore
6293,2011-09-24,0,9,18,0,6,0,1,0.64,0.5909,0.78,0.1045,157,243,400,400,4,Sore
6294,2011-09-24,0,9,19,0,6,0,1,0.62,0.5606,0.88,0.0,77,231,308,308,4,Malam
6295,2011-09-24,0,9,20,0,6,0,1,0.62,0.5758,0.83,0.0,77,166,243,243,4,Malam
6296,2011-09-24,0,9,21,0,6,0,1,0.62,0.5758,0.83,0.0896,66,156,222,222,4,Malam
6297,2011-09-24,0,9,22,0,6,0,2,0.62,0.5606,0.88,0.0,50,143,193,193,4,Malam
6298,2011-09-24,0,9,23,0,6,0,2,0.6,0.5455,0.88,0.0896,27,123,150,150,4,Malam
6299,2011-09-25,0,9,0,0,0,0,2,0.6,0.5455,0.88,0.0,37,136,173,173,4,
6300,2011-09-25,0,9,1,0,0,0,2,0.6,0.5455,0.88,0.1045,31,93,124,124,4,Pagi
6301,2011-09-25,0,9,2,0,0,0,3,0.6,0.5152,0.94,0.0,27,79,106,106,4,Pagi
6302,2011-09-25,0,9,3,0,0,0,3,0.6,0.5152,0.94,0.0,20,39,59,59,4,Pagi
6303,2011-09-25,0,9,4,0,0,0,3,0.6,0.5152,0.94,0.1343,3,5,8,8,4,Pagi
6304,2011-09-25,0,9,5,0,0,0,1,0.6,0.5455,0.88,0.0896,1,2,3,3,4,Pagi
6305,2011-09-25,0,9,6,0,0,0,2,0.6,0.5455,0.88,0.1045,4,13,17,17,4,Pagi
6306,2011-09-25,0,9,7,0,0,0,2,0.6,0.5152,0.94,0.1343,15,23,38,38,4,Siang
6307,2011-09-25,0,9,8,0,0,0,2,0.62,0.5606,0.88,0.0,27,59,86,86,4,Siang
6308,2011-09-25,0,9,9,0,0,0,2,0.64,0.5758,0.83,0.0,55,100,155,155,4,Siang
6309,2011-09-25,0,9,10,0,0,0,2,0.64,0.5758,0.83,0.0,85,190,275,275,4,Siang
6310,2011-09-25,0,9,11,0,0,0,2,0.66,0.6061,0.78,0.1343,131,230,361,361,4,Siang
6311,2011-09-25,0,9,12,0,0,0,2,0.66,0.6061,0.78,0.0,143,270,413,413,4,Siang
6312,2011-09-25,0,9,13,0,0,0,2,0.68,0.6364,0.74,0.0,122,247,369,369,4,Sore
6313,2011-09-25,0,9,14,0,0,0,2,0.66,0.6061,0.78,0.0,116,231,347,347,4,Sore
6314,2011-09-25,0,9,15,0,0,0,2,0.66,0.6061,0.78,0.0,119,234,353,353,4,Sore
6315,2011-09-25,0,9,16,0,0,0,1,0.7,0.6515,0.7,0.0,144,320,464,464,4,Sore
6316,2011-09-25,0,9,17,0,0,0,1,0.68,0.6364,0.74,0.0,145,275,420,420,4,Sore
6317,2011-09-25,0,9,18,0,0,0,1,0.68,0.6364,0.74,0.0,125,279,404,404,4,Sore
6318,2011-09-25,0,9,19,0,0,0,1,0.64,0.5758,0.83,0.1343,87,242,329,329,4,Malam
6319,2011-09-25,0,9,20,0,0,0,1,0.64,0.5758,0.83,0.0896,51,135,186,186,4,Malam
6320,2011-09-25,0,9,21,0,0,0,1,0.62,0.5455,0.94,0.0896,24,113,137,137,4,Malam
6321,2011-09-25,0,9,22,0,0,0,1,0.62,0.5606,0.88,0.0896,20,84,104,104,4,Malam
6322,2011-09-25,0,9,23,0,0,0,2,0.62,0.5455,0.94,0.1045,12,67,79,79,4,Malam
6323,2011-09-26,0,9,0,0,1,1,2,0.62,0.5455,0.94,0.0,6,23,29,29,4,
6324,2011-09-26,0,9,1,0,1,1,2,0.62,0.5606,0.88,0.1045,3,14,17,17,4,Pagi
6325,2011-09-26,0,9,2,0,1,1,2,0.62,0.5606,0.88,0.1045,4,4,8,8,4,Pagi
6326,2011-09-26,0,9,3,0,1,1,2,0.62,0.5455,0.94,0.0,0,5,5,5,4,Pagi
6327,2011-09-26,0,9,4,0,1,1,2,0.62,0.5455,0.94,0.0896,2,4,6,6,4,Pagi
6328,2011-09-26,0,9,5,0,1,1,2,0.62,0.5606,0.88,0.0,0,25,25,25,4,Pagi
6329,2011-09-26,0,9,6,0,1,1,2,0.62,0.5455,0.94,0.0896,6,107,113,113,4,Pagi
6330,2011-09-26,0,9,7,0,1,1,2,0.62,0.5455,0.94,0.0,17,315,332,332,4,Siang
6331,2011-09-26,0,9,8,0,1,1,2,0.62,0.5455,0.94,0.0,29,326,355,355,4,Siang
6332,2011-09-26,0,9,9,0,1,1,2,0.64,0.5758,0.89,0.194,44,161,205,205,4,Siang
6333,2011-09-26,0,9,10,0,1,1,2,0.64,0.5758,0.89,0.194,37,117,154,154,4,Siang
6334,2011-09-26,0,9,11,0,1,1,1,0.68,0.6364,0.79,0.2239,43,116,159,159,4,Siang
6335,2011-09-26,0,9,12,0,1,1,2,0.68,0.6364,0.79,0.1642,48,161,209,209,4,Siang
6336,2011-09-26,0,9,13,0,1,1,2,0.7,0.6667,0.74,0.1642,48,139,187,187,4,Sore
6337,2011-09-26,0,9,14,0,1,1,1,0.7,0.6515,0.7,0.1642,44,110,154,154,4,Sore
6338,2011-09-26,0,9,15,0,1,1,1,0.72,0.6818,0.62,0.1343,52,157,209,209,4,Sore
6339,2011-09-26,0,9,16,0,1,1,1,0.7,0.6515,0.65,0.1642,74,239,313,313,4,Sore
6340,2011-09-26,0,9,17,0,1,1,1,0.7,0.6515,0.7,0.1343,61,509,570,570,4,Sore
6341,2011-09-26,0,9,18,0,1,1,1,0.66,0.6061,0.83,0.1045,63,490,553,553,4,Sore
6342,2011-09-26,0,9,19,0,1,1,1,0.66,0.6061,0.82,0.0896,36,347,383,383,4,Malam
6343,2011-09-26,0,9,20,0,1,1,1,0.64,0.5758,0.89,0.1343,24,227,251,251,4,Malam
6344,2011-09-26,0,9,21,0,1,1,1,0.64,0.5758,0.89,0.1343,18,164,182,182,4,Malam
6345,2011-09-26,0,9,22,0,1,1,1,0.62,0.5455,0.94,0.1343,14,122,136,136,4,Malam
6346,2011-09-26,0,9,23,0,1,1,1,0.62,0.5455,0.94,0.1343,11,64,75,75,4,Malam
6347,2011-09-27,0,9,0,0,2,1,1,0.62,0.5455,0.94,0.1343,9,28,37,37,4,
6348,2011-09-27,0,9,1,0,2,1,1,0.62,0.5455,0.94,0.1642,4,6,10,10,4,Pagi
6349,2011-09-27,0,9,2,0,2,1,1,0.62,0.5455,0.94,0.1045,7,4,11,11,4,Pagi
6350,2011-09-27,0,9,3,0,2,1,2,0.62,0.5455,0.94,0.0,5,5,10,10,4,Pagi
6351,2011-09-27,0,9,4,0,2,1,3,0.62,0.5455,0.94,0.0896,5,3,8,8,4,Pagi
6352,2011-09-27,0,9,5,0,2,1,3,0.62,0.5455,0.94,0.0896,0,24,24,24,4,Pagi
6353,2011-09-27,0,9,6,0,2,1,2,0.62,0.5455,0.94,0.1045,8,116,124,124,4,Pagi
6354,2011-09-27,0,9,7,0,2,1,2,0.62,0.5455,0.94,0.1045,15,234,249,249,4,Siang
6355,2011-09-27,0,9,8,0,2,1,2,0.64,0.5758,0.89,0.1045,27,400,427,427,4,Siang
6356,2011-09-27,0,9,9,0,2,1,3,0.64,0.5758,0.89,0.194,20,173,193,193,4,Siang
6357,2011-09-27,0,9,10,0,2,1,3,0.64,0.5606,0.94,0.1642,21,101,122,122,4,Siang
6358,2011-09-27,0,9,11,0,2,1,2,0.66,0.5909,0.89,0.1045,26,97,123,123,4,Siang
6359,2011-09-27,0,9,12,0,2,1,2,0.66,0.5909,0.89,0.1343,33,129,162,162,4,Siang
6360,2011-09-27,0,9,13,0,2,1,2,0.7,0.6667,0.74,0.2239,29,122,151,151,4,Sore
6361,2011-09-27,0,9,14,0,2,1,2,0.68,0.6364,0.79,0.1045,29,123,152,152,4,Sore
6362,2011-09-27,0,9,15,0,2,1,2,0.68,0.6364,0.83,0.0896,35,170,205,205,4,Sore
6363,2011-09-27,0,9,16,0,2,1,2,0.66,0.6061,0.83,0.194,33,225,258,258,4,Sore
6364,2011-09-27,0,9,17,0,2,1,2,0.66,0.5909,0.89,0.194,50,480,530,530,4,Sore
6365,2011-09-27,0,9,18,0,2,1,2,0.64,0.5758,0.89,0.2239,31,325,356,356,4,Sore
6366,2011-09-27,0,9,19,0,2,1,2,0.64,0.5758,0.89,0.1343,26,294,320,320,4,Malam
6367,2011-09-27,0,9,20,0,2,1,1,0.62,0.5909,0.78,0.0,17,221,238,238,4,Malam
6368,2011-09-27,0,9,21,0,2,1,1,0.6,0.5606,0.83,0.0,17,179,196,196,4,Malam
6369,2011-09-27,0,9,22,0,2,1,1,0.6,0.5455,0.88,0.0896,19,102,121,121,4,Malam
6370,2011-09-27,0,9,23,0,2,1,1,0.6,0.5455,0.88,0.0896,11,82,93,93,4,Malam
6371,2011-09-28,0,9,0,0,3,1,1,0.6,0.5455,0.88,0.0,7,29,36,36,4,
6372,2011-09-28,0,9,1,0,3,1,1,0.6,0.5455,0.88,0.0,1,13,14,14,4,Pagi
6373,2011-09-28,0,9,2,0,3,1,1,0.6,0.5455,0.88,0.2537,0,9,9,9,4,Pagi
6374,2011-09-28,0,9,3,0,3,1,2,0.6,0.5152,0.94,0.0896,0,3,3,3,4,Pagi
6375,2011-09-28,0,9,4,0,3,1,1,0.6,0.5455,0.88,0.0,1,3,4,4,4,Pagi
6376,2011-09-28,0,9,5,0,3,1,2,0.6,0.5152,0.94,0.0,2,20,22,22,4,Pagi
6377,2011-09-28,0,9,6,0,3,1,3,0.6,0.5152,0.94,0.1642,3,111,114,114,4,Pagi
6378,2011-09-28,0,9,7,0,3,1,3,0.6,0.5152,0.94,0.1642,8,177,185,185,4,Siang
6379,2011-09-28,0,9,8,0,3,1,3,0.62,0.5455,0.94,0.2239,17,270,287,287,4,Siang
6380,2011-09-28,0,9,9,0,3,1,3,0.62,0.5455,0.94,0.2239,14,141,155,155,4,Siang
6381,2011-09-28,0,9,10,0,3,1,2,0.62,0.5455,0.94,0.0,20,109,129,129,4,Siang
6382,2011-09-28,0,9,11,0,3,1,2,0.66,0.6061,0.83,0.1045,24,127,151,151,4,Siang
6383,2011-09-28,0,9,12,0,3,1,2,0.68,0.6364,0.79,0.0,25,159,184,184,4,Siang
6384,2011-09-28,0,9,13,0,3,1,1,0.7,0.6667,0.74,0.2537,24,138,162,162,4,Sore
6385,2011-09-28,0,9,14,0,3,1,1,0.72,0.6818,0.62,0.2537,25,145,170,170,4,Sore
6386,2011-09-28,0,9,15,0,3,1,1,0.7,0.6515,0.7,0.1343,35,146,181,181,4,Sore
6387,2011-09-28,0,9,16,0,3,1,1,0.7,0.6515,0.7,0.194,39,241,280,280,4,Sore
6388,2011-09-28,0,9,17,0,3,1,1,0.7,0.6515,0.7,0.2239,64,527,591,591,4,Sore
6389,2011-09-28,0,9,18,0,3,1,3,0.66,0.6061,0.83,0.2537,65,459,524,524,4,Sore
6390,2011-09-28,0,9,19,0,3,1,3,0.66,0.6061,0.83,0.2537,57,315,372,372,4,Malam
6391,2011-09-28,0,9,20,0,3,1,3,0.6,0.5606,0.83,0.2985,11,91,102,102,4,Malam
6392,2011-09-28,0,9,21,0,3,1,3,0.6,0.5455,0.88,0.2537,7,67,74,74,4,Malam
6393,2011-09-28,0,9,22,0,3,1,1,0.6,0.5455,0.88,0.0896,19,68,87,87,4,Malam
6394,2011-09-28,0,9,23,0,3,1,1,0.6,0.5152,0.94,0.1343,12,59,71,71,4,Malam
6395,2011-09-29,0,9,0,0,4,1,1,0.6,0.5152,0.94,0.194,7,33,40,40,4,
6396,2011-09-29,0,9,1,0,4,1,2,0.6,0.5,1.0,0.194,3,20,23,23,4,Pagi
6397,2011-09-29,0,9,2,0,4,1,2,0.6,0.5,1.0,0.194,0,2,2,2,4,Pagi
6398,2011-09-29,0,9,3,0,4,1,2,0.6,0.5152,0.94,0.194,0,8,8,8,4,Pagi
6399,2011-09-29,0,9,4,0,4,1,2,0.6,0.5455,0.88,0.194,2,5,7,7,4,Pagi
6400,2011-09-29,0,9,5,0,4,1,2,0.6,0.5455,0.88,0.1045,0,22,22,22,4,Pagi
6401,2011-09-29,0,9,6,0,4,1,2,0.6,0.5455,0.88,0.0896,5,106,111,111,4,Pagi
6402,2011-09-29,0,9,7,0,4,1,1,0.6,0.5455,0.88,0.1343,14,269,283,283,4,Siang
6403,2011-09-29,0,9,8,0,4,1,1,0.6,0.5606,0.83,0.0,29,402,431,431,4,Siang
6404,2011-09-29,0,9,9,0,4,1,1,0.62,0.5909,0.78,0.2537,27,198,225,225,4,Siang
6405,2011-09-29,0,9,10,0,4,1,1,0.64,0.6061,0.65,0.194,24,103,127,127,4,Siang
6406,2011-09-29,0,9,11,0,4,1,1,0.62,0.6061,0.61,0.194,36,122,158,158,4,Siang
6407,2011-09-29,0,9,12,0,4,1,1,0.66,0.6212,0.61,0.1642,38,157,195,195,4,Siang
6408,2011-09-29,0,9,13,0,4,1,1,0.64,0.6212,0.61,0.194,36,175,211,211,4,Sore
6409,2011-09-29,0,9,14,0,4,1,1,0.68,0.6364,0.51,0.2985,33,134,167,167,4,Sore
6410,2011-09-29,0,9,15,0,4,1,1,0.68,0.6364,0.45,0.3881,42,185,227,227,4,Sore
6411,2011-09-29,0,9,16,0,4,1,1,0.68,0.6364,0.41,0.3582,64,227,291,291,4,Sore
6412,2011-09-29,0,9,17,0,4,1,1,0.66,0.6212,0.47,0.2985,62,527,589,589,4,Sore
6413,2011-09-29,0,9,18,0,4,1,1,0.64,0.6212,0.41,0.2239,84,500,584,584,4,Sore
6414,2011-09-29,0,9,19,0,4,1,1,0.62,0.6212,0.5,0.0896,36,348,384,384,4,Malam
6415,2011-09-29,0,9,20,0,4,1,1,0.6,0.6212,0.53,0.0896,39,234,273,273,4,Malam
6416,2011-09-29,0,9,21,0,4,1,1,0.58,0.5455,0.56,0.0,30,195,225,225,4,Malam
6417,2011-09-29,0,9,22,0,4,1,1,0.56,0.5303,0.68,0.0,25,150,175,175,4,Malam
6418,2011-09-29,0,9,23,0,4,1,1,0.52,0.5,0.77,0.1045,17,64,81,81,4,Malam
6419,2011-09-30,0,9,0,0,5,1,1,0.52,0.5,0.83,0.1045,7,53,60,60,4,
6420,2011-09-30,0,9,1,0,5,1,1,0.52,0.5,0.77,0.0896,5,18,23,23,4,Pagi
6421,2011-09-30,0,9,2,0,5,1,1,0.52,0.5,0.83,0.1045,6,9,15,15,4,Pagi
6422,2011-09-30,0,9,3,0,5,1,1,0.52,0.5,0.83,0.1045,0,3,3,3,4,Pagi
6423,2011-09-30,0,9,4,0,5,1,1,0.52,0.5,0.83,0.194,2,6,8,8,4,Pagi
6424,2011-09-30,0,9,5,0,5,1,1,0.52,0.5,0.83,0.194,3,23,26,26,4,Pagi
6425,2011-09-30,0,9,6,0,5,1,1,0.52,0.5,0.83,0.2239,0,98,98,98,4,Pagi
6426,2011-09-30,0,9,7,0,5,1,1,0.52,0.5,0.83,0.2239,14,283,297,297,4,Siang
6427,2011-09-30,0,9,8,0,5,1,1,0.54,0.5152,0.77,0.1343,31,425,456,456,4,Siang
6428,2011-09-30,0,9,9,0,5,1,1,0.56,0.5303,0.73,0.194,23,214,237,237,4,Siang
6429,2011-09-30,0,9,10,0,5,1,1,0.6,0.6061,0.64,0.0,46,122,168,168,4,Siang
6430,2011-09-30,0,9,11,0,5,1,1,0.64,0.6212,0.57,0.0896,49,168,217,217,4,Siang
6431,2011-09-30,0,9,12,0,5,1,2,0.64,0.6212,0.57,0.194,59,195,254,254,4,Siang
6432,2011-09-30,0,9,13,0,5,1,2,0.66,0.6212,0.47,0.3284,72,194,266,266,4,Sore
6433,2011-09-30,0,9,14,0,5,1,2,0.64,0.6212,0.47,0.2985,93,173,266,266,4,Sore
6434,2011-09-30,0,9,15,0,5,1,1,0.64,0.6212,0.5,0.2836,52,193,245,245,4,Sore
6435,2011-09-30,0,9,16,0,5,1,1,0.62,0.6212,0.53,0.2239,62,298,360,360,4,Sore
6436,2011-09-30,0,9,17,0,5,1,1,0.62,0.6212,0.53,0.194,94,497,591,591,4,Sore
6437,2011-09-30,0,9,18,0,5,1,1,0.58,0.5455,0.49,0.3582,62,449,511,511,4,Sore
6438,2011-09-30,0,9,19,0,5,1,1,0.54,0.5152,0.52,0.2836,42,332,374,374,4,Malam
6439,2011-09-30,0,9,20,0,5,1,1,0.54,0.5152,0.52,0.2836,28,202,230,230,4,Malam
6440,2011-09-30,0,9,21,0,5,1,1,0.52,0.5,0.55,0.194,27,179,206,206,4,Malam
6441,2011-09-30,0,9,22,0,5,1,1,0.52,0.5,0.55,0.3284,30,129,159,159,4,Malam
6442,2011-09-30,0,9,23,0,5,1,1,0.52,0.5,0.55,0.3284,23,109,132,132,4,Malam
6443,2011-10-01,0,10,0,0,6,0,1,0.5,0.4848,0.63,0.3881,24,106,130,130,4,
6444,2011-10-01,0,10,1,0,6,0,1,0.48,0.4697,0.67,0.3284,11,47,58,58,4,Pagi
6445,2011-10-01,0,10,2,0,6,0,1,0.46,0.4545,0.63,0.4179,21,46,67,67,4,Pagi
6446,2011-10-01,0,10,3,0,6,0,1,0.46,0.4545,0.59,0.4179,8,17,25,25,4,Pagi
6447,2011-10-01,0,10,4,0,6,0,1,0.44,0.4394,0.58,0.4179,2,6,8,8,4,Pagi
6448,2011-10-01,0,10,5,0,6,0,2,0.44,0.4394,0.62,0.2985,1,4,5,5,4,Pagi
6449,2011-10-01,0,10,6,0,6,0,1,0.42,0.4242,0.67,0.3284,4,15,19,19,4,Pagi
6450,2011-10-01,0,10,7,0,6,0,3,0.42,0.4242,0.67,0.2537,6,30,36,36,4,Siang
6451,2011-10-01,0,10,8,0,6,0,2,0.4,0.4091,0.76,0.3284,9,58,67,67,4,Siang
6452,2011-10-01,0,10,9,0,6,0,3,0.4,0.4091,0.82,0.3582,17,112,129,129,4,Siang
6453,2011-10-01,0,10,10,0,6,0,3,0.4,0.4091,0.76,0.3582,21,100,121,121,4,Siang
6454,2011-10-01,0,10,11,0,6,0,3,0.38,0.3939,0.82,0.3284,30,102,132,132,4,Siang
6455,2011-10-01,0,10,12,0,6,0,2,0.4,0.4091,0.82,0.2537,28,130,158,158,4,Siang
6456,2011-10-01,0,10,13,0,6,0,2,0.4,0.4091,0.82,0.3284,27,98,125,125,4,Sore
6457,2011-10-01,0,10,14,0,6,0,2,0.42,0.4242,0.71,0.3582,33,147,180,180,4,Sore
6458,2011-10-01,0,10,15,0,6,0,2,0.42,0.4242,0.71,0.2836,41,154,195,195,4,Sore
6459,2011-10-01,0,10,16,0,6,0,2,0.4,0.4091,0.76,0.2985,58,165,223,223,4,Sore
6460,2011-10-01,0,10,17,0,6,0,3,0.4,0.4091,0.76,0.194,58,170,228,228,4,Sore
6461,2011-10-01,0,10,18,0,6,0,3,0.38,0.3939,0.87,0.2239,23,117,140,140,4,Sore
6462,2011-10-01,0,10,19,0,6,0,2,0.38,0.3939,0.82,0.194,27,99,126,126,4,Malam
6463,2011-10-01,0,10,20,0,6,0,3,0.36,0.3636,0.87,0.1045,8,58,66,66,4,Malam
6464,2011-10-01,0,10,21,0,6,0,3,0.36,0.3636,0.87,0.1045,3,53,56,56,4,Malam
6465,2011-10-01,0,10,22,0,6,0,2,0.36,0.3485,0.93,0.2239,12,58,70,70,4,Malam
6466,2011-10-01,0,10,23,0,6,0,3,0.36,0.3485,0.93,0.2239,8,57,65,65,4,Malam
6467,2011-10-02,0,10,0,0,0,0,3,0.36,0.3333,0.93,0.2985,4,43,47,47,4,
6468,2011-10-02,0,10,1,0,0,0,3,0.34,0.3182,0.87,0.2537,1,23,24,24,4,Pagi
6469,2011-10-02,0,10,2,0,0,0,3,0.34,0.303,0.87,0.2985,3,27,30,30,4,Pagi
6470,2011-10-02,0,10,3,0,0,0,3,0.34,0.3182,0.87,0.2836,4,5,9,9,4,Pagi
6471,2011-10-02,0,10,4,0,0,0,2,0.34,0.3182,0.87,0.2537,4,3,7,7,4,Pagi
6472,2011-10-02,0,10,5,0,0,0,1,0.32,0.303,0.87,0.2836,0,7,7,7,4,Pagi
6473,2011-10-02,0,10,6,0,0,0,1,0.32,0.3182,0.81,0.1642,2,13,15,15,4,Pagi
6474,2011-10-02,0,10,7,0,0,0,1,0.34,0.3333,0.76,0.194,5,24,29,29,4,Siang
6475,2011-10-02,0,10,8,0,0,0,2,0.34,0.3333,0.76,0.194,14,50,64,64,4,Siang
6476,2011-10-02,0,10,9,0,0,0,1,0.36,0.3333,0.76,0.3582,19,96,115,115,4,Siang
6477,2011-10-02,0,10,10,0,0,0,2,0.36,0.3333,0.71,0.2836,60,188,248,248,4,Siang
6478,2011-10-02,0,10,11,0,0,0,2,0.38,0.3939,0.66,0.2537,74,218,292,292,4,Siang
6479,2011-10-02,0,10,12,0,0,0,2,0.4,0.4091,0.62,0.194,78,243,321,321,4,Siang
6480,2011-10-02,0,10,13,0,0,0,3,0.4,0.4091,0.62,0.2239,84,224,308,308,4,Sore
6481,2011-10-02,0,10,14,0,0,0,3,0.36,0.3485,0.81,0.1642,61,195,256,256,4,Sore
6482,2011-10-02,0,10,15,0,0,0,3,0.36,0.3333,0.81,0.2537,29,144,173,173,4,Sore
6483,2011-10-02,0,10,16,0,0,0,3,0.36,0.3485,0.87,0.194,44,162,206,206,4,Sore
6484,2011-10-02,0,10,17,0,0,0,3,0.36,0.3485,0.87,0.1642,32,135,167,167,4,Sore
6485,2011-10-02,0,10,18,0,0,0,2,0.36,0.3485,0.81,0.194,16,158,174,174,4,Sore
6486,2011-10-02,0,10,19,0,0,0,2,0.38,0.3939,0.76,0.1642,34,128,162,162,4,Malam
6487,2011-10-02,0,10,20,0,0,0,2,0.36,0.3333,0.76,0.2537,16,71,87,87,4,Malam
6488,2011-10-02,0,10,21,0,0,0,1,0.36,0.3485,0.71,0.2239,17,71,88,88,4,Malam
6489,2011-10-02,0,10,22,0,0,0,3,0.36,0.3636,0.81,0.0896,9,55,64,64,4,Malam
6490,2011-10-02,0,10,23,0,0,0,1,0.36,0.3636,0.81,0.0896,6,19,25,25,4,Malam
6491,2011-10-03,0,10,0,0,1,1,1,0.34,0.3485,0.87,0.1045,3,13,16,16,4,
6492,2011-10-03,0,10,1,0,1,1,1,0.36,0.3636,0.81,0.0896,1,5,6,6,4,Pagi
6493,2011-10-03,0,10,2,0,1,1,1,0.36,0.3636,0.76,0.1045,0,4,4,4,4,Pagi
6494,2011-10-03,0,10,3,0,1,1,1,0.36,0.3788,0.81,0.0,1,6,7,7,4,Pagi
6495,2011-10-03,0,10,4,0,1,1,1,0.34,0.3485,0.87,0.1045,2,6,8,8,4,Pagi
6496,2011-10-03,0,10,5,0,1,1,2,0.36,0.3636,0.76,0.1045,4,17,21,21,4,Pagi
6497,2011-10-03,0,10,6,0,1,1,2,0.36,0.3788,0.71,0.0,3,91,94,94,4,Pagi
6498,2011-10-03,0,10,7,0,1,1,2,0.36,0.3485,0.71,0.1343,8,241,249,249,4,Siang
6499,2011-10-03,0,10,8,0,1,1,2,0.36,0.3636,0.71,0.1045,13,359,372,372,4,Siang
6500,2011-10-03,0,10,9,0,1,1,2,0.4,0.4091,0.66,0.0896,12,141,153,153,4,Siang
6501,2011-10-03,0,10,10,0,1,1,2,0.4,0.4091,0.66,0.1045,19,82,101,101,4,Siang
6502,2011-10-03,0,10,11,0,1,1,2,0.4,0.4091,0.71,0.2239,26,100,126,126,4,Siang
6503,2011-10-03,0,10,12,0,1,1,2,0.4,0.4091,0.71,0.1343,29,118,147,147,4,Siang
6504,2011-10-03,0,10,13,0,1,1,3,0.42,0.4242,0.67,0.1642,16,102,118,118,4,Sore
6505,2011-10-03,0,10,14,0,1,1,3,0.4,0.4091,0.76,0.0,26,94,120,120,4,Sore
6506,2011-10-03,0,10,15,0,1,1,3,0.4,0.4091,0.76,0.0,22,79,101,101,4,Sore
6507,2011-10-03,0,10,16,0,1,1,2,0.4,0.4091,0.76,0.1045,16,202,218,218,4,Sore
6508,2011-10-03,0,10,17,0,1,1,2,0.4,0.4091,0.76,0.1642,40,455,495,495,4,Sore
6509,2011-10-03,0,10,18,0,1,1,2,0.4,0.4091,0.76,0.1642,28,384,412,412,4,Sore
6510,2011-10-03,0,10,19,0,1,1,1,0.4,0.4091,0.76,0.0,15,300,315,315,4,Malam
6511,2011-10-03,0,10,20,0,1,1,3,0.4,0.4091,0.82,0.0,13,191,204,204,4,Malam
6512,2011-10-03,0,10,21,0,1,1,2,0.4,0.4091,0.82,0.0,10,128,138,138,4,Malam
6513,2011-10-03,0,10,22,0,1,1,2,0.4,0.4091,0.82,0.0,12,79,91,91,4,Malam
6514,2011-10-03,0,10,23,0,1,1,2,0.4,0.4091,0.82,0.1045,11,43,54,54,4,Malam
6515,2011-10-04,0,10,0,0,2,1,2,0.4,0.4091,0.87,0.0896,5,22,27,27,4,
6516,2011-10-04,0,10,1,0,2,1,2,0.4,0.4091,0.87,0.1045,1,8,9,9,4,Pagi
6517,2011-10-04,0,10,2,0,2,1,2,0.4,0.4091,0.87,0.0,1,2,3,3,4,Pagi
6518,2011-10-04,0,10,3,0,2,1,1,0.4,0.4091,0.82,0.1045,3,3,6,6,4,Pagi
6519,2011-10-04,0,10,4,0,2,1,1,0.4,0.4091,0.82,0.0896,3,4,7,7,4,Pagi
6520,2011-10-04,0,10,5,0,2,1,1,0.4,0.4091,0.82,0.1343,2,25,27,27,4,Pagi
6521,2011-10-04,0,10,6,0,2,1,1,0.4,0.4091,0.82,0.1045,3,109,112,112,4,Pagi
6522,2011-10-04,0,10,7,0,2,1,1,0.42,0.4242,0.82,0.2836,11,298,309,309,4,Siang
6523,2011-10-04,0,10,8,0,2,1,1,0.44,0.4394,0.77,0.2239,28,372,400,400,4,Siang
6524,2011-10-04,0,10,9,0,2,1,1,0.46,0.4545,0.67,0.2537,19,168,187,187,4,Siang
6525,2011-10-04,0,10,10,0,2,1,1,0.48,0.4697,0.67,0.2836,19,107,126,126,4,Siang
6526,2011-10-04,0,10,11,0,2,1,1,0.54,0.5152,0.64,0.2836,22,102,124,124,4,Siang
6527,2011-10-04,0,10,12,0,2,1,1,0.56,0.5303,0.56,0.2985,39,160,199,199,4,Siang
6528,2011-10-04,0,10,13,0,2,1,1,0.56,0.5303,0.56,0.2985,20,153,173,173,4,Sore
6529,2011-10-04,0,10,14,0,2,1,1,0.58,0.5455,0.53,0.2537,27,156,183,183,4,Sore
6530,2011-10-04,0,10,15,0,2,1,1,0.58,0.5455,0.56,0.2836,28,166,194,194,4,Sore
6531,2011-10-04,0,10,16,0,2,1,1,0.58,0.5455,0.56,0.3284,36,273,309,309,4,Sore
6532,2011-10-04,0,10,17,0,2,1,1,0.56,0.5303,0.6,0.3881,55,530,585,585,4,Sore
6533,2011-10-04,0,10,18,0,2,1,1,0.54,0.5152,0.64,0.2836,68,456,524,524,4,Sore
6534,2011-10-04,0,10,19,0,2,1,1,0.52,0.5,0.68,0.2239,35,310,345,345,4,Malam
6535,2011-10-04,0,10,20,0,2,1,1,0.52,0.5,0.68,0.2239,25,236,261,261,4,Malam
6536,2011-10-04,0,10,21,0,2,1,1,0.5,0.4848,0.72,0.1343,22,144,166,166,4,Malam
6537,2011-10-04,0,10,22,0,2,1,1,0.5,0.4848,0.72,0.1343,8,106,114,114,4,Malam
6538,2011-10-04,0,10,23,0,2,1,1,0.48,0.4697,0.77,0.1343,6,60,66,66,4,Malam
6539,2011-10-05,0,10,0,0,3,1,1,0.48,0.4697,0.77,0.1343,7,36,43,43,4,
6540,2011-10-05,0,10,1,0,3,1,1,0.48,0.4697,0.77,0.1642,4,7,11,11,4,Pagi
6541,2011-10-05,0,10,2,0,3,1,1,0.46,0.4545,0.82,0.1642,1,2,3,3,4,Pagi
6542,2011-10-05,0,10,3,0,3,1,1,0.46,0.4545,0.82,0.1045,1,5,6,6,4,Pagi
6543,2011-10-05,0,10,4,0,3,1,1,0.44,0.4394,0.88,0.0,1,4,5,5,4,Pagi
6544,2011-10-05,0,10,5,0,3,1,1,0.44,0.4394,0.82,0.1343,3,29,32,32,4,Pagi
6545,2011-10-05,0,10,6,0,3,1,1,0.44,0.4394,0.82,0.1045,5,112,117,117,4,Pagi
6546,2011-10-05,0,10,7,0,3,1,1,0.46,0.4545,0.77,0.1045,9,292,301,301,4,Siang
6547,2011-10-05,0,10,8,0,3,1,1,0.52,0.5,0.63,0.0,26,441,467,467,4,Siang
6548,2011-10-05,0,10,9,0,3,1,1,0.54,0.5152,0.6,0.2985,32,187,219,219,4,Siang
6549,2011-10-05,0,10,10,0,3,1,1,0.56,0.5303,0.56,0.3881,30,103,133,133,4,Siang
6550,2011-10-05,0,10,11,0,3,1,1,0.6,0.6212,0.46,0.2836,32,138,170,170,4,Siang
6551,2011-10-05,0,10,12,0,3,1,1,0.62,0.6212,0.43,0.3284,34,180,214,214,4,Siang
6552,2011-10-05,0,10,13,0,3,1,1,0.64,0.6212,0.41,0.2239,30,189,219,219,4,Sore
6553,2011-10-05,0,10,14,0,3,1,1,0.64,0.6212,0.41,0.2836,34,156,190,190,4,Sore
6554,2011-10-05,0,10,15,0,3,1,1,0.64,0.6212,0.47,0.2836,35,147,182,182,4,Sore
6555,2011-10-05,0,10,16,0,3,1,1,0.64,0.6212,0.47,0.3284,37,245,282,282,4,Sore
6556,2011-10-05,0,10,17,0,3,1,1,0.64,0.6212,0.47,0.2537,66,525,591,591,4,Sore
6557,2011-10-05,0,10,18,0,3,1,1,0.6,0.6212,0.53,0.1642,57,536,593,593,4,Sore
6558,2011-10-05,0,10,19,0,3,1,1,0.58,0.5455,0.56,0.1343,40,334,374,374,4,Malam
6559,2011-10-05,0,10,20,0,3,1,1,0.52,0.5,0.77,0.1642,18,228,246,246,4,Malam
6560,2011-10-05,0,10,21,0,3,1,1,0.5,0.4848,0.82,0.1045,28,173,201,201,4,Malam
6561,2011-10-05,0,10,22,0,3,1,1,0.52,0.5,0.72,0.0,20,134,154,154,4,Malam
6562,2011-10-05,0,10,23,0,3,1,1,0.5,0.4848,0.77,0.1045,9,64,73,73,4,Malam
6563,2011-10-06,0,10,0,0,4,1,1,0.5,0.4848,0.72,0.194,6,34,40,40,4,
6564,2011-10-06,0,10,1,0,4,1,1,0.48,0.4697,0.63,0.194,5,17,22,22,4,Pagi
6565,2011-10-06,0,10,2,0,4,1,1,0.46,0.4545,0.67,0.194,2,8,10,10,4,Pagi
6566,2011-10-06,0,10,3,0,4,1,1,0.44,0.4394,0.67,0.2239,1,4,5,5,4,Pagi
6567,2011-10-06,0,10,4,0,4,1,1,0.44,0.4394,0.62,0.2836,0,5,5,5,4,Pagi
6568,2011-10-06,0,10,5,0,4,1,1,0.42,0.4242,0.62,0.194,0,24,24,24,4,Pagi
6569,2011-10-06,0,10,6,0,4,1,1,0.4,0.4091,0.66,0.194,4,110,114,114,4,Pagi
6570,2011-10-06,0,10,7,0,4,1,1,0.42,0.4242,0.62,0.194,15,287,302,302,4,Siang
6571,2011-10-06,0,10,8,0,4,1,1,0.44,0.4394,0.62,0.1642,20,437,457,457,4,Siang
6572,2011-10-06,0,10,9,0,4,1,1,0.46,0.4545,0.63,0.194,20,188,208,208,4,Siang
6573,2011-10-06,0,10,10,0,4,1,1,0.52,0.5,0.52,0.0,24,105,129,129,4,Siang
6574,2011-10-06,0,10,11,0,4,1,1,0.54,0.5152,0.49,0.0,29,115,144,144,4,Siang
6575,2011-10-06,0,10,12,0,4,1,1,0.56,0.5303,0.49,0.0896,46,180,226,226,4,Siang
6576,2011-10-06,0,10,13,0,4,1,1,0.56,0.5303,0.46,0.0896,33,158,191,191,4,Sore
6577,2011-10-06,0,10,14,0,4,1,1,0.58,0.5455,0.43,0.0896,56,139,195,195,4,Sore
6578,2011-10-06,0,10,15,0,4,1,1,0.58,0.5455,0.46,0.1343,62,157,219,219,4,Sore
6579,2011-10-06,0,10,16,0,4,1,1,0.58,0.5455,0.49,0.194,51,272,323,323,4,Sore
6580,2011-10-06,0,10,17,0,4,1,1,0.56,0.5303,0.52,0.1343,63,505,568,568,4,Sore
6581,2011-10-06,0,10,18,0,4,1,1,0.54,0.5152,0.64,0.0896,59,479,538,538,4,Sore
6582,2011-10-06,0,10,19,0,4,1,1,0.52,0.5,0.59,0.1045,38,305,343,343,4,Malam
6583,2011-10-06,0,10,20,0,4,1,1,0.5,0.4848,0.77,0.1045,29,231,260,260,4,Malam
6584,2011-10-06,0,10,21,0,4,1,1,0.46,0.4545,0.88,0.0896,34,161,195,195,4,Malam
6585,2011-10-06,0,10,22,0,4,1,1,0.46,0.4545,0.82,0.0,24,124,148,148,4,Malam
6586,2011-10-06,0,10,23,0,4,1,1,0.44,0.4394,0.88,0.0896,18,81,99,99,4,Malam
6587,2011-10-07,0,10,0,0,5,1,1,0.44,0.4394,0.88,0.0,19,48,67,67,4,
6588,2011-10-07,0,10,1,0,5,1,1,0.44,0.4394,0.88,0.0,3,25,28,28,4,Pagi
6589,2011-10-07,0,10,2,0,5,1,1,0.42,0.4242,0.88,0.0,0,5,5,5,4,Pagi
6590,2011-10-07,0,10,3,0,5,1,1,0.4,0.4091,0.87,0.0,1,9,10,10,4,Pagi
6591,2011-10-07,0,10,4,0,5,1,1,0.4,0.4091,0.87,0.1045,0,5,5,5,4,Pagi
6592,2011-10-07,0,10,5,0,5,1,1,0.42,0.4242,0.82,0.0,3,24,27,27,4,Pagi
6593,2011-10-07,0,10,6,0,5,1,1,0.42,0.4242,0.88,0.0,3,84,87,87,4,Pagi
6594,2011-10-07,0,10,7,0,5,1,1,0.42,0.4242,0.94,0.0,5,237,242,242,4,Siang
6595,2011-10-07,0,10,8,0,5,1,1,0.46,0.4545,0.82,0.0,31,386,417,417,4,Siang
6596,2011-10-07,0,10,9,0,5,1,1,0.48,0.4697,0.77,0.0,34,207,241,241,4,Siang
6597,2011-10-07,0,10,10,0,5,1,1,0.52,0.5,0.68,0.0896,48,126,174,174,4,Siang
6598,2011-10-07,0,10,11,0,5,1,1,0.56,0.5303,0.63,0.0,80,150,230,230,4,Siang
6599,2011-10-07,0,10,12,0,5,1,1,0.6,0.6212,0.53,0.0,61,174,235,235,4,Siang
6600,2011-10-07,0,10,13,0,5,1,1,0.6,0.6212,0.46,0.0,95,210,305,305,4,Sore
6601,2011-10-07,0,10,14,0,5,1,1,0.62,0.6212,0.5,0.0,77,179,256,256,4,Sore
6602,2011-10-07,0,10,15,0,5,1,1,0.66,0.6212,0.41,0.0,68,202,270,270,4,Sore
6603,2011-10-07,0,10,16,0,5,1,1,0.64,0.6212,0.44,0.0,73,346,419,419,4,Sore
6604,2011-10-07,0,10,17,0,5,1,1,0.6,0.6212,0.56,0.2537,101,462,563,563,4,Sore
6605,2011-10-07,0,10,18,0,5,1,1,0.56,0.5303,0.6,0.0896,94,371,465,465,4,Sore
6606,2011-10-07,0,10,19,0,5,1,1,0.56,0.5303,0.52,0.0,51,243,294,294,4,Malam
6607,2011-10-07,0,10,20,0,5,1,1,0.54,0.5152,0.49,0.0,30,167,197,197,4,Malam
6608,2011-10-07,0,10,21,0,5,1,1,0.5,0.4848,0.68,0.0,22,144,166,166,4,Malam
6609,2011-10-07,0,10,22,0,5,1,1,0.5,0.4848,0.68,0.0,27,119,146,146,4,Malam
6610,2011-10-07,0,10,23,0,5,1,1,0.5,0.4848,0.63,0.0,23,113,136,136,4,Malam
6611,2011-10-08,0,10,0,0,6,0,1,0.48,0.4697,0.72,0.0,17,72,89,89,4,
6612,2011-10-08,0,10,1,0,6,0,1,0.46,0.4545,0.82,0.0,14,51,65,65,4,Pagi
6613,2011-10-08,0,10,2,0,6,0,1,0.46,0.4545,0.82,0.0,4,41,45,45,4,Pagi
6614,2011-10-08,0,10,3,0,6,0,1,0.44,0.4394,0.88,0.0,4,16,20,20,4,Pagi
6615,2011-10-08,0,10,4,0,6,0,1,0.42,0.4242,0.94,0.1343,3,7,10,10,4,Pagi
6616,2011-10-08,0,10,5,0,6,0,1,0.42,0.4242,0.88,0.1045,1,7,8,8,4,Pagi
6617,2011-10-08,0,10,6,0,6,0,1,0.42,0.4242,0.94,0.0,6,16,22,22,4,Pagi
6618,2011-10-08,0,10,7,0,6,0,1,0.42,0.4242,0.94,0.0896,27,46,73,73,4,Siang
6619,2011-10-08,0,10,8,0,6,0,1,0.46,0.4545,0.82,0.0,14,89,103,103,4,Siang
6620,2011-10-08,0,10,9,0,6,0,1,0.5,0.4848,0.77,0.0,54,163,217,217,4,Siang
6621,2011-10-08,0,10,10,0,6,0,1,0.52,0.5,0.77,0.0,120,217,337,337,4,Siang
6622,2011-10-08,0,10,11,0,6,0,1,0.58,0.5455,0.56,0.0,176,221,397,397,4,Siang
6623,2011-10-08,0,10,12,0,6,0,1,0.62,0.6212,0.35,0.0,191,255,446,446,4,Siang
6624,2011-10-08,0,10,13,0,6,0,1,0.62,0.6212,0.46,0.1045,256,229,485,485,4,Sore
6625,2011-10-08,0,10,14,0,6,0,1,0.62,0.6212,0.5,0.0896,251,214,465,465,4,Sore
6626,2011-10-08,0,10,15,0,6,0,1,0.66,0.6212,0.39,0.0,262,234,496,496,4,Sore
6627,2011-10-08,0,10,16,0,6,0,1,0.64,0.6212,0.44,0.0896,221,230,451,451,4,Sore
6628,2011-10-08,0,10,17,0,6,0,1,0.62,0.6212,0.5,0.1343,174,219,393,393,4,Sore
6629,2011-10-08,0,10,18,0,6,0,1,0.6,0.6212,0.46,0.1045,135,224,359,359,4,Sore
6630,2011-10-08,0,10,19,0,6,0,1,0.54,0.5152,0.68,0.1343,76,172,248,248,4,Malam
6631,2011-10-08,0,10,20,0,6,0,1,0.52,0.5,0.77,0.1045,78,124,202,202,4,Malam
6632,2011-10-08,0,10,21,0,6,0,1,0.52,0.5,0.77,0.0,54,133,187,187,4,Malam
6633,2011-10-08,0,10,22,0,6,0,1,0.5,0.4848,0.77,0.0,45,104,149,149,4,Malam
6634,2011-10-08,0,10,23,0,6,0,1,0.48,0.4697,0.88,0.0,52,90,142,142,4,Malam
6635,2011-10-09,0,10,0,0,0,0,1,0.46,0.4545,0.88,0.0896,46,83,129,129,4,
6636,2011-10-09,0,10,1,0,0,0,1,0.46,0.4545,0.88,0.0,15,63,78,78,4,Pagi
6637,2011-10-09,0,10,2,0,0,0,1,0.46,0.4545,0.88,0.0,20,35,55,55,4,Pagi
6638,2011-10-09,0,10,3,0,0,0,1,0.44,0.4394,0.88,0.0,10,20,30,30,4,Pagi
6639,2011-10-09,0,10,4,0,0,0,1,0.44,0.4394,0.88,0.0,7,7,14,14,4,Pagi
6640,2011-10-09,0,10,5,0,0,0,1,0.44,0.4394,0.88,0.0,1,14,15,15,4,Pagi
6641,2011-10-09,0,10,6,0,0,0,1,0.44,0.4394,0.88,0.0,7,14,21,21,4,Pagi
6642,2011-10-09,0,10,7,0,0,0,1,0.44,0.4394,0.86,0.0,18,26,44,44,4,Siang
6643,2011-10-09,0,10,8,0,0,0,1,0.46,0.4545,0.88,0.0,25,82,107,107,4,Siang
6644,2011-10-09,0,10,9,0,0,0,1,0.5,0.4848,0.77,0.0,66,119,185,185,4,Siang
6645,2011-10-09,0,10,10,0,0,0,1,0.56,0.5303,0.68,0.0896,155,210,365,365,4,Siang
6646,2011-10-09,0,10,11,0,0,0,1,0.62,0.6212,0.53,0.0896,189,234,423,423,4,Siang
6647,2011-10-09,0,10,12,0,0,0,1,0.64,0.6212,0.44,0.0896,212,243,455,455,4,Siang
6648,2011-10-09,0,10,13,0,0,0,1,0.66,0.6212,0.44,0.0896,225,193,418,418,4,Sore
6649,2011-10-09,0,10,14,0,0,0,1,0.68,0.6364,0.47,0.1642,272,228,500,500,4,Sore
6650,2011-10-09,0,10,15,0,0,0,1,0.68,0.6364,0.51,0.1642,198,209,407,407,4,Sore
6651,2011-10-09,0,10,16,0,0,0,1,0.66,0.6212,0.5,0.1343,223,247,470,470,4,Sore
6652,2011-10-09,0,10,17,0,0,0,1,0.62,0.6061,0.61,0.1045,208,230,438,438,4,Sore
6653,2011-10-09,0,10,18,0,0,0,1,0.64,0.6212,0.5,0.1045,186,228,414,414,4,Sore
6654,2011-10-09,0,10,19,0,0,0,1,0.56,0.5303,0.73,0.0896,116,186,302,302,4,Malam
6655,2011-10-09,0,10,20,0,0,0,1,0.56,0.5303,0.73,0.1045,59,134,193,193,4,Malam
6656,2011-10-09,0,10,21,0,0,0,1,0.54,0.5152,0.83,0.1045,53,120,173,173,4,Malam
6657,2011-10-09,0,10,22,0,0,0,2,0.52,0.5,0.94,0.0,48,104,152,152,4,Malam
6658,2011-10-09,0,10,23,0,0,0,1,0.5,0.4848,0.88,0.1045,38,85,123,123,4,Malam
6659,2011-10-10,0,10,0,1,1,0,1,0.5,0.4848,0.94,0.0,11,42,53,53,4,
6660,2011-10-10,0,10,1,1,1,0,1,0.48,0.4697,0.88,0.0,4,30,34,34,4,Pagi
6661,2011-10-10,0,10,2,1,1,0,1,0.48,0.4697,0.88,0.0,4,15,19,19,4,Pagi
6662,2011-10-10,0,10,3,1,1,0,1,0.46,0.4545,0.88,0.0,2,9,11,11,4,Pagi
6663,2011-10-10,0,10,4,1,1,0,1,0.46,0.4545,0.94,0.0,2,4,6,6,4,Pagi
6664,2011-10-10,0,10,5,1,1,0,1,0.46,0.4545,0.94,0.0,2,19,21,21,4,Pagi
6665,2011-10-10,0,10,6,1,1,0,1,0.44,0.4394,0.94,0.0,5,39,44,44,4,Pagi
6666,2011-10-10,0,10,7,1,1,0,1,0.46,0.4545,0.88,0.0,12,102,114,114,4,Siang
6667,2011-10-10,0,10,8,1,1,0,1,0.52,0.5,0.83,0.0,27,227,254,254,4,Siang
6668,2011-10-10,0,10,9,1,1,0,1,0.54,0.5152,0.77,0.0,58,161,219,219,4,Siang
6669,2011-10-10,0,10,10,1,1,0,1,0.56,0.5303,0.73,0.1642,107,158,265,265,4,Siang
6670,2011-10-10,0,10,11,1,1,0,1,0.62,0.6061,0.69,0.0896,139,183,322,322,4,Siang
6671,2011-10-10,0,10,12,1,1,0,2,0.7,0.6515,0.48,0.0896,164,201,365,365,4,Siang
6672,2011-10-10,0,10,13,1,1,0,1,0.72,0.6515,0.37,0.0,146,219,365,365,4,Sore
6673,2011-10-10,0,10,14,1,1,0,1,0.74,0.6515,0.37,0.0,147,223,370,370,4,Sore
6674,2011-10-10,0,10,15,1,1,0,2,0.72,0.6515,0.42,0.1045,130,254,384,384,4,Sore
6675,2011-10-10,0,10,16,1,1,0,2,0.7,0.6364,0.45,0.0896,154,248,402,402,4,Sore
6676,2011-10-10,0,10,17,1,1,0,2,0.66,0.6212,0.54,0.1045,125,334,459,459,4,Sore
6677,2011-10-10,0,10,18,1,1,0,2,0.64,0.6212,0.53,0.0,108,365,473,473,4,Sore
6678,2011-10-10,0,10,19,1,1,0,2,0.58,0.5455,0.78,0.0896,69,267,336,336,4,Malam
6679,2011-10-10,0,10,20,1,1,0,1,0.6,0.5909,0.73,0.0,37,188,225,225,4,Malam
6680,2011-10-10,0,10,21,1,1,0,1,0.56,0.5303,0.88,0.0896,27,148,175,175,4,Malam
6681,2011-10-10,0,10,22,1,1,0,1,0.56,0.5303,0.88,0.0896,22,104,126,126,4,Malam
6682,2011-10-10,0,10,23,1,1,0,2,0.54,0.5152,0.88,0.1045,12,63,75,75,4,Malam
6683,2011-10-11,0,10,0,0,2,1,2,0.54,0.5152,0.88,0.0,14,16,30,30,4,
6684,2011-10-11,0,10,1,0,2,1,2,0.52,0.5,0.94,0.0896,2,9,11,11,4,Pagi
6685,2011-10-11,0,10,2,0,2,1,2,0.52,0.5,0.94,0.1343,1,4,5,5,4,Pagi
6686,2011-10-11,0,10,3,0,2,1,2,0.52,0.5,0.88,0.1045,2,1,3,3,4,Pagi
6687,2011-10-11,0,10,4,0,2,1,2,0.52,0.5,0.88,0.1343,0,5,5,5,4,Pagi
6688,2011-10-11,0,10,5,0,2,1,2,0.52,0.5,0.88,0.0,0,20,20,20,4,Pagi
6689,2011-10-11,0,10,6,0,2,1,1,0.52,0.5,0.83,0.0896,9,114,123,123,4,Pagi
6690,2011-10-11,0,10,7,0,2,1,2,0.52,0.5,0.88,0.0896,19,333,352,352,4,Siang
6691,2011-10-11,0,10,8,0,2,1,2,0.56,0.5303,0.83,0.1045,31,375,406,406,4,Siang
6692,2011-10-11,0,10,9,0,2,1,2,0.6,0.5909,0.69,0.0,40,195,235,235,4,Siang
6693,2011-10-11,0,10,10,0,2,1,2,0.6,0.5909,0.69,0.1343,38,111,149,149,4,Siang
6694,2011-10-11,0,10,11,0,2,1,2,0.6,0.5909,0.73,0.1642,31,92,123,123,4,Siang
6695,2011-10-11,0,10,12,0,2,1,2,0.6,0.5909,0.73,0.1642,51,130,181,181,4,Siang
6696,2011-10-11,0,10,13,0,2,1,2,0.6,0.5909,0.73,0.194,42,138,180,180,4,Sore
6697,2011-10-11,0,10,14,0,2,1,3,0.6,0.5909,0.73,0.1045,54,117,171,171,4,Sore
6698,2011-10-11,0,10,15,0,2,1,2,0.6,0.5758,0.78,0.1642,36,139,175,175,4,Sore
6699,2011-10-11,0,10,16,0,2,1,2,0.6,0.5909,0.73,0.1642,63,257,320,320,4,Sore
6700,2011-10-11,0,10,17,0,2,1,2,0.6,0.5758,0.78,0.2537,70,534,604,604,4,Sore
6701,2011-10-11,0,10,18,0,2,1,2,0.6,0.5758,0.78,0.2239,46,493,539,539,4,Sore
6702,2011-10-11,0,10,19,0,2,1,2,0.58,0.5455,0.83,0.2239,33,285,318,318,4,Malam
6703,2011-10-11,0,10,20,0,2,1,2,0.58,0.5455,0.83,0.2239,31,203,234,234,4,Malam
6704,2011-10-11,0,10,21,0,2,1,2,0.58,0.5455,0.78,0.194,17,158,175,175,4,Malam
6705,2011-10-11,0,10,22,0,2,1,2,0.56,0.5303,0.83,0.194,27,120,147,147,4,Malam
6706,2011-10-11,0,10,23,0,2,1,2,0.56,0.5303,0.83,0.2836,10,47,57,57,4,Malam
6707,2011-10-12,0,10,0,0,3,1,2,0.56,0.5303,0.83,0.1343,2,23,25,25,4,
6708,2011-10-12,0,10,1,0,3,1,3,0.56,0.5303,0.83,0.1343,2,8,10,10,4,Pagi
6709,2011-10-12,0,10,2,0,3,1,2,0.56,0.5303,0.83,0.2836,0,2,2,2,4,Pagi
6710,2011-10-12,0,10,3,0,3,1,3,0.54,0.5152,0.94,0.2985,0,2,2,2,4,Pagi
6711,2011-10-12,0,10,4,0,3,1,3,0.54,0.5152,0.94,0.3881,1,6,7,7,4,Pagi
6712,2011-10-12,0,10,5,0,3,1,2,0.54,0.5152,0.88,0.3284,0,22,22,22,4,Pagi
6713,2011-10-12,0,10,6,0,3,1,2,0.54,0.5152,0.88,0.2537,5,107,112,112,4,Pagi
6714,2011-10-12,0,10,7,0,3,1,2,0.54,0.5152,0.88,0.3881,15,244,259,259,4,Siang
6715,2011-10-12,0,10,8,0,3,1,2,0.54,0.5152,0.88,0.3881,27,377,404,404,4,Siang
6716,2011-10-12,0,10,9,0,3,1,2,0.54,0.5152,0.88,0.4478,14,183,197,197,4,Siang
6717,2011-10-12,0,10,10,0,3,1,2,0.54,0.5152,0.88,0.3881,15,98,113,113,4,Siang
6718,2011-10-12,0,10,11,0,3,1,3,0.54,0.5152,0.94,0.3284,18,102,120,120,4,Siang
6719,2011-10-12,0,10,12,0,3,1,3,0.54,0.5152,0.88,0.3284,9,53,62,62,4,Siang
6720,2011-10-12,0,10,13,0,3,1,3,0.54,0.5152,0.88,0.2239,25,76,101,101,4,Sore
6721,2011-10-12,0,10,14,0,3,1,3,0.54,0.5152,0.94,0.2836,8,70,78,78,4,Sore
6722,2011-10-12,0,10,15,0,3,1,3,0.54,0.5152,0.94,0.2537,3,42,45,45,4,Sore
6723,2011-10-12,0,10,16,0,3,1,2,0.56,0.5303,0.88,0.2239,5,50,55,55,4,Sore
6724,2011-10-12,0,10,17,0,3,1,3,0.54,0.5152,0.94,0.2239,16,235,251,251,4,Sore
6725,2011-10-12,0,10,18,0,3,1,3,0.54,0.5152,0.94,0.1343,11,161,172,172,4,Sore
6726,2011-10-12,0,10,19,0,3,1,3,0.54,0.5152,0.94,0.1343,7,102,109,109,4,Malam
6727,2011-10-12,0,10,20,0,3,1,3,0.54,0.5152,0.94,0.1045,9,81,90,90,4,Malam
6728,2011-10-12,0,10,21,0,3,1,3,0.54,0.5152,1.0,0.1045,9,74,83,83,4,Malam
6729,2011-10-12,0,10,22,0,3,1,3,0.54,0.5152,0.94,0.0896,3,40,43,43,4,Malam
6730,2011-10-12,0,10,23,0,3,1,3,0.54,0.5152,0.94,0.0896,13,41,54,54,4,Malam
6731,2011-10-13,0,10,0,0,4,1,2,0.54,0.5152,0.94,0.1343,1,14,15,15,4,
6732,2011-10-13,0,10,1,0,4,1,2,0.54,0.5152,0.94,0.0,3,9,12,12,4,Pagi
6733,2011-10-13,0,10,2,0,4,1,2,0.54,0.5152,0.94,0.0,0,4,4,4,4,Pagi
6734,2011-10-13,0,10,3,0,4,1,2,0.54,0.5152,1.0,0.194,2,4,6,6,4,Pagi
6735,2011-10-13,0,10,4,0,4,1,2,0.54,0.5152,1.0,0.1045,2,5,7,7,4,Pagi
6736,2011-10-13,0,10,5,0,4,1,2,0.54,0.5152,1.0,0.1045,1,16,17,17,4,Pagi
6737,2011-10-13,0,10,6,0,4,1,3,0.54,0.5152,1.0,0.0896,1,51,52,52,4,Pagi
6738,2011-10-13,0,10,7,0,4,1,3,0.54,0.5152,1.0,0.1343,5,76,81,81,4,Siang
6739,2011-10-13,0,10,8,0,4,1,3,0.54,0.5152,1.0,0.0896,10,199,209,209,4,Siang
6740,2011-10-13,0,10,9,0,4,1,3,0.56,0.5303,1.0,0.1045,3,106,109,109,4,Siang
6741,2011-10-13,0,10,10,0,4,1,3,0.56,0.5303,1.0,0.1343,16,53,69,69,4,Siang
6742,2011-10-13,0,10,11,0,4,1,2,0.62,0.5758,0.83,0.0,8,76,84,84,4,Siang
6743,2011-10-13,0,10,12,0,4,1,2,0.62,0.5606,0.88,0.0,10,95,105,105,4,Siang
6744,2011-10-13,0,10,13,0,4,1,2,0.64,0.5758,0.83,0.1642,20,142,162,162,4,Sore
6745,2011-10-13,0,10,14,0,4,1,1,0.66,0.6061,0.78,0.194,22,111,133,133,4,Sore
6746,2011-10-13,0,10,15,0,4,1,1,0.66,0.6061,0.78,0.194,27,128,155,155,4,Sore
6747,2011-10-13,0,10,16,0,4,1,1,0.66,0.6212,0.74,0.2239,36,240,276,276,4,Sore
6748,2011-10-13,0,10,17,0,4,1,3,0.62,0.5758,0.83,0.2537,47,432,479,479,4,Sore
6749,2011-10-13,0,10,18,0,4,1,3,0.62,0.5758,0.83,0.2537,20,248,268,268,4,Sore
6750,2011-10-13,0,10,19,0,4,1,2,0.62,0.5758,0.83,0.1642,18,187,205,205,4,Malam
6751,2011-10-13,0,10,20,0,4,1,1,0.62,0.5758,0.83,0.2836,15,166,181,181,4,Malam
6752,2011-10-13,0,10,21,0,4,1,1,0.62,0.5758,0.83,0.194,8,115,123,123,4,Malam
6753,2011-10-13,0,10,22,0,4,1,1,0.62,0.5758,0.83,0.194,13,101,114,114,4,Malam
6754,2011-10-13,0,10,23,0,4,1,2,0.58,0.5455,0.88,0.194,2,45,47,47,4,Malam
6755,2011-10-14,0,10,0,0,5,1,1,0.58,0.5455,0.94,0.0896,10,29,39,39,4,
6756,2011-10-14,0,10,1,0,5,1,1,0.58,0.5455,0.94,0.1343,8,16,24,24,4,Pagi
6757,2011-10-14,0,10,2,0,5,1,1,0.56,0.5303,0.94,0.1642,0,6,6,6,4,Pagi
6758,2011-10-14,0,10,3,0,5,1,1,0.56,0.5303,0.94,0.1343,1,6,7,7,4,Pagi
6759,2011-10-14,0,10,4,0,5,1,1,0.56,0.5303,0.94,0.194,0,8,8,8,4,Pagi
6760,2011-10-14,0,10,5,0,5,1,2,0.56,0.5303,0.94,0.1642,0,17,17,17,4,Pagi
6761,2011-10-14,0,10,6,0,5,1,3,0.56,0.5303,0.88,0.194,4,90,94,94,4,Pagi
6762,2011-10-14,0,10,7,0,5,1,3,0.56,0.5303,0.88,0.194,10,137,147,147,4,Siang
6763,2011-10-14,0,10,8,0,5,1,2,0.56,0.5303,0.9,0.1642,23,186,209,209,4,Siang
6764,2011-10-14,0,10,9,0,5,1,2,0.56,0.5303,0.94,0.2239,16,164,180,180,4,Siang
6765,2011-10-14,0,10,10,0,5,1,3,0.54,0.5152,0.88,0.3582,17,108,125,125,4,Siang
6766,2011-10-14,0,10,11,0,5,1,3,0.52,0.5,0.88,0.1642,11,76,87,87,4,Siang
6767,2011-10-14,0,10,12,0,5,1,3,0.52,0.5,0.88,0.1642,13,62,75,75,4,Siang
6768,2011-10-14,0,10,13,0,5,1,1,0.56,0.5303,0.73,0.3582,18,114,132,132,4,Sore
6769,2011-10-14,0,10,14,0,5,1,1,0.62,0.6212,0.43,0.3582,37,119,156,156,4,Sore
6770,2011-10-14,0,10,15,0,5,1,1,0.62,0.6212,0.43,0.2836,61,169,230,230,4,Sore
6771,2011-10-14,0,10,16,0,5,1,1,0.6,0.6212,0.43,0.2239,80,264,344,344,4,Sore
6772,2011-10-14,0,10,17,0,5,1,1,0.58,0.5455,0.46,0.4179,55,426,481,481,4,Sore
6773,2011-10-14,0,10,18,0,5,1,1,0.54,0.5152,0.39,0.2836,62,361,423,423,4,Sore
6774,2011-10-14,0,10,19,0,5,1,1,0.54,0.5152,0.39,0.3284,27,221,248,248,4,Malam
6775,2011-10-14,0,10,20,0,5,1,1,0.52,0.5,0.42,0.194,19,177,196,196,4,Malam
6776,2011-10-14,0,10,21,0,5,1,1,0.5,0.4848,0.45,0.194,22,156,178,178,4,Malam
6777,2011-10-14,0,10,22,0,5,1,1,0.46,0.4545,0.59,0.2239,20,123,143,143,4,Malam
6778,2011-10-14,0,10,23,0,5,1,1,0.46,0.4545,0.59,0.1642,15,80,95,95,4,Malam
6779,2011-10-15,0,10,0,0,6,0,1,0.46,0.4545,0.55,0.1045,18,88,106,106,4,
6780,2011-10-15,0,10,1,0,6,0,1,0.46,0.4545,0.55,0.2537,9,64,73,73,4,Pagi
6781,2011-10-15,0,10,2,0,6,0,1,0.46,0.4545,0.59,0.194,17,39,56,56,4,Pagi
6782,2011-10-15,0,10,3,0,6,0,1,0.44,0.4394,0.62,0.194,5,18,23,23,4,Pagi
6783,2011-10-15,0,10,4,0,6,0,1,0.42,0.4242,0.67,0.1343,0,6,6,6,4,Pagi
6784,2011-10-15,0,10,5,0,6,0,1,0.42,0.4242,0.71,0.1642,1,6,7,7,4,Pagi
6785,2011-10-15,0,10,6,0,6,0,1,0.4,0.4091,0.71,0.0,5,15,20,20,4,Pagi
6786,2011-10-15,0,10,7,0,6,0,1,0.4,0.4091,0.76,0.1045,17,40,57,57,4,Siang
6787,2011-10-15,0,10,8,0,6,0,1,0.46,0.4545,0.59,0.2836,24,101,125,125,4,Siang
6788,2011-10-15,0,10,9,0,6,0,1,0.52,0.5,0.48,0.2985,50,157,207,207,4,Siang
6789,2011-10-15,0,10,10,0,6,0,1,0.54,0.5152,0.45,0.4478,115,207,322,322,4,Siang
6790,2011-10-15,0,10,11,0,6,0,1,0.56,0.5303,0.4,0.3881,153,221,374,374,4,Siang
6791,2011-10-15,0,10,12,0,6,0,1,0.58,0.5455,0.35,0.5522,195,261,456,456,4,Siang
6792,2011-10-15,0,10,13,0,6,0,1,0.6,0.6212,0.35,0.4627,171,223,394,394,4,Sore
6793,2011-10-15,0,10,14,0,6,0,1,0.6,0.6212,0.33,0.4627,242,230,472,472,4,Sore
6794,2011-10-15,0,10,15,0,6,0,1,0.62,0.6212,0.31,0.4925,166,211,377,377,4,Sore
6795,2011-10-15,0,10,16,0,6,0,1,0.62,0.6212,0.29,0.3881,179,264,443,443,4,Sore
6796,2011-10-15,0,10,17,0,6,0,1,0.58,0.5455,0.32,0.2836,177,264,441,441,4,Sore
6797,2011-10-15,0,10,18,0,6,0,1,0.54,0.5152,0.39,0.194,121,251,372,372,4,Sore
6798,2011-10-15,0,10,19,0,6,0,1,0.5,0.4848,0.51,0.1343,61,177,238,238,4,Malam
6799,2011-10-15,0,10,20,0,6,0,1,0.5,0.4848,0.48,0.1343,42,137,179,179,4,Malam
6800,2011-10-15,0,10,21,0,6,0,1,0.5,0.4848,0.42,0.2239,53,115,168,168,4,Malam
6801,2011-10-15,0,10,22,0,6,0,1,0.5,0.4848,0.36,0.1343,45,121,166,166,4,Malam
6802,2011-10-15,0,10,23,0,6,0,1,0.48,0.4697,0.41,0.1642,33,102,135,135,4,Malam
6803,2011-10-16,0,10,0,0,0,0,1,0.46,0.4545,0.44,0.1343,22,85,107,107,4,
6804,2011-10-16,0,10,1,0,0,0,1,0.44,0.4394,0.47,0.1343,13,64,77,77,4,Pagi
6805,2011-10-16,0,10,2,0,0,0,1,0.42,0.4242,0.54,0.1343,13,52,65,65,4,Pagi
6806,2011-10-16,0,10,3,0,0,0,1,0.42,0.4242,0.54,0.1343,11,31,42,42,4,Pagi
6807,2011-10-16,0,10,4,0,0,0,1,0.42,0.4242,0.54,0.194,5,7,12,12,4,Pagi
6808,2011-10-16,0,10,5,0,0,0,1,0.42,0.4242,0.54,0.1642,1,6,7,7,4,Pagi
6809,2011-10-16,0,10,6,0,0,0,1,0.38,0.3939,0.66,0.1642,3,7,10,10,4,Pagi
6810,2011-10-16,0,10,7,0,0,0,1,0.4,0.4091,0.62,0.1343,9,39,48,48,4,Siang
6811,2011-10-16,0,10,8,0,0,0,1,0.44,0.4394,0.62,0.194,28,71,99,99,4,Siang
6812,2011-10-16,0,10,9,0,0,0,1,0.5,0.4848,0.45,0.2239,39,151,190,190,4,Siang
6813,2011-10-16,0,10,10,0,0,0,1,0.54,0.5152,0.45,0.2537,121,226,347,347,4,Siang
6814,2011-10-16,0,10,11,0,0,0,1,0.56,0.5303,0.35,0.2836,159,218,377,377,4,Siang
6815,2011-10-16,0,10,12,0,0,0,1,0.58,0.5455,0.35,0.2537,167,277,444,444,4,Siang
6816,2011-10-16,0,10,13,0,0,0,1,0.6,0.6212,0.35,0.2985,169,269,438,438,4,Sore
6817,2011-10-16,0,10,14,0,0,0,1,0.6,0.6212,0.4,0.2985,204,258,462,462,4,Sore
6818,2011-10-16,0,10,15,0,0,0,1,0.62,0.6212,0.35,0.3881,182,230,412,412,4,Sore
6819,2011-10-16,0,10,16,0,0,0,1,0.6,0.6212,0.46,0.3881,177,289,466,466,4,Sore
6820,2011-10-16,0,10,17,0,0,0,1,0.58,0.5455,0.49,0.4627,152,253,405,405,4,Sore
6821,2011-10-16,0,10,18,0,0,0,1,0.56,0.5303,0.49,0.4478,102,226,328,328,4,Sore
6822,2011-10-16,0,10,19,0,0,0,1,0.54,0.5152,0.52,0.3881,52,181,233,233,4,Malam
6823,2011-10-16,0,10,20,0,0,0,1,0.54,0.5152,0.52,0.4627,49,129,178,178,4,Malam
6824,2011-10-16,0,10,21,0,0,0,1,0.54,0.5152,0.52,0.3881,14,88,102,102,4,Malam
6825,2011-10-16,0,10,22,0,0,0,1,0.56,0.5303,0.49,0.4179,42,88,130,130,4,Malam
6826,2011-10-16,0,10,23,0,0,0,1,0.56,0.5303,0.52,0.4179,14,48,62,62,4,Malam
6827,2011-10-17,0,10,0,0,1,1,1,0.54,0.5152,0.56,0.3284,12,25,37,37,4,
6828,2011-10-17,0,10,1,0,1,1,1,0.56,0.5303,0.54,0.3881,2,15,17,17,4,Pagi
6829,2011-10-17,0,10,2,0,1,1,1,0.56,0.5303,0.54,0.3881,4,3,7,7,4,Pagi
6830,2011-10-17,0,10,3,0,1,1,1,0.56,0.5303,0.49,0.194,0,2,2,2,4,Pagi
6831,2011-10-17,0,10,4,0,1,1,1,0.52,0.5,0.59,0.1642,2,3,5,5,4,Pagi
6832,2011-10-17,0,10,5,0,1,1,1,0.5,0.4848,0.63,0.2985,1,28,29,29,4,Pagi
6833,2011-10-17,0,10,6,0,1,1,1,0.5,0.4848,0.55,0.2537,7,107,114,114,4,Pagi
6834,2011-10-17,0,10,7,0,1,1,2,0.5,0.4848,0.55,0.1642,10,299,309,309,4,Siang
6835,2011-10-17,0,10,8,0,1,1,2,0.5,0.4848,0.51,0.2537,33,381,414,414,4,Siang
6836,2011-10-17,0,10,9,0,1,1,2,0.5,0.4848,0.45,0.2836,26,180,206,206,4,Siang
6837,2011-10-17,0,10,10,0,1,1,1,0.52,0.5,0.45,0.1642,43,92,135,135,4,Siang
6838,2011-10-17,0,10,11,0,1,1,1,0.56,0.5303,0.43,0.0,35,131,166,166,4,Siang
6839,2011-10-17,0,10,12,0,1,1,1,0.56,0.5303,0.4,0.0896,39,166,205,205,4,Siang
6840,2011-10-17,0,10,13,0,1,1,1,0.56,0.5303,0.46,0.0896,49,156,205,205,4,Sore
6841,2011-10-17,0,10,14,0,1,1,1,0.58,0.5455,0.49,0.194,44,122,166,166,4,Sore
6842,2011-10-17,0,10,15,0,1,1,1,0.56,0.5303,0.6,0.2537,66,142,208,208,4,Sore
6843,2011-10-17,0,10,16,0,1,1,1,0.58,0.5455,0.56,0.2537,64,238,302,302,4,Sore
6844,2011-10-17,0,10,17,0,1,1,1,0.56,0.5303,0.64,0.1343,80,540,620,620,4,Sore
6845,2011-10-17,0,10,18,0,1,1,1,0.56,0.5303,0.6,0.0,49,469,518,518,4,Sore
6846,2011-10-17,0,10,19,0,1,1,1,0.54,0.5152,0.68,0.1045,45,288,333,333,4,Malam
6847,2011-10-17,0,10,20,0,1,1,1,0.52,0.5,0.77,0.1045,40,189,229,229,4,Malam
6848,2011-10-17,0,10,21,0,1,1,1,0.5,0.4848,0.77,0.1045,36,141,177,177,4,Malam
6849,2011-10-17,0,10,22,0,1,1,1,0.5,0.4848,0.77,0.0,16,88,104,104,4,Malam
6850,2011-10-17,0,10,23,0,1,1,2,0.48,0.4697,0.88,0.0,10,52,62,62,4,Malam
6851,2011-10-18,0,10,0,0,2,1,1,0.48,0.4697,0.82,0.0,8,23,31,31,4,
6852,2011-10-18,0,10,1,0,2,1,2,0.46,0.4545,0.88,0.0,4,7,11,11,4,Pagi
6853,2011-10-18,0,10,2,0,2,1,1,0.44,0.4394,0.94,0.0896,1,4,5,5,4,Pagi
6854,2011-10-18,0,10,3,0,2,1,1,0.44,0.4394,0.94,0.0896,0,1,1,1,4,Pagi
6855,2011-10-18,0,10,4,0,2,1,2,0.44,0.4394,0.94,0.1045,0,4,4,4,4,Pagi
6856,2011-10-18,0,10,5,0,2,1,2,0.46,0.4545,0.88,0.0,2,19,21,21,4,Pagi
6857,2011-10-18,0,10,6,0,2,1,1,0.46,0.4545,0.82,0.0896,4,105,109,109,4,Pagi
6858,2011-10-18,0,10,7,0,2,1,1,0.46,0.4545,0.88,0.0896,15,326,341,341,4,Siang
6859,2011-10-18,0,10,8,0,2,1,1,0.5,0.4848,0.77,0.0896,25,474,499,499,4,Siang
6860,2011-10-18,0,10,9,0,2,1,2,0.52,0.5,0.77,0.0896,29,198,227,227,4,Siang
6861,2011-10-18,0,10,10,0,2,1,2,0.56,0.5303,0.68,0.0,27,75,102,102,4,Siang
6862,2011-10-18,0,10,11,0,2,1,2,0.6,0.6212,0.49,0.1045,35,112,147,147,4,Siang
6863,2011-10-18,0,10,12,0,2,1,2,0.62,0.6212,0.43,0.0896,42,159,201,201,4,Siang
6864,2011-10-18,0,10,13,0,2,1,2,0.64,0.6212,0.38,0.194,48,171,219,219,4,Sore
6865,2011-10-18,0,10,14,0,2,1,2,0.62,0.6212,0.41,0.1642,32,137,169,169,4,Sore
6866,2011-10-18,0,10,15,0,2,1,1,0.62,0.6212,0.5,0.194,66,139,205,205,4,Sore
6867,2011-10-18,0,10,16,0,2,1,1,0.62,0.6212,0.57,0.2537,58,246,304,304,4,Sore
6868,2011-10-18,0,10,17,0,2,1,1,0.6,0.6061,0.6,0.1343,72,553,625,625,4,Sore
6869,2011-10-18,0,10,18,0,2,1,1,0.56,0.5303,0.68,0.1045,58,512,570,570,4,Sore
6870,2011-10-18,0,10,19,0,2,1,1,0.56,0.5303,0.6,0.1045,31,286,317,317,4,Malam
6871,2011-10-18,0,10,20,0,2,1,1,0.54,0.5152,0.64,0.1642,23,204,227,227,4,Malam
6872,2011-10-18,0,10,21,0,2,1,2,0.54,0.5152,0.68,0.1343,28,178,206,206,4,Malam
6873,2011-10-18,0,10,22,0,2,1,2,0.52,0.5,0.77,0.1642,22,115,137,137,4,Malam
6874,2011-10-18,0,10,23,0,2,1,2,0.52,0.5,0.77,0.194,7,63,70,70,4,Malam
6875,2011-10-19,0,10,0,0,3,1,2,0.52,0.5,0.77,0.194,11,23,34,34,4,
6876,2011-10-19,0,10,1,0,3,1,2,0.52,0.5,0.77,0.194,7,9,16,16,4,Pagi
6877,2011-10-19,0,10,2,0,3,1,2,0.52,0.5,0.77,0.194,1,6,7,7,4,Pagi
6878,2011-10-19,0,10,4,0,3,1,3,0.5,0.4848,0.94,0.194,0,3,3,3,4,Pagi
6879,2011-10-19,0,10,5,0,3,1,3,0.5,0.4848,1.0,0.1045,0,3,3,3,4,Pagi
6880,2011-10-19,0,10,6,0,3,1,3,0.52,0.5,0.83,0.2537,3,28,31,31,4,Pagi
6881,2011-10-19,0,10,7,0,3,1,3,0.52,0.5,0.77,0.2537,1,67,68,68,4,Siang
6882,2011-10-19,0,10,8,0,3,1,3,0.54,0.5152,0.7,0.4925,10,200,210,210,4,Siang
6883,2011-10-19,0,10,9,0,3,1,3,0.52,0.5,0.88,0.4925,17,185,202,202,4,Siang
6884,2011-10-19,0,10,10,0,3,1,3,0.52,0.5,0.88,0.4925,14,109,123,123,4,Siang
6885,2011-10-19,0,10,11,0,3,1,3,0.52,0.5,0.94,0.2537,33,116,149,149,4,Siang
6886,2011-10-19,0,10,12,0,3,1,3,0.52,0.5,0.94,0.3284,13,117,130,130,4,Siang
6887,2011-10-19,0,10,13,0,3,1,2,0.54,0.5152,0.94,0.2836,20,86,106,106,4,Sore
6888,2011-10-19,0,10,14,0,3,1,3,0.54,0.5152,0.94,0.1642,17,80,97,97,4,Sore
6889,2011-10-19,0,10,15,0,3,1,3,0.54,0.5152,1.0,0.1343,21,99,120,120,4,Sore
6890,2011-10-19,0,10,16,0,3,1,3,0.56,0.5303,0.94,0.1642,21,180,201,201,4,Sore
6891,2011-10-19,0,10,17,0,3,1,3,0.56,0.5303,0.94,0.1642,11,170,181,181,4,Sore
6892,2011-10-19,0,10,18,0,3,1,3,0.56,0.5303,1.0,0.1642,8,132,140,140,4,Sore
6893,2011-10-19,0,10,19,0,3,1,2,0.6,0.5455,0.88,0.1343,8,189,197,197,4,Malam
6894,2011-10-19,0,10,20,0,3,1,3,0.6,0.5152,0.94,0.0896,5,140,145,145,4,Malam
6895,2011-10-19,0,10,21,0,3,1,2,0.58,0.5455,0.94,0.1343,6,79,85,85,4,Malam
6896,2011-10-19,0,10,22,0,3,1,2,0.58,0.5455,0.94,0.3582,13,94,107,107,4,Malam
6897,2011-10-19,0,10,23,0,3,1,2,0.58,0.5455,0.94,0.3582,14,55,69,69,4,Malam
6898,2011-10-20,0,10,0,0,4,1,1,0.56,0.5303,0.94,0.2985,4,22,26,26,4,
6899,2011-10-20,0,10,1,0,4,1,1,0.56,0.5303,0.88,0.3582,4,11,15,15,4,Pagi
6900,2011-10-20,0,10,2,0,4,1,1,0.56,0.5303,0.88,0.4478,0,4,4,4,4,Pagi
6901,2011-10-20,0,10,3,0,4,1,1,0.5,0.4848,0.82,0.4627,0,1,1,1,4,Pagi
6902,2011-10-20,0,10,4,0,4,1,1,0.5,0.4848,0.82,0.4627,2,6,8,8,4,Pagi
6903,2011-10-20,0,10,5,0,4,1,1,0.48,0.4697,0.82,0.3582,2,24,26,26,4,Pagi
6904,2011-10-20,0,10,6,0,4,1,1,0.44,0.4394,0.82,0.4179,5,87,92,92,4,Pagi
6905,2011-10-20,0,10,7,0,4,1,1,0.42,0.4242,0.77,0.4478,15,303,318,318,4,Siang
6906,2011-10-20,0,10,8,0,4,1,1,0.44,0.4394,0.67,0.5224,17,409,426,426,4,Siang
6907,2011-10-20,0,10,9,0,4,1,1,0.44,0.4394,0.67,0.5821,26,197,223,223,4,Siang
6908,2011-10-20,0,10,10,0,4,1,1,0.46,0.4545,0.59,0.4478,25,105,130,130,4,Siang
6909,2011-10-20,0,10,11,0,4,1,1,0.48,0.4697,0.55,0.5224,30,99,129,129,4,Siang
6910,2011-10-20,0,10,12,0,4,1,1,0.48,0.4697,0.48,0.5224,28,171,199,199,4,Siang
6911,2011-10-20,0,10,13,0,4,1,1,0.5,0.4848,0.45,0.5821,28,136,164,164,4,Sore
6912,2011-10-20,0,10,14,0,4,1,2,0.48,0.4697,0.48,0.5522,38,117,155,155,4,Sore
6913,2011-10-20,0,10,15,0,4,1,2,0.48,0.4697,0.51,0.4478,22,138,160,160,4,Sore
6914,2011-10-20,0,10,16,0,4,1,2,0.48,0.4697,0.51,0.4478,31,203,234,234,4,Sore
6915,2011-10-20,0,10,17,0,4,1,2,0.48,0.4697,0.48,0.3881,56,438,494,494,4,Sore
6916,2011-10-20,0,10,18,0,4,1,2,0.46,0.4545,0.51,0.2985,39,430,469,469,4,Sore
6917,2011-10-20,0,10,19,0,4,1,1,0.46,0.4545,0.51,0.3582,20,278,298,298,4,Malam
6918,2011-10-20,0,10,20,0,4,1,2,0.46,0.4545,0.51,0.3284,34,207,241,241,4,Malam
6919,2011-10-20,0,10,21,0,4,1,1,0.44,0.4394,0.51,0.2985,16,149,165,165,4,Malam
6920,2011-10-20,0,10,22,0,4,1,1,0.44,0.4394,0.51,0.3284,22,106,128,128,4,Malam
6921,2011-10-20,0,10,23,0,4,1,1,0.42,0.4242,0.58,0.2537,7,83,90,90,4,Malam
6922,2011-10-21,0,10,0,0,5,1,1,0.4,0.4091,0.62,0.2537,8,42,50,50,4,
6923,2011-10-21,0,10,1,0,5,1,1,0.4,0.4091,0.62,0.2239,7,19,26,26,4,Pagi
6924,2011-10-21,0,10,2,0,5,1,1,0.38,0.3939,0.66,0.1642,6,12,18,18,4,Pagi
6925,2011-10-21,0,10,3,0,5,1,1,0.36,0.3485,0.71,0.1343,0,7,7,7,4,Pagi
6926,2011-10-21,0,10,4,0,5,1,1,0.36,0.3485,0.71,0.1642,0,6,6,6,4,Pagi
6927,2011-10-21,0,10,5,0,5,1,1,0.34,0.3333,0.76,0.194,0,31,31,31,4,Pagi
6928,2011-10-21,0,10,6,0,5,1,1,0.36,0.3485,0.71,0.1642,7,78,85,85,4,Pagi
6929,2011-10-21,0,10,7,0,5,1,1,0.36,0.3485,0.71,0.1642,5,228,233,233,4,Siang
6930,2011-10-21,0,10,8,0,5,1,1,0.4,0.4091,0.62,0.194,16,386,402,402,4,Siang
6931,2011-10-21,0,10,9,0,5,1,2,0.42,0.4242,0.58,0.1343,33,189,222,222,4,Siang
6932,2011-10-21,0,10,10,0,5,1,1,0.46,0.4545,0.51,0.1642,32,106,138,138,4,Siang
6933,2011-10-21,0,10,11,0,5,1,1,0.5,0.4848,0.45,0.2239,39,135,174,174,4,Siang
6934,2011-10-21,0,10,12,0,5,1,1,0.5,0.4848,0.45,0.2985,47,193,240,240,4,Siang
6935,2011-10-21,0,10,13,0,5,1,1,0.48,0.4697,0.48,0.3284,43,163,206,206,4,Sore
6936,2011-10-21,0,10,14,0,5,1,1,0.52,0.5,0.42,0.2985,67,131,198,198,4,Sore
6937,2011-10-21,0,10,15,0,5,1,1,0.5,0.4848,0.45,0.2836,57,178,235,235,4,Sore
6938,2011-10-21,0,10,16,0,5,1,1,0.5,0.4848,0.45,0.2537,60,242,302,302,4,Sore
6939,2011-10-21,0,10,17,0,5,1,2,0.46,0.4545,0.51,0.2537,79,445,524,524,4,Sore
6940,2011-10-21,0,10,18,0,5,1,2,0.44,0.4394,0.54,0.2537,43,354,397,397,4,Sore
6941,2011-10-21,0,10,19,0,5,1,2,0.44,0.4394,0.54,0.3881,25,228,253,253,4,Malam
6942,2011-10-21,0,10,20,0,5,1,2,0.44,0.4394,0.54,0.2239,29,155,184,184,4,Malam
6943,2011-10-21,0,10,21,0,5,1,1,0.42,0.4242,0.58,0.1642,31,112,143,143,4,Malam
6944,2011-10-21,0,10,22,0,5,1,1,0.42,0.4242,0.54,0.1642,24,89,113,113,4,Malam
6945,2011-10-21,0,10,23,0,5,1,1,0.4,0.4091,0.62,0.2239,18,99,117,117,4,Malam
6946,2011-10-22,0,10,0,0,6,0,1,0.4,0.4091,0.62,0.194,16,80,96,96,4,
6947,2011-10-22,0,10,1,0,6,0,1,0.4,0.4091,0.62,0.194,20,50,70,70,4,Pagi
6948,2011-10-22,0,10,2,0,6,0,1,0.4,0.4091,0.62,0.2537,6,25,31,31,4,Pagi
6949,2011-10-22,0,10,3,0,6,0,1,0.4,0.4091,0.62,0.1343,1,19,20,20,4,Pagi
6950,2011-10-22,0,10,4,0,6,0,1,0.38,0.3939,0.66,0.0896,4,4,8,8,4,Pagi
6951,2011-10-22,0,10,5,0,6,0,1,0.38,0.3939,0.66,0.0,1,7,8,8,4,Pagi
6952,2011-10-22,0,10,6,0,6,0,1,0.36,0.3788,0.71,0.0,1,17,18,18,4,Pagi
6953,2011-10-22,0,10,7,0,6,0,1,0.36,0.3636,0.76,0.1045,8,49,57,57,4,Siang
6954,2011-10-22,0,10,8,0,6,0,1,0.4,0.4091,0.71,0.0,26,88,114,114,4,Siang
6955,2011-10-22,0,10,9,0,6,0,1,0.42,0.4242,0.67,0.0896,47,122,169,169,4,Siang
6956,2011-10-22,0,10,10,0,6,0,2,0.44,0.4394,0.62,0.1045,87,149,236,236,4,Siang
6957,2011-10-22,0,10,11,0,6,0,2,0.44,0.4394,0.62,0.1045,110,172,282,282,4,Siang
6958,2011-10-22,0,10,12,0,6,0,1,0.46,0.4545,0.55,0.0896,132,211,343,343,4,Siang
6959,2011-10-22,0,10,13,0,6,0,1,0.5,0.4848,0.45,0.0,136,186,322,322,4,Sore
6960,2011-10-22,0,10,14,0,6,0,2,0.48,0.4697,0.48,0.2239,133,177,310,310,4,Sore
6961,2011-10-22,0,10,15,0,6,0,1,0.48,0.4697,0.51,0.2239,159,223,382,382,4,Sore
6962,2011-10-22,0,10,16,0,6,0,1,0.5,0.4848,0.45,0.194,169,190,359,359,4,Sore
6963,2011-10-22,0,10,17,0,6,0,1,0.46,0.4545,0.55,0.1343,143,217,360,360,4,Sore
6964,2011-10-22,0,10,18,0,6,0,1,0.44,0.4394,0.54,0.0896,111,224,335,335,4,Sore
6965,2011-10-22,0,10,19,0,6,0,1,0.44,0.4394,0.67,0.0,47,173,220,220,4,Malam
6966,2011-10-22,0,10,20,0,6,0,1,0.42,0.4242,0.67,0.0,48,111,159,159,4,Malam
6967,2011-10-22,0,10,21,0,6,0,1,0.4,0.4091,0.76,0.0,37,120,157,157,4,Malam
6968,2011-10-22,0,10,22,0,6,0,1,0.4,0.4091,0.76,0.0,30,114,144,144,4,Malam
6969,2011-10-22,0,10,23,0,6,0,1,0.38,0.3939,0.82,0.0,27,81,108,108,4,Malam
6970,2011-10-23,0,10,0,0,0,0,1,0.36,0.3788,0.87,0.0,24,64,88,88,4,
6971,2011-10-23,0,10,1,0,0,0,1,0.36,0.3788,0.87,0.0,11,60,71,71,4,Pagi
6972,2011-10-23,0,10,2,0,0,0,1,0.34,0.3485,0.87,0.0896,10,40,50,50,4,Pagi
6973,2011-10-23,0,10,3,0,0,0,1,0.34,0.3636,0.87,0.0,15,31,46,46,4,Pagi
6974,2011-10-23,0,10,4,0,0,0,1,0.34,0.3636,0.87,0.0,5,1,6,6,4,Pagi
6975,2011-10-23,0,10,5,0,0,0,1,0.32,0.3485,0.87,0.0,1,2,3,3,4,Pagi
6976,2011-10-23,0,10,6,0,0,0,1,0.32,0.3333,0.87,0.1045,0,12,12,12,4,Pagi
6977,2011-10-23,0,10,7,0,0,0,1,0.34,0.3485,0.87,0.0896,3,18,21,21,4,Siang
6978,2011-10-23,0,10,8,0,0,0,1,0.36,0.3485,0.87,0.1343,32,56,88,88,4,Siang
6979,2011-10-23,0,10,9,0,0,0,1,0.4,0.4091,0.76,0.0,48,95,143,143,4,Siang
6980,2011-10-23,0,10,10,0,0,0,1,0.42,0.4242,0.71,0.0896,104,185,289,289,4,Siang
6981,2011-10-23,0,10,11,0,0,0,1,0.46,0.4545,0.72,0.1642,131,202,333,333,4,Siang
6982,2011-10-23,0,10,12,0,0,0,1,0.5,0.4848,0.59,0.2537,164,249,413,413,4,Siang
6983,2011-10-23,0,10,13,0,0,0,1,0.52,0.5,0.55,0.194,160,255,415,415,4,Sore
6984,2011-10-23,0,10,14,0,0,0,1,0.52,0.5,0.55,0.2239,192,216,408,408,4,Sore
6985,2011-10-23,0,10,15,0,0,0,1,0.52,0.5,0.52,0.1642,171,216,387,387,4,Sore
6986,2011-10-23,0,10,16,0,0,0,1,0.52,0.5,0.55,0.194,188,217,405,405,4,Sore
6987,2011-10-23,0,10,17,0,0,0,1,0.5,0.4848,0.63,0.1343,120,220,340,340,4,Sore
6988,2011-10-23,0,10,18,0,0,0,1,0.5,0.4848,0.63,0.1045,88,196,284,284,4,Sore
6989,2011-10-23,0,10,19,0,0,0,1,0.46,0.4545,0.77,0.0,53,140,193,193,4,Malam
6990,2011-10-23,0,10,20,0,0,0,1,0.44,0.4394,0.72,0.0896,32,112,144,144,4,Malam
6991,2011-10-23,0,10,21,0,0,0,1,0.44,0.4394,0.72,0.0896,24,75,99,99,4,Malam
6992,2011-10-23,0,10,22,0,0,0,1,0.42,0.4242,0.77,0.1045,25,69,94,94,4,Malam
6993,2011-10-23,0,10,23,0,0,0,1,0.42,0.4242,0.77,0.1642,18,31,49,49,4,Malam
6994,2011-10-24,0,10,0,0,1,1,1,0.42,0.4242,0.77,0.0,6,26,32,32,4,
6995,2011-10-24,0,10,1,0,1,1,1,0.4,0.4091,0.82,0.1343,7,8,15,15,4,Pagi
6996,2011-10-24,0,10,2,0,1,1,1,0.4,0.4091,0.87,0.1045,1,6,7,7,4,Pagi
6997,2011-10-24,0,10,3,0,1,1,1,0.4,0.4091,0.82,0.0896,1,3,4,4,4,Pagi
6998,2011-10-24,0,10,4,0,1,1,1,0.4,0.4091,0.82,0.0,1,5,6,6,4,Pagi
6999,2011-10-24,0,10,5,0,1,1,1,0.38,0.3939,0.87,0.0,2,19,21,21,4,Pagi
7000,2011-10-24,0,10,6,0,1,1,1,0.4,0.4091,0.87,0.1045,3,83,86,86,4,Pagi
7001,2011-10-24,0,10,7,0,1,1,2,0.38,0.3939,0.94,0.1045,11,274,285,285,4,Siang
7002,2011-10-24,0,10,8,0,1,1,2,0.42,0.4242,0.88,0.1642,20,378,398,398,4,Siang
7003,2011-10-24,0,10,9,0,1,1,2,0.44,0.4394,0.82,0.1642,29,166,195,195,4,Siang
7004,2011-10-24,0,10,10,0,1,1,2,0.46,0.4545,0.82,0.2537,47,82,129,129,4,Siang
7005,2011-10-24,0,10,11,0,1,1,2,0.5,0.4848,0.72,0.1642,59,109,168,168,4,Siang
7006,2011-10-24,0,10,12,0,1,1,2,0.52,0.5,0.68,0.1045,64,156,220,220,4,Siang
7007,2011-10-24,0,10,13,0,1,1,2,0.54,0.5152,0.64,0.2239,60,138,198,198,4,Sore
7008,2011-10-24,0,10,14,0,1,1,2,0.54,0.5152,0.64,0.194,63,143,206,206,4,Sore
7009,2011-10-24,0,10,15,0,1,1,1,0.56,0.5303,0.6,0.1642,52,125,177,177,4,Sore
7010,2011-10-24,0,10,16,0,1,1,1,0.54,0.5152,0.64,0.194,68,242,310,310,4,Sore
7011,2011-10-24,0,10,17,0,1,1,1,0.52,0.5,0.68,0.1343,87,527,614,614,4,Sore
7012,2011-10-24,0,10,18,0,1,1,1,0.54,0.5152,0.6,0.0896,58,428,486,486,4,Sore
7013,2011-10-24,0,10,19,0,1,1,3,0.48,0.4697,0.82,0.0,25,212,237,237,4,Malam
7014,2011-10-24,0,10,20,0,1,1,1,0.48,0.4697,0.82,0.1045,11,118,129,129,4,Malam
7015,2011-10-24,0,10,21,0,1,1,1,0.46,0.4545,0.87,0.1045,12,114,126,126,4,Malam
7016,2011-10-24,0,10,22,0,1,1,1,0.48,0.4697,0.75,0.1642,3,76,79,79,4,Malam
7017,2011-10-24,0,10,23,0,1,1,1,0.46,0.4545,0.77,0.0896,9,50,59,59,4,Malam
7018,2011-10-25,0,10,0,0,2,1,1,0.44,0.4394,0.77,0.1343,4,26,30,30,4,
7019,2011-10-25,0,10,1,0,2,1,1,0.44,0.4394,0.77,0.1343,5,6,11,11,4,Pagi
7020,2011-10-25,0,10,2,0,2,1,1,0.42,0.4242,0.82,0.1343,2,3,5,5,4,Pagi
7021,2011-10-25,0,10,3,0,2,1,1,0.4,0.4091,0.87,0.0,1,3,4,4,4,Pagi
7022,2011-10-25,0,10,4,0,2,1,1,0.38,0.3939,0.87,0.1343,0,5,5,5,4,Pagi
7023,2011-10-25,0,10,5,0,2,1,1,0.38,0.3939,0.87,0.1343,0,24,24,24,4,Pagi
7024,2011-10-25,0,10,6,0,2,1,1,0.38,0.3939,0.82,0.1045,3,95,98,98,4,Pagi
7025,2011-10-25,0,10,7,0,2,1,1,0.4,0.4091,0.76,0.194,15,299,314,314,4,Siang
7026,2011-10-25,0,10,8,0,2,1,1,0.44,0.4394,0.72,0.0,25,383,408,408,4,Siang
7027,2011-10-25,0,10,9,0,2,1,1,0.48,0.4697,0.55,0.2239,29,194,223,223,4,Siang
7028,2011-10-25,0,10,10,0,2,1,1,0.5,0.4848,0.51,0.2537,26,102,128,128,4,Siang
7029,2011-10-25,0,10,11,0,2,1,1,0.52,0.5,0.48,0.2836,46,120,166,166,4,Siang
7030,2011-10-25,0,10,12,0,2,1,1,0.54,0.5152,0.39,0.3582,35,165,200,200,4,Siang
7031,2011-10-25,0,10,13,0,2,1,1,0.56,0.5303,0.37,0.3881,37,161,198,198,4,Sore
7032,2011-10-25,0,10,14,0,2,1,1,0.56,0.5303,0.4,0.2537,66,134,200,200,4,Sore
7033,2011-10-25,0,10,15,0,2,1,1,0.56,0.5303,0.37,0.1045,63,171,234,234,4,Sore
7034,2011-10-25,0,10,16,0,2,1,1,0.56,0.5303,0.37,0.194,52,233,285,285,4,Sore
7035,2011-10-25,0,10,17,0,2,1,1,0.56,0.5303,0.37,0.1045,68,517,585,585,4,Sore
7036,2011-10-25,0,10,18,0,2,1,1,0.52,0.5,0.42,0.1045,65,453,518,518,4,Sore
7037,2011-10-25,0,10,19,0,2,1,1,0.48,0.4697,0.67,0.194,44,294,338,338,4,Malam
7038,2011-10-25,0,10,20,0,2,1,1,0.46,0.4545,0.67,0.1045,40,208,248,248,4,Malam
7039,2011-10-25,0,10,21,0,2,1,1,0.44,0.4394,0.72,0.1343,32,169,201,201,4,Malam
7040,2011-10-25,0,10,22,0,2,1,1,0.46,0.4545,0.67,0.194,22,148,170,170,4,Malam
7041,2011-10-25,0,10,23,0,2,1,1,0.44,0.4394,0.72,0.1343,15,79,94,94,4,Malam
7042,2011-10-26,0,10,0,0,3,1,1,0.44,0.4394,0.72,0.194,4,28,32,32,4,
7043,2011-10-26,0,10,1,0,3,1,1,0.44,0.4394,0.67,0.2537,3,9,12,12,4,Pagi
7044,2011-10-26,0,10,2,0,3,1,1,0.44,0.4394,0.67,0.1642,2,1,3,3,4,Pagi
7045,2011-10-26,0,10,3,0,3,1,1,0.44,0.4394,0.67,0.2239,0,3,3,3,4,Pagi
7046,2011-10-26,0,10,4,0,3,1,1,0.42,0.4242,0.71,0.2537,0,5,5,5,4,Pagi
7047,2011-10-26,0,10,5,0,3,1,1,0.42,0.4242,0.71,0.2239,0,21,21,21,4,Pagi
7048,2011-10-26,0,10,6,0,3,1,1,0.42,0.4242,0.71,0.2239,0,92,92,92,4,Pagi
7049,2011-10-26,0,10,7,0,3,1,1,0.42,0.4242,0.71,0.1642,15,284,299,299,4,Siang
7050,2011-10-26,0,10,8,0,3,1,2,0.44,0.4394,0.67,0.194,26,438,464,464,4,Siang
7051,2011-10-26,0,10,9,0,3,1,2,0.48,0.4697,0.63,0.2239,14,226,240,240,4,Siang
7052,2011-10-26,0,10,10,0,3,1,2,0.52,0.5,0.62,0.2537,26,105,131,131,4,Siang
7053,2011-10-26,0,10,11,0,3,1,1,0.52,0.5,0.59,0.3284,23,132,155,155,4,Siang
7054,2011-10-26,0,10,12,0,3,1,3,0.58,0.5455,0.53,0.2239,39,155,194,194,4,Siang
7055,2011-10-26,0,10,13,0,3,1,3,0.56,0.5303,0.6,0.1045,20,62,82,82,4,Sore
7056,2011-10-26,0,10,14,0,3,1,2,0.52,0.5,0.77,0.0,14,52,66,66,4,Sore
7057,2011-10-26,0,10,15,0,3,1,2,0.52,0.5,0.77,0.0,11,59,70,70,4,Sore
7058,2011-10-26,0,10,16,0,3,1,2,0.52,0.5,0.77,0.0896,17,196,213,213,4,Sore
7059,2011-10-26,0,10,17,0,3,1,2,0.52,0.5,0.77,0.1045,40,414,454,454,4,Sore
7060,2011-10-26,0,10,18,0,3,1,1,0.52,0.5,0.77,0.1642,55,398,453,453,4,Sore
7061,2011-10-26,0,10,19,0,3,1,1,0.5,0.4848,0.82,0.0,25,306,331,331,4,Malam
7062,2011-10-26,0,10,20,0,3,1,1,0.5,0.4848,0.88,0.0,27,180,207,207,4,Malam
7063,2011-10-26,0,10,21,0,3,1,2,0.52,0.5,0.77,0.0,17,140,157,157,4,Malam
7064,2011-10-26,0,10,22,0,3,1,2,0.48,0.4697,0.88,0.0896,23,112,135,135,4,Malam
7065,2011-10-26,0,10,23,0,3,1,2,0.48,0.4697,0.88,0.0896,3,72,75,75,4,Malam
7066,2011-10-27,0,10,0,0,4,1,1,0.46,0.4545,0.94,0.0,3,23,26,26,4,
7067,2011-10-27,0,10,1,0,4,1,1,0.46,0.4545,0.94,0.0,2,9,11,11,4,Pagi
7068,2011-10-27,0,10,2,0,4,1,3,0.46,0.4545,0.94,0.0,3,5,8,8,4,Pagi
7069,2011-10-27,0,10,3,0,4,1,3,0.46,0.4545,0.94,0.0,1,3,4,4,4,Pagi
7070,2011-10-27,0,10,4,0,4,1,3,0.48,0.4697,0.88,0.0,1,3,4,4,4,Pagi
7071,2011-10-27,0,10,5,0,4,1,3,0.48,0.4697,0.88,0.0896,1,14,15,15,4,Pagi
7072,2011-10-27,0,10,6,0,4,1,3,0.5,0.4848,0.82,0.0,4,42,46,46,4,Pagi
7073,2011-10-27,0,10,7,0,4,1,2,0.46,0.4545,0.94,0.0896,9,128,137,137,4,Siang
7074,2011-10-27,0,10,8,0,4,1,3,0.48,0.4697,0.88,0.194,12,304,316,316,4,Siang
7075,2011-10-27,0,10,9,0,4,1,2,0.5,0.4848,0.82,0.1642,16,155,171,171,4,Siang
7076,2011-10-27,0,10,10,0,4,1,3,0.5,0.4848,0.88,0.194,10,52,62,62,4,Siang
7077,2011-10-27,0,10,11,0,4,1,3,0.5,0.4848,0.88,0.1343,8,44,52,52,4,Siang
7078,2011-10-27,0,10,12,0,4,1,3,0.5,0.4848,0.88,0.1343,8,45,53,53,4,Siang
7079,2011-10-27,0,10,13,0,4,1,2,0.5,0.4848,0.88,0.1642,10,64,74,74,4,Sore
7080,2011-10-27,0,10,14,0,4,1,2,0.52,0.5,0.83,0.0,16,76,92,92,4,Sore
7081,2011-10-27,0,10,15,0,4,1,2,0.52,0.5,0.83,0.1045,12,95,107,107,4,Sore
7082,2011-10-27,0,10,16,0,4,1,2,0.56,0.5303,0.73,0.1642,14,193,207,207,4,Sore
7083,2011-10-27,0,10,17,0,4,1,2,0.5,0.4848,0.72,0.4627,31,291,322,322,4,Sore
7084,2011-10-27,0,10,18,0,4,1,2,0.48,0.4697,0.67,0.4627,14,226,240,240,4,Sore
7085,2011-10-27,0,10,19,0,4,1,2,0.44,0.4394,0.67,0.4627,19,200,219,219,4,Malam
7086,2011-10-27,0,10,20,0,4,1,1,0.42,0.4242,0.67,0.4925,11,171,182,182,4,Malam
7087,2011-10-27,0,10,21,0,4,1,1,0.4,0.4091,0.62,0.5224,13,119,132,132,4,Malam
7088,2011-10-27,0,10,22,0,4,1,1,0.36,0.3182,0.66,0.4925,14,97,111,111,4,Malam
7089,2011-10-27,0,10,23,0,4,1,1,0.34,0.303,0.61,0.4179,8,60,68,68,4,Malam
7090,2011-10-28,0,10,0,0,5,1,1,0.34,0.3182,0.66,0.2537,4,40,44,44,4,
7091,2011-10-28,0,10,1,0,5,1,1,0.32,0.303,0.66,0.2537,7,9,16,16,4,Pagi
7092,2011-10-28,0,10,2,0,5,1,1,0.32,0.303,0.66,0.2836,1,3,4,4,4,Pagi
7093,2011-10-28,0,10,3,0,5,1,1,0.3,0.2879,0.7,0.2836,4,4,8,8,4,Pagi
7094,2011-10-28,0,10,4,0,5,1,1,0.3,0.2879,0.65,0.2836,5,5,10,10,4,Pagi
7095,2011-10-28,0,10,5,0,5,1,2,0.3,0.2879,0.61,0.2537,0,25,25,25,4,Pagi
7096,2011-10-28,0,10,6,0,5,1,1,0.28,0.2727,0.65,0.2537,1,74,75,75,4,Pagi
7097,2011-10-28,0,10,7,0,5,1,1,0.28,0.2727,0.65,0.2537,6,199,205,205,4,Siang
7098,2011-10-28,0,10,8,0,5,1,1,0.3,0.2879,0.61,0.2836,13,361,374,374,4,Siang
7099,2011-10-28,0,10,9,0,5,1,1,0.32,0.303,0.57,0.2239,19,210,229,229,4,Siang
7100,2011-10-28,0,10,10,0,5,1,1,0.34,0.3182,0.57,0.2239,28,102,130,130,4,Siang
7101,2011-10-28,0,10,11,0,5,1,1,0.36,0.3485,0.5,0.2239,40,128,168,168,4,Siang
7102,2011-10-28,0,10,12,0,5,1,2,0.38,0.3939,0.4,0.1642,46,167,213,213,4,Siang
7103,2011-10-28,0,10,13,0,5,1,2,0.38,0.3939,0.42,0.2239,43,185,228,228,4,Sore
7104,2011-10-28,0,10,14,0,5,1,2,0.36,0.3485,0.46,0.194,33,152,185,185,4,Sore
7105,2011-10-28,0,10,15,0,5,1,2,0.36,0.3333,0.43,0.2537,44,171,215,215,4,Sore
7106,2011-10-28,0,10,16,0,5,1,2,0.36,0.3485,0.46,0.1642,46,262,308,308,4,Sore
7107,2011-10-28,0,10,17,0,5,1,2,0.36,0.3485,0.5,0.1343,35,411,446,446,4,Sore
7108,2011-10-28,0,10,18,0,5,1,2,0.36,0.3485,0.53,0.1642,36,332,368,368,4,Sore
7109,2011-10-28,0,10,19,0,5,1,2,0.36,0.3485,0.5,0.1343,16,188,204,204,4,Malam
7110,2011-10-28,0,10,20,0,5,1,3,0.34,0.3182,0.61,0.2239,12,131,143,143,4,Malam
7111,2011-10-28,0,10,21,0,5,1,3,0.32,0.3182,0.7,0.1642,5,69,74,74,4,Malam
7112,2011-10-28,0,10,22,0,5,1,3,0.3,0.2879,0.75,0.2836,4,32,36,36,4,Malam
7113,2011-10-28,0,10,23,0,5,1,3,0.3,0.2727,0.81,0.3284,8,31,39,39,4,Malam
7114,2011-10-29,0,10,0,0,6,0,3,0.28,0.2576,0.87,0.2985,0,19,19,19,4,
7115,2011-10-29,0,10,1,0,6,0,3,0.3,0.2727,0.87,0.2985,0,18,18,18,4,Pagi
7116,2011-10-29,0,10,2,0,6,0,3,0.3,0.2727,0.87,0.2985,1,16,17,17,4,Pagi
7117,2011-10-29,0,10,3,0,6,0,3,0.3,0.2727,0.81,0.4179,0,8,8,8,4,Pagi
7118,2011-10-29,0,10,4,0,6,0,3,0.3,0.2727,0.81,0.4179,0,1,1,1,4,Pagi
7119,2011-10-29,0,10,5,0,6,0,3,0.26,0.2273,0.93,0.3582,0,1,1,1,4,Pagi
7120,2011-10-29,0,10,6,0,6,0,3,0.26,0.2273,0.87,0.3582,4,1,5,5,4,Pagi
7121,2011-10-29,0,10,7,0,6,0,3,0.26,0.2273,0.87,0.3582,1,6,7,7,4,Siang
7122,2011-10-29,0,10,8,0,6,0,3,0.28,0.2576,0.87,0.3582,4,16,20,20,4,Siang
7123,2011-10-29,0,10,9,0,6,0,3,0.28,0.2576,0.87,0.3582,1,19,20,20,4,Siang
7124,2011-10-29,0,10,10,0,6,0,3,0.26,0.2273,0.93,0.3284,0,12,12,12,4,Siang
7125,2011-10-29,0,10,11,0,6,0,3,0.26,0.2273,0.93,0.3881,1,26,27,27,4,Siang
7126,2011-10-29,0,10,12,0,6,0,3,0.24,0.197,0.87,0.4925,6,44,50,50,4,Siang
7127,2011-10-29,0,10,13,0,6,0,3,0.24,0.197,0.87,0.5224,0,30,30,30,4,Sore
7128,2011-10-29,0,10,14,0,6,0,3,0.24,0.197,0.87,0.4478,0,29,29,29,4,Sore
7129,2011-10-29,0,10,15,0,6,0,3,0.22,0.2121,0.93,0.2537,3,38,41,41,4,Sore
7130,2011-10-29,0,10,16,0,6,0,3,0.22,0.197,0.93,0.3284,3,19,22,22,4,Sore
7131,2011-10-29,0,10,17,0,6,0,3,0.22,0.197,0.93,0.3284,3,28,31,31,4,Sore
7132,2011-10-29,0,10,18,0,6,0,3,0.22,0.197,0.93,0.3284,6,37,43,43,4,Sore
7133,2011-10-29,0,10,19,0,6,0,1,0.24,0.2121,0.87,0.3582,3,36,39,39,4,Malam
7134,2011-10-29,0,10,20,0,6,0,1,0.24,0.2121,0.87,0.3582,7,40,47,47,4,Malam
7135,2011-10-29,0,10,21,0,6,0,1,0.24,0.2121,0.87,0.3582,1,49,50,50,4,Malam
7136,2011-10-29,0,10,22,0,6,0,1,0.22,0.2121,0.87,0.2239,10,44,54,54,4,Malam
7137,2011-10-29,0,10,23,0,6,0,1,0.22,0.2273,0.87,0.194,3,33,36,36,4,Malam
7138,2011-10-30,0,10,0,0,0,0,1,0.22,0.2121,0.87,0.2239,7,47,54,54,4,
7139,2011-10-30,0,10,1,0,0,0,1,0.22,0.2121,0.87,0.2537,9,34,43,43,4,Pagi
7140,2011-10-30,0,10,2,0,0,0,1,0.22,0.2121,0.87,0.2836,7,43,50,50,4,Pagi
7141,2011-10-30,0,10,3,0,0,0,1,0.24,0.2121,0.75,0.3582,7,26,33,33,4,Pagi
7142,2011-10-30,0,10,4,0,0,0,1,0.22,0.197,0.8,0.3284,1,10,11,11,4,Pagi
7143,2011-10-30,0,10,5,0,0,0,1,0.24,0.2121,0.75,0.2985,0,4,4,4,4,Pagi
7144,2011-10-30,0,10,6,0,0,0,1,0.24,0.2273,0.75,0.2537,2,8,10,10,4,Pagi
7145,2011-10-30,0,10,7,0,0,0,1,0.24,0.2879,0.75,0.0,7,15,22,22,4,Siang
7146,2011-10-30,0,10,8,0,0,0,1,0.26,0.2576,0.7,0.2239,20,60,80,80,4,Siang
7147,2011-10-30,0,10,9,0,0,0,1,0.3,0.2879,0.65,0.2537,55,92,147,147,4,Siang
7148,2011-10-30,0,10,10,0,0,0,1,0.32,0.3333,0.61,0.0896,53,125,178,178,4,Siang
7149,2011-10-30,0,10,11,0,0,0,1,0.36,0.3485,0.53,0.2239,58,182,240,240,4,Siang
7150,2011-10-30,0,10,12,0,0,0,1,0.38,0.3939,0.5,0.194,85,229,314,314,4,Siang
7151,2011-10-30,0,10,13,0,0,0,1,0.4,0.4091,0.43,0.2239,113,232,345,345,4,Sore
7152,2011-10-30,0,10,14,0,0,0,1,0.42,0.4242,0.38,0.194,91,209,300,300,4,Sore
7153,2011-10-30,0,10,15,0,0,0,1,0.42,0.4242,0.35,0.1642,88,202,290,290,4,Sore
7154,2011-10-30,0,10,16,0,0,0,1,0.42,0.4242,0.32,0.1343,107,213,320,320,4,Sore
7155,2011-10-30,0,10,17,0,0,0,1,0.4,0.4091,0.35,0.1045,54,191,245,245,4,Sore
7156,2011-10-30,0,10,18,0,0,0,1,0.36,0.3485,0.4,0.1343,51,162,213,213,4,Sore
7157,2011-10-30,0,10,19,0,0,0,1,0.56,0.5303,0.49,0.2985,28,125,153,153,4,Malam
7158,2011-10-30,0,10,20,0,0,0,1,0.34,0.3636,0.57,0.0,18,74,92,92,4,Malam
7159,2011-10-30,0,10,21,0,0,0,1,0.32,0.3485,0.66,0.0,4,75,79,79,4,Malam
7160,2011-10-30,0,10,22,0,0,0,1,0.3,0.3333,0.75,0.0,13,58,71,71,4,Malam
7161,2011-10-30,0,10,23,0,0,0,1,0.26,0.303,0.87,0.0,7,30,37,37,4,Malam
7162,2011-10-31,0,10,0,0,1,1,1,0.26,0.303,0.87,0.0,3,20,23,23,4,
7163,2011-10-31,0,10,1,0,1,1,1,0.26,0.303,0.81,0.0,5,8,13,13,4,Pagi
7164,2011-10-31,0,10,2,0,1,1,1,0.24,0.2879,0.87,0.0,0,3,3,3,4,Pagi
7165,2011-10-31,0,10,3,0,1,1,1,0.24,0.2576,0.87,0.1045,0,3,3,3,4,Pagi
7166,2011-10-31,0,10,4,0,1,1,1,0.24,0.2879,0.87,0.0,1,5,6,6,4,Pagi
7167,2011-10-31,0,10,5,0,1,1,1,0.22,0.2727,0.93,0.0,0,18,18,18,4,Pagi
7168,2011-10-31,0,10,6,0,1,1,1,0.24,0.2879,0.87,0.0,4,82,86,86,4,Pagi
7169,2011-10-31,0,10,7,0,1,1,1,0.24,0.2879,0.93,0.0,11,216,227,227,4,Siang
7170,2011-10-31,0,10,8,0,1,1,2,0.28,0.3182,0.87,0.0,17,355,372,372,4,Siang
7171,2011-10-31,0,10,9,0,1,1,2,0.32,0.3182,0.76,0.1642,14,197,211,211,4,Siang
7172,2011-10-31,0,10,10,0,1,1,2,0.36,0.3485,0.57,0.1642,18,87,105,105,4,Siang
7173,2011-10-31,0,10,11,0,1,1,1,0.4,0.4091,0.5,0.1343,31,97,128,128,4,Siang
7174,2011-10-31,0,10,12,0,1,1,1,0.42,0.4242,0.44,0.2239,30,140,170,170,4,Siang
7175,2011-10-31,0,10,13,0,1,1,2,0.44,0.4394,0.44,0.2239,24,128,152,152,4,Sore
7176,2011-10-31,0,10,14,0,1,1,2,0.44,0.4394,0.47,0.2239,22,119,141,141,4,Sore
7177,2011-10-31,0,10,15,0,1,1,1,0.44,0.4394,0.47,0.1642,27,141,168,168,4,Sore
7178,2011-10-31,0,10,16,0,1,1,1,0.42,0.4242,0.54,0.1642,30,242,272,272,4,Sore
7179,2011-10-31,0,10,17,0,1,1,1,0.42,0.4242,0.54,0.1343,44,442,486,486,4,Sore
7180,2011-10-31,0,10,18,0,1,1,1,0.4,0.4091,0.66,0.0896,30,392,422,422,4,Sore
7181,2011-10-31,0,10,19,0,1,1,1,0.4,0.4091,0.66,0.0896,12,226,238,238,4,Malam
7182,2011-10-31,0,10,20,0,1,1,1,0.4,0.4091,0.66,0.0896,18,154,172,172,4,Malam
7183,2011-10-31,0,10,21,0,1,1,2,0.36,0.3485,0.76,0.194,7,109,116,116,4,Malam
7184,2011-10-31,0,10,22,0,1,1,2,0.36,0.3485,0.76,0.194,8,77,85,85,4,Malam
7185,2011-10-31,0,10,23,0,1,1,2,0.36,0.3485,0.76,0.194,6,46,52,52,4,Malam
7186,2011-11-01,0,11,0,0,2,1,2,0.36,0.3485,0.87,0.1642,3,18,21,21,4,
7187,2011-11-01,0,11,1,0,2,1,1,0.36,0.3485,0.81,0.1343,3,8,11,11,4,Pagi
7188,2011-11-01,0,11,2,0,2,1,2,0.36,0.3485,0.81,0.1642,1,3,4,4,4,Pagi
7189,2011-11-01,0,11,3,0,2,1,2,0.36,0.3485,0.81,0.1343,1,5,6,6,4,Pagi
7190,2011-11-01,0,11,4,0,2,1,1,0.34,0.3182,0.81,0.2239,1,7,8,8,4,Pagi
7191,2011-11-01,0,11,5,0,2,1,1,0.32,0.3182,0.81,0.194,0,18,18,18,4,Pagi
7192,2011-11-01,0,11,6,0,2,1,1,0.32,0.3182,0.81,0.194,3,90,93,93,4,Pagi
7193,2011-11-01,0,11,7,0,2,1,1,0.34,0.3333,0.76,0.194,8,246,254,254,4,Siang
7194,2011-11-01,0,11,8,0,2,1,1,0.36,0.3333,0.71,0.2537,17,402,419,419,4,Siang
7195,2011-11-01,0,11,9,0,2,1,1,0.4,0.4091,0.66,0.1642,16,206,222,222,4,Siang
7196,2011-11-01,0,11,10,0,2,1,1,0.44,0.4394,0.62,0.1343,21,114,135,135,4,Siang
7197,2011-11-01,0,11,11,0,2,1,1,0.46,0.4545,0.63,0.1045,16,101,117,117,4,Siang
7198,2011-11-01,0,11,12,0,2,1,1,0.5,0.4848,0.48,0.0896,23,153,176,176,4,Siang
7199,2011-11-01,0,11,13,0,2,1,1,0.48,0.4697,0.55,0.194,20,147,167,167,4,Sore
7200,2011-11-01,0,11,14,0,2,1,1,0.5,0.4848,0.48,0.2537,32,118,150,150,4,Sore
7201,2011-11-01,0,11,15,0,2,1,1,0.5,0.4848,0.45,0.1343,38,148,186,186,4,Sore
7202,2011-11-01,0,11,16,0,2,1,1,0.48,0.4697,0.44,0.1642,46,252,298,298,4,Sore
7203,2011-11-01,0,11,17,0,2,1,1,0.44,0.4394,0.54,0.1642,36,470,506,506,4,Sore
7204,2011-11-01,0,11,18,0,2,1,1,0.42,0.4242,0.58,0.1045,39,421,460,460,4,Sore
7205,2011-11-01,0,11,19,0,2,1,1,0.42,0.4242,0.58,0.0896,39,274,313,313,4,Malam
7206,2011-11-01,0,11,20,0,2,1,1,0.4,0.4091,0.71,0.0,18,191,209,209,4,Malam
7207,2011-11-01,0,11,21,0,2,1,1,0.36,0.3788,0.81,0.0,13,114,127,127,4,Malam
7208,2011-11-01,0,11,22,0,2,1,1,0.36,0.3788,0.81,0.0,5,91,96,96,4,Malam
7209,2011-11-01,0,11,23,0,2,1,1,0.34,0.3636,0.87,0.0,11,61,72,72,4,Malam
7210,2011-11-02,0,11,0,0,3,1,1,0.32,0.3485,0.87,0.0,0,19,19,19,4,
7211,2011-11-02,0,11,1,0,3,1,1,0.3,0.3333,0.87,0.0,2,8,10,10,4,Pagi
7212,2011-11-02,0,11,2,0,3,1,1,0.3,0.3333,0.87,0.0,0,2,2,2,4,Pagi
7213,2011-11-02,0,11,3,0,3,1,1,0.3,0.3333,0.75,0.0,0,2,2,2,4,Pagi
7214,2011-11-02,0,11,4,0,3,1,1,0.3,0.3333,0.87,0.0,0,4,4,4,4,Pagi
7215,2011-11-02,0,11,5,0,3,1,1,0.3,0.3333,0.81,0.0,0,27,27,27,4,Pagi
7216,2011-11-02,0,11,6,0,3,1,1,0.3,0.3333,0.81,0.0,1,91,92,92,4,Pagi
7217,2011-11-02,0,11,7,0,3,1,1,0.3,0.3333,0.81,0.0,11,240,251,251,4,Siang
7218,2011-11-02,0,11,8,0,3,1,1,0.32,0.3485,0.87,0.0,20,452,472,472,4,Siang
7219,2011-11-02,0,11,9,0,3,1,1,0.34,0.3636,0.87,0.0,15,213,228,228,4,Siang
7220,2011-11-02,0,11,10,0,3,1,1,0.4,0.4091,0.71,0.0896,25,108,133,133,4,Siang
7221,2011-11-02,0,11,11,0,3,1,1,0.42,0.4242,0.71,0.1343,27,117,144,144,4,Siang
7222,2011-11-02,0,11,12,0,3,1,1,0.46,0.4545,0.55,0.1642,32,157,189,189,4,Siang
7223,2011-11-02,0,11,13,0,3,1,1,0.48,0.4697,0.48,0.1642,22,139,161,161,4,Sore
7224,2011-11-02,0,11,14,0,3,1,1,0.5,0.4848,0.45,0.1642,40,132,172,172,4,Sore
7225,2011-11-02,0,11,15,0,3,1,1,0.48,0.4697,0.51,0.1642,26,161,187,187,4,Sore
7226,2011-11-02,0,11,16,0,3,1,1,0.48,0.4697,0.51,0.1045,35,231,266,266,4,Sore
7227,2011-11-02,0,11,17,0,3,1,1,0.44,0.4394,0.62,0.194,30,523,553,553,4,Sore
7228,2011-11-02,0,11,18,0,3,1,1,0.42,0.4242,0.71,0.1642,31,448,479,479,4,Sore
7229,2011-11-02,0,11,19,0,3,1,1,0.4,0.4091,0.76,0.1343,25,257,282,282,4,Malam
7230,2011-11-02,0,11,20,0,3,1,1,0.4,0.4091,0.66,0.1343,5,177,182,182,4,Malam
7231,2011-11-02,0,11,21,0,3,1,1,0.38,0.3939,0.71,0.1343,13,155,168,168,4,Malam
7232,2011-11-02,0,11,22,0,3,1,1,0.36,0.3485,0.71,0.1343,7,99,106,106,4,Malam
7233,2011-11-02,0,11,23,0,3,1,1,0.36,0.3636,0.76,0.0896,3,54,57,57,4,Malam
7234,2011-11-03,0,11,0,0,4,1,1,0.36,0.3636,0.76,0.0896,3,28,31,31,4,
7235,2011-11-03,0,11,1,0,4,1,1,0.34,0.3333,0.81,0.1343,3,12,15,15,4,Pagi
7236,2011-11-03,0,11,2,0,4,1,1,0.34,0.3333,0.76,0.1343,2,5,7,7,4,Pagi
7237,2011-11-03,0,11,3,0,4,1,1,0.34,0.3333,0.81,0.1343,1,4,5,5,4,Pagi
7238,2011-11-03,0,11,4,0,4,1,1,0.32,0.3333,0.81,0.0896,1,3,4,4,4,Pagi
7239,2011-11-03,0,11,5,0,4,1,1,0.32,0.3333,0.81,0.1343,1,27,28,28,4,Pagi
7240,2011-11-03,0,11,6,0,4,1,1,0.34,0.3333,0.76,0.194,3,96,99,99,4,Pagi
7241,2011-11-03,0,11,7,0,4,1,2,0.32,0.3333,0.81,0.0896,12,280,292,292,4,Siang
7242,2011-11-03,0,11,8,0,4,1,2,0.34,0.3485,0.81,0.0896,8,394,402,402,4,Siang
7243,2011-11-03,0,11,9,0,4,1,2,0.36,0.3485,0.81,0.194,9,155,164,164,4,Siang
7244,2011-11-03,0,11,10,0,4,1,2,0.4,0.4091,0.76,0.194,12,98,110,110,4,Siang
7245,2011-11-03,0,11,11,0,4,1,1,0.44,0.4394,0.67,0.194,12,108,120,120,4,Siang
7246,2011-11-03,0,11,12,0,4,1,1,0.5,0.4848,0.51,0.194,17,162,179,179,4,Siang
7247,2011-11-03,0,11,13,0,4,1,2,0.52,0.5,0.48,0.2537,19,150,169,169,4,Sore
7248,2011-11-03,0,11,14,0,4,1,1,0.52,0.5,0.52,0.1642,32,120,152,152,4,Sore
7249,2011-11-03,0,11,15,0,4,1,1,0.52,0.5,0.52,0.1642,24,138,162,162,4,Sore
7250,2011-11-03,0,11,16,0,4,1,1,0.52,0.5,0.48,0.194,33,234,267,267,4,Sore
7251,2011-11-03,0,11,17,0,4,1,1,0.48,0.4697,0.55,0.0896,33,465,498,498,4,Sore
7252,2011-11-03,0,11,18,0,4,1,1,0.46,0.4545,0.63,0.1343,24,409,433,433,4,Sore
7253,2011-11-03,0,11,19,0,4,1,1,0.44,0.4394,0.67,0.0896,18,234,252,252,4,Malam
7254,2011-11-03,0,11,20,0,4,1,1,0.42,0.4242,0.71,0.1045,11,198,209,209,4,Malam
7255,2011-11-03,0,11,21,0,4,1,1,0.4,0.4091,0.76,0.1343,4,140,144,144,4,Malam
7256,2011-11-03,0,11,22,0,4,1,1,0.4,0.4091,0.82,0.0,21,116,137,137,4,Malam
7257,2011-11-03,0,11,23,0,4,1,1,0.4,0.4091,0.82,0.0896,15,80,95,95,4,Malam
7258,2011-11-04,0,11,0,0,5,1,2,0.4,0.4091,0.82,0.0,11,32,43,43,4,
7259,2011-11-04,0,11,1,0,5,1,2,0.4,0.4091,0.82,0.0,1,16,17,17,4,Pagi
7260,2011-11-04,0,11,2,0,5,1,2,0.4,0.4091,0.76,0.0,2,8,10,10,4,Pagi
7261,2011-11-04,0,11,3,0,5,1,2,0.38,0.3939,0.87,0.1642,1,7,8,8,4,Pagi
7262,2011-11-04,0,11,4,0,5,1,2,0.38,0.3939,0.87,0.0896,1,6,7,7,4,Pagi
7263,2011-11-04,0,11,5,0,5,1,2,0.38,0.3939,0.87,0.0,0,23,23,23,4,Pagi
7264,2011-11-04,0,11,6,0,5,1,2,0.38,0.3939,0.87,0.0896,2,64,66,66,4,Pagi
7265,2011-11-04,0,11,7,0,5,1,2,0.4,0.4091,0.86,0.2239,10,235,245,245,4,Siang
7266,2011-11-04,0,11,8,0,5,1,2,0.4,0.4091,0.87,0.3582,8,387,395,395,4,Siang
7267,2011-11-04,0,11,9,0,5,1,2,0.42,0.4242,0.71,0.4627,15,239,254,254,4,Siang
7268,2011-11-04,0,11,10,0,5,1,2,0.42,0.4242,0.71,0.3284,19,115,134,134,4,Siang
7269,2011-11-04,0,11,11,0,5,1,2,0.44,0.4394,0.67,0.4478,34,128,162,162,4,Siang
7270,2011-11-04,0,11,12,0,5,1,2,0.48,0.4697,0.55,0.4925,44,153,197,197,4,Siang
7271,2011-11-04,0,11,13,0,5,1,1,0.44,0.4394,0.51,0.4179,33,161,194,194,4,Sore
7272,2011-11-04,0,11,14,0,5,1,1,0.44,0.4394,0.47,0.2985,54,147,201,201,4,Sore
7273,2011-11-04,0,11,15,0,5,1,1,0.46,0.4545,0.44,0.3881,45,192,237,237,4,Sore
7274,2011-11-04,0,11,16,0,5,1,1,0.46,0.4545,0.36,0.3881,53,237,290,290,4,Sore
7275,2011-11-04,0,11,17,0,5,1,1,0.42,0.4242,0.38,0.3582,42,438,480,480,4,Sore
7276,2011-11-04,0,11,18,0,5,1,1,0.42,0.4242,0.32,0.4627,35,339,374,374,4,Sore
7277,2011-11-04,0,11,19,0,5,1,1,0.4,0.4091,0.37,0.3582,14,182,196,196,4,Malam
7278,2011-11-04,0,11,20,0,5,1,1,0.36,0.3333,0.43,0.2836,15,171,186,186,4,Malam
7279,2011-11-04,0,11,21,0,5,1,1,0.34,0.3182,0.46,0.2537,8,115,123,123,4,Malam
7280,2011-11-04,0,11,22,0,5,1,1,0.34,0.303,0.46,0.3284,6,109,115,115,4,Malam
7281,2011-11-04,0,11,23,0,5,1,1,0.32,0.303,0.49,0.3284,17,72,89,89,4,Malam
7282,2011-11-05,0,11,0,0,6,0,1,0.32,0.2879,0.45,0.3582,4,48,52,52,4,
7283,2011-11-05,0,11,1,0,6,0,1,0.32,0.303,0.45,0.2985,5,57,62,62,4,Pagi
7284,2011-11-05,0,11,2,0,6,0,1,0.3,0.2727,0.52,0.3284,7,24,31,31,4,Pagi
7285,2011-11-05,0,11,3,0,6,0,1,0.3,0.2727,0.52,0.2985,0,8,8,8,4,Pagi
7286,2011-11-05,0,11,4,0,6,0,1,0.28,0.2576,0.56,0.3284,3,5,8,8,4,Pagi
7287,2011-11-05,0,11,5,0,6,0,1,0.26,0.2273,0.6,0.3284,0,2,2,2,4,Pagi
7288,2011-11-05,0,11,6,0,6,0,1,0.26,0.2424,0.6,0.2537,3,20,23,23,4,Pagi
7289,2011-11-05,0,11,7,0,6,0,1,0.26,0.2424,0.6,0.2836,3,31,34,34,4,Siang
7290,2011-11-05,0,11,8,0,6,0,1,0.28,0.2576,0.56,0.3284,4,80,84,84,4,Siang
7291,2011-11-05,0,11,9,0,6,0,1,0.3,0.2727,0.56,0.2985,30,111,141,141,4,Siang
7292,2011-11-05,0,11,10,0,6,0,1,0.32,0.303,0.53,0.2537,56,171,227,227,4,Siang
7293,2011-11-05,0,11,11,0,6,0,1,0.36,0.3636,0.46,0.1045,69,169,238,238,4,Siang
7294,2011-11-05,0,11,12,0,6,0,1,0.36,0.3485,0.46,0.1642,137,235,372,372,4,Siang
7295,2011-11-05,0,11,13,0,6,0,1,0.4,0.4091,0.37,0.1045,148,207,355,355,4,Sore
7296,2011-11-05,0,11,14,0,6,0,1,0.42,0.4242,0.35,0.1343,159,227,386,386,4,Sore
7297,2011-11-05,0,11,15,0,6,0,1,0.4,0.4091,0.37,0.194,141,202,343,343,4,Sore
7298,2011-11-05,0,11,16,0,6,0,1,0.4,0.4091,0.4,0.2239,128,207,335,335,4,Sore
7299,2011-11-05,0,11,17,0,6,0,1,0.38,0.3939,0.4,0.1642,100,234,334,334,4,Sore
7300,2011-11-05,0,11,18,0,6,0,1,0.36,0.3636,0.5,0.0896,52,185,237,237,4,Sore
7301,2011-11-05,0,11,19,0,6,0,1,0.34,0.3636,0.53,0.0,45,159,204,204,4,Malam
7302,2011-11-05,0,11,20,0,6,0,1,0.32,0.3485,0.66,0.0,29,136,165,165,4,Malam
7303,2011-11-05,0,11,21,0,6,0,1,0.32,0.3485,0.66,0.0,19,99,118,118,4,Malam
7304,2011-11-05,0,11,22,0,6,0,1,0.3,0.3333,0.65,0.0,10,72,82,82,4,Malam
7305,2011-11-05,0,11,23,0,6,0,1,0.28,0.3182,0.7,0.0,4,81,85,85,4,Malam
7306,2011-11-06,0,11,0,0,0,0,1,0.28,0.3182,0.75,0.0,10,65,75,75,4,
7307,2011-11-06,0,11,1,0,0,0,1,0.26,0.303,0.81,0.0,11,104,115,115,4,Pagi
7308,2011-11-06,0,11,2,0,0,0,1,0.26,0.303,0.81,0.0,6,23,29,29,4,Pagi
7309,2011-11-06,0,11,3,0,0,0,1,0.24,0.2879,0.87,0.0,5,4,9,9,4,Pagi
7310,2011-11-06,0,11,4,0,0,0,1,0.24,0.2879,0.87,0.0,0,6,6,6,4,Pagi
7311,2011-11-06,0,11,5,0,0,0,1,0.24,0.2424,0.87,0.1343,0,5,5,5,4,Pagi
7312,2011-11-06,0,11,6,0,0,0,1,0.26,0.2879,0.81,0.0896,5,11,16,16,4,Pagi
7313,2011-11-06,0,11,7,0,0,0,1,0.26,0.2727,0.87,0.1045,4,24,28,28,4,Siang
7314,2011-11-06,0,11,8,0,0,0,2,0.28,0.303,0.87,0.0896,19,71,90,90,4,Siang
7315,2011-11-06,0,11,9,0,0,0,2,0.3,0.3182,0.75,0.0896,36,134,170,170,4,Siang
7316,2011-11-06,0,11,10,0,0,0,1,0.36,0.3636,0.66,0.0896,76,186,262,262,4,Siang
7317,2011-11-06,0,11,11,0,0,0,1,0.42,0.4242,0.58,0.0896,104,216,320,320,4,Siang
7318,2011-11-06,0,11,12,0,0,0,1,0.44,0.4394,0.54,0.0,120,226,346,346,4,Siang
7319,2011-11-06,0,11,13,0,0,0,1,0.46,0.4545,0.51,0.1642,105,209,314,314,4,Sore
7320,2011-11-06,0,11,14,0,0,0,1,0.46,0.4545,0.55,0.194,101,219,320,320,4,Sore
7321,2011-11-06,0,11,15,0,0,0,1,0.48,0.4697,0.51,0.194,96,210,306,306,4,Sore
7322,2011-11-06,0,11,16,0,0,0,1,0.46,0.4545,0.55,0.2239,84,263,347,347,4,Sore
7323,2011-11-06,0,11,17,0,0,0,1,0.44,0.4394,0.62,0.1642,71,185,256,256,4,Sore
7324,2011-11-06,0,11,18,0,0,0,1,0.42,0.4242,0.71,0.1045,39,146,185,185,4,Sore
7325,2011-11-06,0,11,19,0,0,0,1,0.38,0.3939,0.76,0.194,21,130,151,151,4,Malam
7326,2011-11-06,0,11,20,0,0,0,1,0.36,0.3636,0.81,0.1045,16,100,116,116,4,Malam
7327,2011-11-06,0,11,21,0,0,0,1,0.36,0.3636,0.81,0.0896,11,77,88,88,4,Malam
7328,2011-11-06,0,11,22,0,0,0,1,0.36,0.3788,0.87,0.0,5,40,45,45,4,Malam
7329,2011-11-06,0,11,23,0,0,0,1,0.34,0.3485,0.87,0.0896,7,43,50,50,4,Malam
7330,2011-11-07,0,11,0,0,1,1,1,0.34,0.3636,0.87,0.0,1,14,15,15,4,
7331,2011-11-07,0,11,1,0,1,1,1,0.34,0.3636,0.87,0.0,2,6,8,8,4,Pagi
7332,2011-11-07,0,11,2,0,1,1,1,0.32,0.3485,0.93,0.0,0,2,2,2,4,Pagi
7333,2011-11-07,0,11,3,0,1,1,1,0.32,0.3485,0.93,0.0,0,3,3,3,4,Pagi
7334,2011-11-07,0,11,4,0,1,1,1,0.32,0.3485,0.93,0.0,2,4,6,6,4,Pagi
7335,2011-11-07,0,11,5,0,1,1,1,0.3,0.3333,0.93,0.0,1,25,26,26,4,Pagi
7336,2011-11-07,0,11,6,0,1,1,2,0.28,0.3182,0.93,0.0,2,97,99,99,4,Pagi
7337,2011-11-07,0,11,7,0,1,1,2,0.28,0.3182,0.93,0.0,6,305,311,311,4,Siang
7338,2011-11-07,0,11,8,0,1,1,2,0.3,0.3182,1.0,0.0896,13,397,410,410,4,Siang
7339,2011-11-07,0,11,9,0,1,1,2,0.34,0.3333,1.0,0.1343,18,156,174,174,4,Siang
7340,2011-11-07,0,11,10,0,1,1,1,0.36,0.3485,0.93,0.1343,28,95,123,123,4,Siang
7341,2011-11-07,0,11,11,0,1,1,1,0.42,0.4242,0.77,0.1045,28,100,128,128,4,Siang
7342,2011-11-07,0,11,12,0,1,1,1,0.46,0.4545,0.67,0.0,21,158,179,179,4,Siang
7343,2011-11-07,0,11,13,0,1,1,1,0.54,0.5152,0.49,0.0896,32,157,189,189,4,Sore
7344,2011-11-07,0,11,14,0,1,1,1,0.56,0.5303,0.37,0.1642,30,115,145,145,4,Sore
7345,2011-11-07,0,11,15,0,1,1,1,0.56,0.5303,0.37,0.1045,38,132,170,170,4,Sore
7346,2011-11-07,0,11,16,0,1,1,1,0.52,0.5,0.45,0.0,40,255,295,295,4,Sore
7347,2011-11-07,0,11,17,0,1,1,1,0.5,0.4848,0.45,0.1642,39,489,528,528,4,Sore
7348,2011-11-07,0,11,18,0,1,1,1,0.46,0.4545,0.59,0.1045,18,407,425,425,4,Sore
7349,2011-11-07,0,11,19,0,1,1,1,0.46,0.4545,0.59,0.0,20,280,300,300,4,Malam
7350,2011-11-07,0,11,20,0,1,1,1,0.4,0.4091,0.71,0.0,17,187,204,204,4,Malam
7351,2011-11-07,0,11,21,0,1,1,1,0.38,0.3939,0.82,0.1045,10,129,139,139,4,Malam
7352,2011-11-07,0,11,22,0,1,1,1,0.36,0.3636,0.81,0.0896,6,102,108,108,4,Malam
7353,2011-11-07,0,11,23,0,1,1,1,0.36,0.3636,0.87,0.0896,1,47,48,48,4,Malam
7354,2011-11-08,0,11,0,0,2,1,1,0.34,0.3485,0.87,0.0896,0,18,18,18,4,
7355,2011-11-08,0,11,1,0,2,1,1,0.32,0.3333,0.93,0.1045,3,8,11,11,4,Pagi
7356,2011-11-08,0,11,2,0,2,1,1,0.32,0.3485,0.87,0.0,0,1,1,1,4,Pagi
7357,2011-11-08,0,11,3,0,2,1,1,0.32,0.3485,0.87,0.0,0,3,3,3,4,Pagi
7358,2011-11-08,0,11,4,0,2,1,1,0.3,0.3333,0.87,0.0,0,4,4,4,4,Pagi
7359,2011-11-08,0,11,5,0,2,1,1,0.3,0.3182,0.87,0.0896,1,17,18,18,4,Pagi
7360,2011-11-08,0,11,6,0,2,1,1,0.3,0.3333,0.87,0.0,3,96,99,99,4,Pagi
7361,2011-11-08,0,11,7,0,2,1,1,0.3,0.3182,0.87,0.1045,7,316,323,323,4,Siang
7362,2011-11-08,0,11,8,0,2,1,1,0.32,0.3333,0.93,0.1045,11,455,466,466,4,Siang
7363,2011-11-08,0,11,9,0,2,1,1,0.36,0.3788,0.87,0.0,14,177,191,191,4,Siang
7364,2011-11-08,0,11,10,0,2,1,1,0.42,0.4242,0.71,0.0896,25,104,129,129,4,Siang
7365,2011-11-08,0,11,11,0,2,1,1,0.46,0.4545,0.63,0.1343,21,126,147,147,4,Siang
7366,2011-11-08,0,11,12,0,2,1,1,0.52,0.5,0.52,0.1343,28,175,203,203,4,Siang
7367,2011-11-08,0,11,13,0,2,1,1,0.54,0.5152,0.49,0.1642,31,165,196,196,4,Sore
7368,2011-11-08,0,11,14,0,2,1,1,0.56,0.5303,0.46,0.1045,32,129,161,161,4,Sore
7369,2011-11-08,0,11,15,0,2,1,1,0.58,0.5455,0.46,0.1045,33,155,188,188,4,Sore
7370,2011-11-08,0,11,16,0,2,1,1,0.56,0.5303,0.46,0.1343,39,250,289,289,4,Sore
7371,2011-11-08,0,11,17,0,2,1,1,0.52,0.5,0.43,0.1642,40,459,499,499,4,Sore
7372,2011-11-08,0,11,18,0,2,1,1,0.48,0.4697,0.55,0.1343,30,432,462,462,4,Sore
7373,2011-11-08,0,11,19,0,2,1,1,0.46,0.4545,0.59,0.0,14,264,278,278,4,Malam
7374,2011-11-08,0,11,20,0,2,1,1,0.4,0.4091,0.76,0.0,12,169,181,181,4,Malam
7375,2011-11-08,0,11,21,0,2,1,1,0.4,0.4091,0.76,0.0,16,166,182,182,4,Malam
7376,2011-11-08,0,11,22,0,2,1,1,0.36,0.3788,0.87,0.0,13,95,108,108,4,Malam
7377,2011-11-08,0,11,23,0,2,1,1,0.36,0.3788,0.81,0.0,3,45,48,48,4,Malam
7378,2011-11-09,0,11,0,0,3,1,1,0.36,0.3788,0.87,0.0,0,13,13,13,4,
7379,2011-11-09,0,11,1,0,3,1,1,0.34,0.3636,0.87,0.0,0,10,10,10,4,Pagi
7380,2011-11-09,0,11,2,0,3,1,1,0.32,0.3485,0.93,0.0,0,5,5,5,4,Pagi
7381,2011-11-09,0,11,3,0,3,1,1,0.32,0.3485,0.93,0.0,0,4,4,4,4,Pagi
7382,2011-11-09,0,11,4,0,3,1,1,0.32,0.3485,0.87,0.0,0,4,4,4,4,Pagi
7383,2011-11-09,0,11,5,0,3,1,1,0.3,0.3333,0.87,0.0,0,28,28,28,4,Pagi
7384,2011-11-09,0,11,6,0,3,1,1,0.3,0.3333,0.87,0.0,0,98,98,98,4,Pagi
7385,2011-11-09,0,11,7,0,3,1,1,0.3,0.3333,0.87,0.0,0,300,300,300,4,Siang
7386,2011-11-09,0,11,8,0,3,1,1,0.32,0.3485,0.93,0.0,19,437,456,456,4,Siang
7387,2011-11-09,0,11,9,0,3,1,1,0.34,0.3636,0.93,0.0,22,197,219,219,4,Siang
7388,2011-11-09,0,11,10,0,3,1,1,0.4,0.4091,0.76,0.1045,16,89,105,105,4,Siang
7389,2011-11-09,0,11,11,0,3,1,1,0.46,0.4545,0.67,0.1642,21,131,152,152,4,Siang
7390,2011-11-09,0,11,12,0,3,1,1,0.5,0.4848,0.51,0.1642,24,156,180,180,4,Siang
7391,2011-11-09,0,11,13,0,3,1,1,0.5,0.4848,0.51,0.1642,31,136,167,167,4,Sore
7392,2011-11-09,0,11,14,0,3,1,1,0.52,0.5,0.48,0.1642,26,153,179,179,4,Sore
7393,2011-11-09,0,11,15,0,3,1,1,0.52,0.5,0.45,0.2239,21,130,151,151,4,Sore
7394,2011-11-09,0,11,16,0,3,1,1,0.52,0.5,0.48,0.194,24,257,281,281,4,Sore
7395,2011-11-09,0,11,17,0,3,1,1,0.46,0.4545,0.63,0.1045,27,458,485,485,4,Sore
7396,2011-11-09,0,11,18,0,3,1,1,0.44,0.4394,0.67,0.1045,21,387,408,408,4,Sore
7397,2011-11-09,0,11,19,0,3,1,1,0.44,0.4394,0.72,0.1045,12,292,304,304,4,Malam
7398,2011-11-09,0,11,20,0,3,1,1,0.44,0.4394,0.77,0.0,18,201,219,219,4,Malam
7399,2011-11-09,0,11,21,0,3,1,1,0.4,0.4091,0.87,0.0,9,152,161,161,4,Malam
7400,2011-11-09,0,11,22,0,3,1,1,0.4,0.4091,0.87,0.0,9,105,114,114,4,Malam
7401,2011-11-09,0,11,23,0,3,1,1,0.38,0.3939,0.87,0.0,5,61,66,66,4,Malam
7402,2011-11-10,0,11,0,0,4,1,1,0.4,0.4091,0.87,0.0,0,24,24,24,4,
7403,2011-11-10,0,11,1,0,4,1,2,0.4,0.4091,0.87,0.0,1,10,11,11,4,Pagi
7404,2011-11-10,0,11,2,0,4,1,2,0.38,0.3939,0.94,0.0,0,5,5,5,4,Pagi
7405,2011-11-10,0,11,3,0,4,1,1,0.38,0.3939,0.94,0.0896,0,11,11,11,4,Pagi
7406,2011-11-10,0,11,4,0,4,1,1,0.38,0.3939,0.94,0.0896,1,2,3,3,4,Pagi
7407,2011-11-10,0,11,5,0,4,1,2,0.36,0.3485,1.0,0.1343,1,22,23,23,4,Pagi
7408,2011-11-10,0,11,6,0,4,1,2,0.36,0.3485,1.0,0.1343,4,110,114,114,4,Pagi
7409,2011-11-10,0,11,7,0,4,1,2,0.38,0.3939,0.94,0.1642,6,266,272,272,4,Siang
7410,2011-11-10,0,11,8,0,4,1,2,0.4,0.4091,0.94,0.0896,18,418,436,436,4,Siang
7411,2011-11-10,0,11,9,0,4,1,2,0.42,0.4242,0.94,0.1045,23,188,211,211,4,Siang
7412,2011-11-10,0,11,10,0,4,1,2,0.44,0.4394,0.88,0.2239,17,100,117,117,4,Siang
7413,2011-11-10,0,11,11,0,4,1,2,0.46,0.4545,0.67,0.3881,9,99,108,108,4,Siang
7414,2011-11-10,0,11,12,0,4,1,2,0.42,0.4242,0.67,0.3582,18,149,167,167,4,Siang
7415,2011-11-10,0,11,13,0,4,1,3,0.36,0.3333,0.81,0.3582,9,87,96,96,4,Sore
7416,2011-11-10,0,11,14,0,4,1,3,0.36,0.3333,0.87,0.2836,6,58,64,64,4,Sore
7417,2011-11-10,0,11,15,0,4,1,3,0.36,0.3333,0.81,0.2985,5,57,62,62,4,Sore
7418,2011-11-10,0,11,16,0,4,1,3,0.36,0.3485,0.81,0.2239,6,67,73,73,4,Sore
7419,2011-11-10,0,11,17,0,4,1,3,0.36,0.3485,0.81,0.2239,9,168,177,177,4,Sore
7420,2011-11-10,0,11,18,0,4,1,2,0.36,0.3485,0.81,0.1642,10,263,273,273,4,Sore
7421,2011-11-10,0,11,19,0,4,1,2,0.36,0.3485,0.71,0.2239,19,192,211,211,4,Malam
7422,2011-11-10,0,11,20,0,4,1,2,0.36,0.3333,0.62,0.2836,8,160,168,168,4,Malam
7423,2011-11-10,0,11,21,0,4,1,1,0.36,0.3333,0.57,0.2537,6,130,136,136,4,Malam
7424,2011-11-10,0,11,22,0,4,1,1,0.36,0.3333,0.53,0.2836,5,84,89,89,4,Malam
7425,2011-11-10,0,11,23,0,4,1,2,0.34,0.3333,0.57,0.1642,9,73,82,82,4,Malam
7426,2011-11-11,0,11,0,1,5,0,1,0.34,0.3182,0.53,0.2537,10,56,66,66,4,
7427,2011-11-11,0,11,1,1,5,0,1,0.32,0.303,0.57,0.3284,3,16,19,19,4,Pagi
7428,2011-11-11,0,11,2,1,5,0,1,0.32,0.2879,0.57,0.2836,1,10,11,11,4,Pagi
7429,2011-11-11,0,11,3,1,5,0,1,0.3,0.2879,0.61,0.194,0,6,6,6,4,Pagi
7430,2011-11-11,0,11,4,1,5,0,1,0.3,0.2879,0.61,0.194,0,8,8,8,4,Pagi
7431,2011-11-11,0,11,5,1,5,0,1,0.3,0.2879,0.49,0.2537,0,13,13,13,4,Pagi
7432,2011-11-11,0,11,6,1,5,0,1,0.28,0.2576,0.45,0.3284,0,46,46,46,4,Pagi
7433,2011-11-11,0,11,7,1,5,0,1,0.28,0.2727,0.45,0.2537,5,116,121,121,4,Siang
7434,2011-11-11,0,11,8,1,5,0,1,0.3,0.2727,0.42,0.3582,9,249,258,258,4,Siang
7435,2011-11-11,0,11,9,1,5,0,1,0.32,0.2879,0.45,0.4478,15,186,201,201,4,Siang
7436,2011-11-11,0,11,10,1,5,0,1,0.32,0.2727,0.42,0.5522,38,162,200,200,4,Siang
7437,2011-11-11,0,11,11,1,5,0,1,0.34,0.2879,0.42,0.4925,20,150,170,170,4,Siang
7438,2011-11-11,0,11,12,1,5,0,1,0.34,0.2879,0.42,0.4627,41,198,239,239,4,Siang
7439,2011-11-11,0,11,13,1,5,0,1,0.38,0.3939,0.37,0.5522,57,179,236,236,4,Sore
7440,2011-11-11,0,11,14,1,5,0,1,0.38,0.3939,0.37,0.4627,64,183,247,247,4,Sore
7441,2011-11-11,0,11,15,1,5,0,1,0.36,0.3333,0.37,0.4179,29,187,216,216,4,Sore
7442,2011-11-11,0,11,16,1,5,0,1,0.36,0.3333,0.34,0.3284,49,189,238,238,4,Sore
7443,2011-11-11,0,11,17,1,5,0,1,0.34,0.303,0.39,0.3284,24,286,310,310,4,Sore
7444,2011-11-11,0,11,18,1,5,0,1,0.34,0.3182,0.39,0.2537,23,185,208,208,4,Sore
7445,2011-11-11,0,11,19,1,5,0,1,0.32,0.3182,0.39,0.1642,17,182,199,199,4,Malam
7446,2011-11-11,0,11,20,1,5,0,1,0.32,0.3182,0.39,0.194,12,97,109,109,4,Malam
7447,2011-11-11,0,11,21,1,5,0,1,0.3,0.303,0.45,0.1642,4,79,83,83,4,Malam
7448,2011-11-11,0,11,22,1,5,0,1,0.32,0.3182,0.39,0.194,13,78,91,91,4,Malam
7449,2011-11-11,0,11,23,1,5,0,1,0.3,0.3182,0.45,0.0896,6,67,73,73,4,Malam
7450,2011-11-12,0,11,0,0,6,0,1,0.24,0.2424,0.6,0.1343,12,52,64,64,4,
7451,2011-11-12,0,11,1,0,6,0,1,0.24,0.2424,0.6,0.1343,9,45,54,54,4,Pagi
7452,2011-11-12,0,11,2,0,6,0,1,0.24,0.2576,0.65,0.0896,7,39,46,46,4,Pagi
7453,2011-11-12,0,11,3,0,6,0,1,0.24,0.2424,0.7,0.1343,4,13,17,17,4,Pagi
7454,2011-11-12,0,11,4,0,6,0,1,0.2,0.2121,0.8,0.1343,0,7,7,7,4,Pagi
7455,2011-11-12,0,11,5,0,6,0,1,0.22,0.2576,0.75,0.0896,1,3,4,4,4,Pagi
7456,2011-11-12,0,11,6,0,6,0,1,0.22,0.2273,0.75,0.1642,0,7,7,7,4,Pagi
7457,2011-11-12,0,11,7,0,6,0,1,0.22,0.2273,0.75,0.194,3,24,27,27,4,Siang
7458,2011-11-12,0,11,8,0,6,0,1,0.26,0.2576,0.7,0.194,14,87,101,101,4,Siang
7459,2011-11-12,0,11,9,0,6,0,1,0.3,0.303,0.61,0.1642,18,142,160,160,4,Siang
7460,2011-11-12,0,11,10,0,6,0,1,0.34,0.3182,0.61,0.2836,62,170,232,232,4,Siang
7461,2011-11-12,0,11,11,0,6,0,1,0.38,0.3939,0.54,0.2836,102,213,315,315,4,Siang
7462,2011-11-12,0,11,12,0,6,0,1,0.44,0.4394,0.44,0.2836,142,224,366,366,4,Siang
7463,2011-11-12,0,11,13,0,6,0,1,0.48,0.4697,0.36,0.2836,128,225,353,353,4,Sore
7464,2011-11-12,0,11,14,0,6,0,1,0.5,0.4848,0.36,0.2985,191,244,435,435,4,Sore
7465,2011-11-12,0,11,15,0,6,0,1,0.52,0.5,0.29,0.2836,165,221,386,386,4,Sore
7466,2011-11-12,0,11,16,0,6,0,1,0.52,0.5,0.32,0.2537,137,224,361,361,4,Sore
7467,2011-11-12,0,11,17,0,6,0,1,0.5,0.4848,0.34,0.2537,92,193,285,285,4,Sore
7468,2011-11-12,0,11,18,0,6,0,1,0.42,0.4242,0.58,0.194,53,150,203,203,4,Sore
7469,2011-11-12,0,11,19,0,6,0,1,0.42,0.4242,0.5,0.2537,32,139,171,171,4,Malam
7470,2011-11-12,0,11,20,0,6,0,1,0.42,0.4242,0.5,0.2836,31,101,132,132,4,Malam
7471,2011-11-12,0,11,21,0,6,0,1,0.42,0.4242,0.47,0.2836,19,103,122,122,4,Malam
7472,2011-11-12,0,11,22,0,6,0,1,0.42,0.4242,0.47,0.2537,30,88,118,118,4,Malam
7473,2011-11-12,0,11,23,0,6,0,1,0.4,0.4091,0.58,0.1642,23,78,101,101,4,Malam
7474,2011-11-13,0,11,0,0,0,0,2,0.4,0.4091,0.58,0.194,12,61,73,73,4,
7475,2011-11-13,0,11,1,0,0,0,2,0.36,0.3485,0.66,0.194,13,58,71,71,4,Pagi
7476,2011-11-13,0,11,2,0,0,0,1,0.36,0.3636,0.57,0.1045,9,48,57,57,4,Pagi
7477,2011-11-13,0,11,3,0,0,0,2,0.36,0.3485,0.62,0.1343,8,20,28,28,4,Pagi
7478,2011-11-13,0,11,4,0,0,0,2,0.36,0.3485,0.62,0.1343,1,5,6,6,4,Pagi
7479,2011-11-13,0,11,5,0,0,0,1,0.34,0.3333,0.61,0.1642,2,3,5,5,4,Pagi
7480,2011-11-13,0,11,6,0,0,0,1,0.34,0.3333,0.66,0.1343,5,18,23,23,4,Pagi
7481,2011-11-13,0,11,7,0,0,0,1,0.34,0.3182,0.66,0.2239,13,30,43,43,4,Siang
7482,2011-11-13,0,11,8,0,0,0,1,0.34,0.3485,0.66,0.0896,24,55,79,79,4,Siang
7483,2011-11-13,0,11,9,0,0,0,1,0.4,0.4091,0.54,0.2836,38,97,135,135,4,Siang
7484,2011-11-13,0,11,10,0,0,0,1,0.44,0.4394,0.44,0.3284,63,178,241,241,4,Siang
7485,2011-11-13,0,11,11,0,0,0,1,0.46,0.4545,0.4,0.4179,108,187,295,295,4,Siang
7486,2011-11-13,0,11,12,0,0,0,2,0.52,0.5,0.29,0.4179,112,242,354,354,4,Siang
7487,2011-11-13,0,11,13,0,0,0,2,0.52,0.5,0.29,0.4179,105,234,339,339,4,Sore
7488,2011-11-13,0,11,14,0,0,0,2,0.54,0.5152,0.28,0.4925,108,263,371,371,4,Sore
7489,2011-11-13,0,11,15,0,0,0,2,0.5,0.4848,0.42,0.3284,89,221,310,310,4,Sore
7490,2011-11-13,0,11,16,0,0,0,2,0.54,0.5152,0.28,0.3881,93,226,319,319,4,Sore
7491,2011-11-13,0,11,17,0,0,0,1,0.52,0.5,0.27,0.3284,44,187,231,231,4,Sore
7492,2011-11-13,0,11,18,0,0,0,1,0.52,0.5,0.27,0.3284,35,155,190,190,4,Sore
7493,2011-11-13,0,11,19,0,0,0,1,0.5,0.4848,0.29,0.3582,36,121,157,157,4,Malam
7494,2011-11-13,0,11,20,0,0,0,1,0.5,0.4848,0.31,0.3582,24,115,139,139,4,Malam
7495,2011-11-13,0,11,21,0,0,0,1,0.48,0.4697,0.36,0.2537,19,76,95,95,4,Malam
7496,2011-11-13,0,11,22,0,0,0,1,0.48,0.4697,0.41,0.3881,25,64,89,89,4,Malam
7497,2011-11-13,0,11,23,0,0,0,1,0.46,0.4545,0.51,0.2985,18,49,67,67,4,Malam
7498,2011-11-14,0,11,0,0,1,1,1,0.46,0.4545,0.59,0.2836,8,22,30,30,4,
7499,2011-11-14,0,11,1,0,1,1,1,0.46,0.4545,0.63,0.2985,5,6,11,11,4,Pagi
7500,2011-11-14,0,11,2,0,1,1,1,0.46,0.4545,0.63,0.3582,7,10,17,17,4,Pagi
7501,2011-11-14,0,11,3,0,1,1,1,0.44,0.4394,0.67,0.2836,4,3,7,7,4,Pagi
7502,2011-11-14,0,11,4,0,1,1,1,0.44,0.4394,0.67,0.2239,0,5,5,5,4,Pagi
7503,2011-11-14,0,11,5,0,1,1,2,0.44,0.4394,0.67,0.2537,0,19,19,19,4,Pagi
7504,2011-11-14,0,11,6,0,1,1,2,0.44,0.4394,0.72,0.2239,10,104,114,114,4,Pagi
7505,2011-11-14,0,11,7,0,1,1,1,0.44,0.4394,0.72,0.2537,11,311,322,322,4,Siang
7506,2011-11-14,0,11,8,0,1,1,2,0.46,0.4545,0.67,0.194,27,425,452,452,4,Siang
7507,2011-11-14,0,11,9,0,1,1,2,0.48,0.4697,0.67,0.3284,29,204,233,233,4,Siang
7508,2011-11-14,0,11,10,0,1,1,2,0.5,0.4848,0.63,0.2836,26,85,111,111,4,Siang
7509,2011-11-14,0,11,11,0,1,1,2,0.54,0.5152,0.6,0.2836,22,106,128,128,4,Siang
7510,2011-11-14,0,11,12,0,1,1,1,0.56,0.5303,0.56,0.2985,36,166,202,202,4,Siang
7511,2011-11-14,0,11,13,0,1,1,1,0.6,0.6212,0.49,0.3881,50,153,203,203,4,Sore
7512,2011-11-14,0,11,14,0,1,1,1,0.62,0.6212,0.46,0.4478,47,138,185,185,4,Sore
7513,2011-11-14,0,11,15,0,1,1,1,0.64,0.6212,0.44,0.3284,53,142,195,195,4,Sore
7514,2011-11-14,0,11,16,0,1,1,1,0.62,0.6212,0.46,0.4179,51,264,315,315,4,Sore
7515,2011-11-14,0,11,17,0,1,1,1,0.62,0.6212,0.46,0.2537,55,464,519,519,4,Sore
7516,2011-11-14,0,11,18,0,1,1,1,0.56,0.5303,0.56,0.2836,29,460,489,489,4,Sore
7517,2011-11-14,0,11,19,0,1,1,1,0.6,0.6212,0.53,0.2985,28,274,302,302,4,Malam
7518,2011-11-14,0,11,20,0,1,1,1,0.6,0.6212,0.53,0.3582,30,210,240,240,4,Malam
7519,2011-11-14,0,11,21,0,1,1,1,0.6,0.6212,0.53,0.3582,37,176,213,213,4,Malam
7520,2011-11-14,0,11,22,0,1,1,1,0.58,0.5455,0.56,0.3582,17,96,113,113,4,Malam
7521,2011-11-14,0,11,23,0,1,1,1,0.56,0.5303,0.64,0.2985,13,48,61,61,4,Malam
7522,2011-11-15,0,11,0,0,2,1,1,0.56,0.5303,0.64,0.3582,7,15,22,22,4,
7523,2011-11-15,0,11,1,0,2,1,1,0.56,0.5303,0.6,0.2985,5,5,10,10,4,Pagi
7524,2011-11-15,0,11,2,0,2,1,1,0.56,0.5303,0.64,0.2537,7,8,15,15,4,Pagi
7525,2011-11-15,0,11,3,0,2,1,2,0.54,0.5152,0.68,0.3284,0,4,4,4,4,Pagi
7526,2011-11-15,0,11,4,0,2,1,1,0.56,0.5303,0.64,0.2985,1,6,7,7,4,Pagi
7527,2011-11-15,0,11,5,0,2,1,1,0.54,0.5152,0.68,0.2836,2,26,28,28,4,Pagi
7528,2011-11-15,0,11,6,0,2,1,2,0.56,0.5303,0.64,0.0896,4,104,108,108,4,Pagi
7529,2011-11-15,0,11,7,0,2,1,2,0.54,0.5152,0.68,0.1642,21,298,319,319,4,Siang
7530,2011-11-15,0,11,8,0,2,1,2,0.54,0.5152,0.68,0.1045,27,453,480,480,4,Siang
7531,2011-11-15,0,11,9,0,2,1,2,0.56,0.5303,0.64,0.0896,26,174,200,200,4,Siang
7532,2011-11-15,0,11,10,0,2,1,2,0.56,0.5303,0.64,0.2836,23,115,138,138,4,Siang
7533,2011-11-15,0,11,11,0,2,1,2,0.56,0.5303,0.64,0.194,18,116,134,134,4,Siang
7534,2011-11-15,0,11,12,0,2,1,2,0.54,0.5152,0.68,0.0,28,148,176,176,4,Siang
7535,2011-11-15,0,11,13,0,2,1,3,0.54,0.5152,0.6,0.2239,21,132,153,153,4,Sore
7536,2011-11-15,0,11,14,0,2,1,2,0.54,0.5152,0.6,0.2836,27,120,147,147,4,Sore
7537,2011-11-15,0,11,15,0,2,1,2,0.54,0.5152,0.6,0.1343,36,155,191,191,4,Sore
7538,2011-11-15,0,11,16,0,2,1,2,0.52,0.5,0.68,0.1343,31,240,271,271,4,Sore
7539,2011-11-15,0,11,17,0,2,1,2,0.5,0.4848,0.72,0.194,29,422,451,451,4,Sore
7540,2011-11-15,0,11,18,0,2,1,2,0.5,0.4848,0.72,0.2836,27,414,441,441,4,Sore
7541,2011-11-15,0,11,19,0,2,1,2,0.5,0.4848,0.72,0.3582,27,259,286,286,4,Malam
7542,2011-11-15,0,11,20,0,2,1,2,0.48,0.4697,0.82,0.1343,26,212,238,238,4,Malam
7543,2011-11-15,0,11,21,0,2,1,2,0.5,0.4848,0.77,0.0896,23,145,168,168,4,Malam
7544,2011-11-15,0,11,22,0,2,1,2,0.46,0.4545,0.88,0.1045,19,109,128,128,4,Malam
7545,2011-11-15,0,11,23,0,2,1,2,0.46,0.4545,0.94,0.1045,14,66,80,80,4,Malam
7546,2011-11-16,0,11,0,0,3,1,2,0.46,0.4545,0.94,0.0,5,26,31,31,4,
7547,2011-11-16,0,11,1,0,3,1,3,0.46,0.4545,0.94,0.0896,0,5,5,5,4,Pagi
7548,2011-11-16,0,11,2,0,3,1,2,0.46,0.4545,0.94,0.1045,4,6,10,10,4,Pagi
7549,2011-11-16,0,11,3,0,3,1,2,0.46,0.4545,0.94,0.1045,2,3,5,5,4,Pagi
7550,2011-11-16,0,11,4,0,3,1,2,0.44,0.4394,1.0,0.2239,1,3,4,4,4,Pagi
7551,2011-11-16,0,11,5,0,3,1,3,0.46,0.4545,0.94,0.1045,0,13,13,13,4,Pagi
7552,2011-11-16,0,11,6,0,3,1,2,0.46,0.4545,0.94,0.0896,4,52,56,56,4,Pagi
7553,2011-11-16,0,11,7,0,3,1,3,0.46,0.4545,0.94,0.0,7,130,137,137,4,Siang
7554,2011-11-16,0,11,8,0,3,1,3,0.46,0.4545,0.94,0.0,9,223,232,232,4,Siang
7555,2011-11-16,0,11,9,0,3,1,3,0.46,0.4545,0.94,0.0,5,77,82,82,4,Siang
7556,2011-11-16,0,11,10,0,3,1,3,0.46,0.4545,0.94,0.0,4,32,36,36,4,Siang
7557,2011-11-16,0,11,11,0,3,1,3,0.46,0.4545,0.94,0.0896,7,53,60,60,4,Siang
7558,2011-11-16,0,11,12,0,3,1,3,0.46,0.4545,1.0,0.0,5,49,54,54,4,Siang
7559,2011-11-16,0,11,13,0,3,1,3,0.46,0.4545,0.94,0.1343,6,52,58,58,4,Sore
7560,2011-11-16,0,11,14,0,3,1,2,0.46,0.4545,1.0,0.1343,12,49,61,61,4,Sore
7561,2011-11-16,0,11,15,0,3,1,3,0.48,0.4697,0.94,0.1045,16,50,66,66,4,Sore
7562,2011-11-16,0,11,16,0,3,1,3,0.48,0.4697,0.94,0.1045,13,110,123,123,4,Sore
7563,2011-11-16,0,11,17,0,3,1,2,0.48,0.4697,0.88,0.194,17,216,233,233,4,Sore
7564,2011-11-16,0,11,18,0,3,1,3,0.46,0.4545,0.88,0.3881,13,176,189,189,4,Sore
7565,2011-11-16,0,11,19,0,3,1,3,0.46,0.4545,0.88,0.3881,3,108,111,111,4,Malam
7566,2011-11-16,0,11,20,0,3,1,3,0.44,0.4394,0.88,0.3881,5,94,99,99,4,Malam
7567,2011-11-16,0,11,21,0,3,1,3,0.44,0.4394,0.88,0.2836,3,72,75,75,4,Malam
7568,2011-11-16,0,11,22,0,3,1,3,0.42,0.4242,0.88,0.2239,1,45,46,46,4,Malam
7569,2011-11-16,0,11,23,0,3,1,3,0.42,0.4242,0.88,0.1343,3,28,31,31,4,Malam
7570,2011-11-17,0,11,0,0,4,1,2,0.42,0.4242,0.88,0.2537,2,22,24,24,4,
7571,2011-11-17,0,11,1,0,4,1,2,0.42,0.4242,0.82,0.1642,0,5,5,5,4,Pagi
7572,2011-11-17,0,11,2,0,4,1,2,0.42,0.4242,0.82,0.2239,0,5,5,5,4,Pagi
7573,2011-11-17,0,11,3,0,4,1,2,0.42,0.4242,0.77,0.3284,0,3,3,3,4,Pagi
7574,2011-11-17,0,11,4,0,4,1,2,0.4,0.4091,0.62,0.4179,1,3,4,4,4,Pagi
7575,2011-11-17,0,11,5,0,4,1,3,0.34,0.303,0.71,0.3284,1,21,22,22,4,Pagi
7576,2011-11-17,0,11,6,0,4,1,3,0.36,0.3485,0.57,0.2239,3,72,75,75,4,Pagi
7577,2011-11-17,0,11,7,0,4,1,3,0.34,0.3182,0.61,0.2836,4,164,168,168,4,Siang
7578,2011-11-17,0,11,8,0,4,1,3,0.34,0.303,0.61,0.2985,12,343,355,355,4,Siang
7579,2011-11-17,0,11,9,0,4,1,2,0.34,0.303,0.61,0.3284,14,184,198,198,4,Siang
7580,2011-11-17,0,11,10,0,4,1,2,0.34,0.303,0.61,0.3284,7,74,81,81,4,Siang
7581,2011-11-17,0,11,11,0,4,1,3,0.32,0.303,0.66,0.3284,4,93,97,97,4,Siang
7582,2011-11-17,0,11,12,0,4,1,2,0.34,0.303,0.53,0.2985,6,115,121,121,4,Siang
7583,2011-11-17,0,11,13,0,4,1,2,0.34,0.303,0.49,0.4478,15,109,124,124,4,Sore
7584,2011-11-17,0,11,14,0,4,1,2,0.34,0.303,0.49,0.3881,5,105,110,110,4,Sore
7585,2011-11-17,0,11,15,0,4,1,2,0.34,0.303,0.49,0.4478,10,106,116,116,4,Sore
7586,2011-11-17,0,11,16,0,4,1,1,0.32,0.2879,0.39,0.4179,8,187,195,195,4,Sore
7587,2011-11-17,0,11,17,0,4,1,1,0.32,0.2879,0.42,0.3881,20,379,399,399,4,Sore
7588,2011-11-17,0,11,18,0,4,1,1,0.32,0.3182,0.39,0.194,9,298,307,307,4,Sore
7589,2011-11-17,0,11,19,0,4,1,1,0.3,0.2879,0.45,0.2239,7,210,217,217,4,Malam
7590,2011-11-17,0,11,20,0,4,1,1,0.3,0.2879,0.42,0.2836,7,162,169,169,4,Malam
7591,2011-11-17,0,11,21,0,4,1,1,0.3,0.2879,0.42,0.2537,3,113,116,116,4,Malam
7592,2011-11-17,0,11,22,0,4,1,1,0.26,0.2424,0.52,0.2537,1,83,84,84,4,Malam
7593,2011-11-17,0,11,23,0,4,1,1,0.26,0.2576,0.52,0.2239,0,58,58,58,4,Malam
7594,2011-11-18,0,11,0,0,5,1,1,0.26,0.2576,0.48,0.1642,2,28,30,30,4,
7595,2011-11-18,0,11,1,0,5,1,1,0.26,0.2273,0.44,0.3284,0,10,10,10,4,Pagi
7596,2011-11-18,0,11,2,0,5,1,1,0.24,0.2273,0.44,0.2239,2,8,10,10,4,Pagi
7597,2011-11-18,0,11,3,0,5,1,1,0.24,0.2121,0.41,0.2836,0,2,2,2,4,Pagi
7598,2011-11-18,0,11,4,0,5,1,1,0.22,0.2273,0.44,0.1642,0,5,5,5,4,Pagi
7599,2011-11-18,0,11,5,0,5,1,1,0.22,0.2273,0.44,0.1343,0,22,22,22,4,Pagi
7600,2011-11-18,0,11,6,0,5,1,1,0.22,0.2576,0.44,0.0896,1,70,71,71,4,Pagi
7601,2011-11-18,0,11,7,0,5,1,1,0.22,0.2273,0.44,0.1642,5,211,216,216,4,Siang
7602,2011-11-18,0,11,8,0,5,1,1,0.22,0.2273,0.44,0.194,6,369,375,375,4,Siang
7603,2011-11-18,0,11,9,0,5,1,1,0.26,0.2576,0.41,0.194,6,207,213,213,4,Siang
7604,2011-11-18,0,11,10,0,5,1,1,0.26,0.2424,0.41,0.2836,10,105,115,115,4,Siang
7605,2011-11-18,0,11,11,0,5,1,1,0.3,0.303,0.36,0.1343,18,122,140,140,4,Siang
7606,2011-11-18,0,11,12,0,5,1,1,0.32,0.3333,0.33,0.0,22,143,165,165,4,Siang
7607,2011-11-18,0,11,13,0,5,1,1,0.34,0.3182,0.31,0.2239,31,146,177,177,4,Sore
7608,2011-11-18,0,11,14,0,5,1,1,0.34,0.3333,0.31,0.1343,31,123,154,154,4,Sore
7609,2011-11-18,0,11,15,0,5,1,1,0.34,0.3333,0.29,0.1343,27,151,178,178,4,Sore
7610,2011-11-18,0,11,16,0,5,1,1,0.34,0.3333,0.29,0.1343,19,190,209,209,4,Sore
7611,2011-11-18,0,11,17,0,5,1,1,0.32,0.3333,0.31,0.1343,17,361,378,378,4,Sore
7612,2011-11-18,0,11,18,0,5,1,1,0.3,0.303,0.36,0.1642,16,312,328,328,4,Sore
7613,2011-11-18,0,11,19,0,5,1,1,0.28,0.2727,0.41,0.1642,7,183,190,190,4,Malam
7614,2011-11-18,0,11,20,0,5,1,1,0.28,0.2727,0.48,0.194,8,129,137,137,4,Malam
7615,2011-11-18,0,11,21,0,5,1,1,0.28,0.2727,0.48,0.1642,3,108,111,111,4,Malam
7616,2011-11-18,0,11,22,0,5,1,1,0.26,0.2727,0.52,0.1045,9,88,97,97,4,Malam
7617,2011-11-18,0,11,23,0,5,1,1,0.26,0.2727,0.6,0.1343,5,54,59,59,4,Malam
7618,2011-11-19,0,11,0,0,6,0,1,0.26,0.2576,0.56,0.194,4,49,53,53,4,
7619,2011-11-19,0,11,1,0,6,0,1,0.26,0.2273,0.52,0.2985,1,34,35,35,4,Pagi
7620,2011-11-19,0,11,2,0,6,0,1,0.24,0.2424,0.56,0.1642,12,34,46,46,4,Pagi
7621,2011-11-19,0,11,3,0,6,0,1,0.26,0.2424,0.48,0.2537,4,11,15,15,4,Pagi
7622,2011-11-19,0,11,4,0,6,0,1,0.26,0.2273,0.48,0.3284,4,4,8,8,4,Pagi
7623,2011-11-19,0,11,5,0,6,0,1,0.24,0.2273,0.56,0.2537,0,2,2,2,4,Pagi
7624,2011-11-19,0,11,6,0,6,0,1,0.24,0.2121,0.6,0.3284,2,10,12,12,4,Pagi
7625,2011-11-19,0,11,7,0,6,0,1,0.24,0.2273,0.6,0.2537,3,38,41,41,4,Siang
7626,2011-11-19,0,11,8,0,6,0,1,0.26,0.2424,0.56,0.2537,12,80,92,92,4,Siang
7627,2011-11-19,0,11,9,0,6,0,1,0.28,0.2576,0.52,0.2985,12,130,142,142,4,Siang
7628,2011-11-19,0,11,10,0,6,0,1,0.32,0.303,0.45,0.2537,35,165,200,200,4,Siang
7629,2011-11-19,0,11,11,0,6,0,1,0.36,0.3788,0.4,0.0,50,183,233,233,4,Siang
7630,2011-11-19,0,11,12,0,6,0,1,0.4,0.4091,0.35,0.2836,93,218,311,311,4,Siang
7631,2011-11-19,0,11,13,0,6,0,1,0.42,0.4242,0.3,0.2836,118,245,363,363,4,Sore
7632,2011-11-19,0,11,14,0,6,0,1,0.42,0.4242,0.32,0.2985,121,228,349,349,4,Sore
7633,2011-11-19,0,11,15,0,6,0,1,0.42,0.4242,0.41,0.194,120,262,382,382,4,Sore
7634,2011-11-19,0,11,16,0,6,0,1,0.42,0.4242,0.38,0.2985,99,188,287,287,4,Sore
7635,2011-11-19,0,11,17,0,6,0,1,0.4,0.4091,0.4,0.194,61,171,232,232,4,Sore
7636,2011-11-19,0,11,18,0,6,0,1,0.38,0.3939,0.46,0.1343,36,172,208,208,4,Sore
7637,2011-11-19,0,11,19,0,6,0,2,0.34,0.3333,0.71,0.1343,33,149,182,182,4,Malam
7638,2011-11-19,0,11,20,0,6,0,2,0.36,0.3636,0.57,0.1045,48,115,163,163,4,Malam
7639,2011-11-19,0,11,21,0,6,0,2,0.36,0.3485,0.62,0.194,29,79,108,108,4,Malam
7640,2011-11-19,0,11,22,0,6,0,2,0.38,0.3939,0.62,0.1642,26,80,106,106,4,Malam
7641,2011-11-19,0,11,23,0,6,0,1,0.38,0.3939,0.62,0.2239,20,73,93,93,4,Malam
7642,2011-11-20,0,11,0,0,0,0,1,0.38,0.3939,0.66,0.1642,14,79,93,93,4,
7643,2011-11-20,0,11,1,0,0,0,1,0.4,0.4091,0.62,0.2537,11,73,84,84,4,Pagi
7644,2011-11-20,0,11,2,0,0,0,1,0.4,0.4091,0.62,0.2836,12,44,56,56,4,Pagi
7645,2011-11-20,0,11,3,0,0,0,2,0.4,0.4091,0.66,0.2836,6,31,37,37,4,Pagi
7646,2011-11-20,0,11,4,0,0,0,2,0.4,0.4091,0.71,0.2836,2,10,12,12,4,Pagi
7647,2011-11-20,0,11,5,0,0,0,2,0.42,0.4242,0.67,0.2836,0,4,4,4,4,Pagi
7648,2011-11-20,0,11,6,0,0,0,2,0.42,0.4242,0.67,0.2537,3,6,9,9,4,Pagi
7649,2011-11-20,0,11,7,0,0,0,1,0.42,0.4242,0.67,0.2239,4,19,23,23,4,Siang
7650,2011-11-20,0,11,8,0,0,0,2,0.42,0.4242,0.71,0.2836,13,52,65,65,4,Siang
7651,2011-11-20,0,11,9,0,0,0,1,0.44,0.4394,0.72,0.1642,29,109,138,138,4,Siang
7652,2011-11-20,0,11,10,0,0,0,2,0.44,0.4394,0.72,0.1045,46,183,229,229,4,Siang
7653,2011-11-20,0,11,11,0,0,0,2,0.5,0.4848,0.63,0.1045,74,212,286,286,4,Siang
7654,2011-11-20,0,11,12,0,0,0,2,0.5,0.4848,0.63,0.1343,70,234,304,304,4,Siang
7655,2011-11-20,0,11,13,0,0,0,2,0.54,0.5152,0.6,0.194,84,285,369,369,4,Sore
7656,2011-11-20,0,11,14,0,0,0,1,0.52,0.5,0.63,0.2537,113,250,363,363,4,Sore
7657,2011-11-20,0,11,15,0,0,0,2,0.52,0.5,0.68,0.194,109,242,351,351,4,Sore
7658,2011-11-20,0,11,16,0,0,0,2,0.52,0.5,0.63,0.1343,81,225,306,306,4,Sore
7659,2011-11-20,0,11,17,0,0,0,2,0.52,0.5,0.63,0.194,35,168,203,203,4,Sore
7660,2011-11-20,0,11,18,0,0,0,2,0.54,0.5152,0.64,0.194,22,123,145,145,4,Sore
7661,2011-11-20,0,11,19,0,0,0,2,0.5,0.4848,0.72,0.1045,17,140,157,157,4,Malam
7662,2011-11-20,0,11,20,0,0,0,2,0.52,0.5,0.68,0.1045,23,90,113,113,4,Malam
7663,2011-11-20,0,11,21,0,0,0,2,0.48,0.4697,0.77,0.0896,11,94,105,105,4,Malam
7664,2011-11-20,0,11,22,0,0,0,3,0.46,0.4545,0.88,0.0896,5,35,40,40,4,Malam
7665,2011-11-20,0,11,23,0,0,0,3,0.46,0.4545,0.88,0.0896,3,25,28,28,4,Malam
7666,2011-11-21,0,11,0,0,1,1,2,0.46,0.4545,0.94,0.0,4,13,17,17,4,
7667,2011-11-21,0,11,1,0,1,1,3,0.46,0.4545,0.94,0.194,4,8,12,12,4,Pagi
7668,2011-11-21,0,11,2,0,1,1,3,0.44,0.4394,1.0,0.194,1,2,3,3,4,Pagi
7669,2011-11-21,0,11,3,0,1,1,3,0.44,0.4394,1.0,0.1343,0,4,4,4,4,Pagi
7670,2011-11-21,0,11,4,0,1,1,3,0.44,0.4394,1.0,0.1343,0,5,5,5,4,Pagi
7671,2011-11-21,0,11,5,0,1,1,2,0.44,0.4394,1.0,0.0,0,20,20,20,4,Pagi
7672,2011-11-21,0,11,6,0,1,1,2,0.42,0.4242,1.0,0.0,0,76,76,76,4,Pagi
7673,2011-11-21,0,11,7,0,1,1,2,0.46,0.4545,0.94,0.1642,17,229,246,246,4,Siang
7674,2011-11-21,0,11,8,0,1,1,2,0.46,0.4545,0.94,0.0,13,378,391,391,4,Siang
7675,2011-11-21,0,11,9,0,1,1,2,0.48,0.4697,0.94,0.1045,15,222,237,237,4,Siang
7676,2011-11-21,0,11,10,0,1,1,2,0.52,0.5,0.83,0.0,25,110,135,135,4,Siang
7677,2011-11-21,0,11,11,0,1,1,2,0.52,0.5,0.83,0.1045,16,112,128,128,4,Siang
7678,2011-11-21,0,11,12,0,1,1,2,0.5,0.4848,0.77,0.1343,24,138,162,162,4,Siang
7679,2011-11-21,0,11,13,0,1,1,2,0.5,0.4848,0.77,0.1343,13,121,134,134,4,Sore
7680,2011-11-21,0,11,14,0,1,1,2,0.48,0.4697,0.82,0.194,14,121,135,135,4,Sore
7681,2011-11-21,0,11,15,0,1,1,3,0.44,0.4394,0.94,0.2239,15,93,108,108,4,Sore
7682,2011-11-21,0,11,16,0,1,1,3,0.44,0.4394,0.94,0.2239,13,95,108,108,4,Sore
7683,2011-11-21,0,11,17,0,1,1,3,0.42,0.4242,0.94,0.2985,10,200,210,210,4,Sore
7684,2011-11-21,0,11,18,0,1,1,3,0.42,0.4242,0.88,0.194,8,184,192,192,4,Sore
7685,2011-11-21,0,11,19,0,1,1,3,0.4,0.4091,0.94,0.194,2,135,137,137,4,Malam
7686,2011-11-21,0,11,20,0,1,1,3,0.4,0.4091,0.87,0.2239,5,75,80,80,4,Malam
7687,2011-11-21,0,11,21,0,1,1,3,0.4,0.4091,0.87,0.1642,11,103,114,114,4,Malam
7688,2011-11-21,0,11,22,0,1,1,3,0.4,0.4091,0.87,0.1343,6,72,78,78,4,Malam
7689,2011-11-21,0,11,23,0,1,1,3,0.4,0.4091,0.87,0.1642,4,29,33,33,4,Malam
7690,2011-11-22,0,11,0,0,2,1,3,0.38,0.3939,0.94,0.1045,0,14,14,14,4,
7691,2011-11-22,0,11,1,0,2,1,3,0.4,0.4091,0.94,0.1343,1,5,6,6,4,Pagi
7692,2011-11-22,0,11,2,0,2,1,3,0.38,0.3939,1.0,0.1045,2,4,6,6,4,Pagi
7693,2011-11-22,0,11,3,0,2,1,3,0.38,0.3939,1.0,0.1045,1,2,3,3,4,Pagi
7694,2011-11-22,0,11,4,0,2,1,3,0.38,0.3939,0.94,0.1642,0,7,7,7,4,Pagi
7695,2011-11-22,0,11,5,0,2,1,3,0.38,0.3939,0.94,0.1642,1,17,18,18,4,Pagi
7696,2011-11-22,0,11,6,0,2,1,2,0.38,0.3939,0.94,0.1045,1,63,64,64,4,Pagi
7697,2011-11-22,0,11,7,0,2,1,3,0.38,0.3939,0.94,0.2239,2,119,121,121,4,Siang
7698,2011-11-22,0,11,8,0,2,1,3,0.38,0.3939,0.94,0.2239,5,185,190,190,4,Siang
7699,2011-11-22,0,11,9,0,2,1,3,0.4,0.4091,0.94,0.0,2,147,149,149,4,Siang
7700,2011-11-22,0,11,10,0,2,1,3,0.4,0.4091,0.94,0.0,6,46,52,52,4,Siang
7701,2011-11-22,0,11,11,0,2,1,3,0.4,0.4091,0.94,0.1343,4,28,32,32,4,Siang
7702,2011-11-22,0,11,12,0,2,1,3,0.4,0.4091,1.0,0.0896,3,18,21,21,4,Siang
7703,2011-11-22,0,11,13,0,2,1,3,0.42,0.4242,1.0,0.0896,4,22,26,26,4,Sore
7704,2011-11-22,0,11,14,0,2,1,3,0.42,0.4242,1.0,0.0896,4,31,35,35,4,Sore
7705,2011-11-22,0,11,15,0,2,1,3,0.44,0.4394,0.94,0.0,2,32,34,34,4,Sore
7706,2011-11-22,0,11,16,0,2,1,3,0.44,0.4394,0.94,0.0,3,59,62,62,4,Sore
7707,2011-11-22,0,11,17,0,2,1,3,0.44,0.4394,1.0,0.0896,4,161,165,165,4,Sore
7708,2011-11-22,0,11,18,0,2,1,3,0.44,0.4394,1.0,0.0,0,148,148,148,4,Sore
7709,2011-11-22,0,11,19,0,2,1,3,0.46,0.4545,0.94,0.1045,5,106,111,111,4,Malam
7710,2011-11-22,0,11,20,0,2,1,2,0.46,0.4545,1.0,0.2239,6,121,127,127,4,Malam
7711,2011-11-22,0,11,21,0,2,1,2,0.46,0.4545,1.0,0.2537,4,86,90,90,4,Malam
7712,2011-11-22,0,11,22,0,2,1,2,0.5,0.4848,0.94,0.194,6,81,87,87,4,Malam
7713,2011-11-22,0,11,23,0,2,1,2,0.48,0.4697,0.94,0.2537,3,36,39,39,4,Malam
7714,2011-11-23,0,11,0,0,3,1,2,0.48,0.4697,0.94,0.2537,2,14,16,16,4,
7715,2011-11-23,0,11,1,0,3,1,2,0.48,0.4697,0.94,0.2985,0,8,8,8,4,Pagi
7716,2011-11-23,0,11,2,0,3,1,3,0.5,0.4848,0.94,0.3582,1,5,6,6,4,Pagi
7717,2011-11-23,0,11,3,0,3,1,3,0.5,0.4848,0.94,0.3582,1,2,3,3,4,Pagi
7718,2011-11-23,0,11,4,0,3,1,3,0.52,0.5,0.88,0.3582,0,5,5,5,4,Pagi
7719,2011-11-23,0,11,5,0,3,1,2,0.46,0.4545,0.94,0.194,1,16,17,17,4,Pagi
7720,2011-11-23,0,11,6,0,3,1,2,0.44,0.4394,1.0,0.0,1,68,69,69,4,Pagi
7721,2011-11-23,0,11,7,0,3,1,2,0.46,0.4545,1.0,0.0896,2,154,156,156,4,Siang
7722,2011-11-23,0,11,8,0,3,1,2,0.48,0.4697,0.94,0.1045,7,316,323,323,4,Siang
7723,2011-11-23,0,11,9,0,3,1,2,0.52,0.5,0.94,0.194,3,164,167,167,4,Siang
7724,2011-11-23,0,11,10,0,3,1,2,0.52,0.5,0.94,0.194,6,70,76,76,4,Siang
7725,2011-11-23,0,11,11,0,3,1,2,0.5,0.4848,0.72,0.4179,9,107,116,116,4,Siang
7726,2011-11-23,0,11,12,0,3,1,1,0.48,0.4697,0.55,0.4179,9,151,160,160,4,Siang
7727,2011-11-23,0,11,13,0,3,1,2,0.44,0.4394,0.54,0.4925,12,162,174,174,4,Sore
7728,2011-11-23,0,11,14,0,3,1,1,0.42,0.4242,0.54,0.4627,13,200,213,213,4,Sore
7729,2011-11-23,0,11,15,0,3,1,2,0.42,0.4242,0.54,0.4478,13,194,207,207,4,Sore
7730,2011-11-23,0,11,16,0,3,1,2,0.4,0.4091,0.62,0.4627,4,169,173,173,4,Sore
7731,2011-11-23,0,11,17,0,3,1,3,0.38,0.3939,0.71,0.3881,7,156,163,163,4,Sore
7732,2011-11-23,0,11,18,0,3,1,2,0.4,0.4091,0.58,0.5224,7,138,145,145,4,Sore
7733,2011-11-23,0,11,19,0,3,1,1,0.38,0.3939,0.58,0.3881,6,116,122,122,4,Malam
7734,2011-11-23,0,11,20,0,3,1,1,0.36,0.3333,0.62,0.3881,1,67,68,68,4,Malam
7735,2011-11-23,0,11,21,0,3,1,1,0.36,0.3182,0.57,0.4627,0,66,66,66,4,Malam
7736,2011-11-23,0,11,22,0,3,1,1,0.34,0.303,0.61,0.4478,3,59,62,62,4,Malam
7737,2011-11-23,0,11,23,0,3,1,1,0.34,0.303,0.61,0.3582,4,47,51,51,4,Malam
7738,2011-11-24,0,11,0,1,4,0,1,0.32,0.303,0.57,0.2239,1,22,23,23,4,
7739,2011-11-24,0,11,1,1,4,0,1,0.32,0.2879,0.57,0.4179,1,23,24,24,4,Pagi
7740,2011-11-24,0,11,2,1,4,0,1,0.3,0.2879,0.61,0.2836,3,19,22,22,4,Pagi
7741,2011-11-24,0,11,3,1,4,0,1,0.28,0.2879,0.65,0.1343,1,4,5,5,4,Pagi
7742,2011-11-24,0,11,4,1,4,0,1,0.3,0.3182,0.61,0.0896,1,1,2,2,4,Pagi
7743,2011-11-24,0,11,5,1,4,0,1,0.3,0.3182,0.61,0.1045,1,10,11,11,4,Pagi
7744,2011-11-24,0,11,6,1,4,0,1,0.3,0.3182,0.61,0.0896,1,5,6,6,4,Pagi
7745,2011-11-24,0,11,7,1,4,0,1,0.26,0.2727,0.75,0.1045,9,31,40,40,4,Siang
7746,2011-11-24,0,11,8,1,4,0,1,0.3,0.3182,0.65,0.0896,4,42,46,46,4,Siang
7747,2011-11-24,0,11,9,1,4,0,1,0.34,0.3485,0.61,0.0,13,68,81,81,4,Siang
7748,2011-11-24,0,11,10,1,4,0,1,0.36,0.3788,0.57,0.0,34,64,98,98,4,Siang
7749,2011-11-24,0,11,11,1,4,0,1,0.42,0.4242,0.41,0.2985,52,90,142,142,4,Siang
7750,2011-11-24,0,11,12,1,4,0,1,0.46,0.4545,0.36,0.2239,62,88,150,150,4,Siang
7751,2011-11-24,0,11,13,1,4,0,1,0.48,0.4697,0.33,0.2239,84,91,175,175,4,Sore
7752,2011-11-24,0,11,14,1,4,0,1,0.5,0.4848,0.31,0.2985,74,94,168,168,4,Sore
7753,2011-11-24,0,11,15,1,4,0,1,0.5,0.4848,0.31,0.2537,78,71,149,149,4,Sore
7754,2011-11-24,0,11,16,1,4,0,1,0.5,0.4848,0.34,0.2836,48,66,114,114,4,Sore
7755,2011-11-24,0,11,17,1,4,0,1,0.48,0.4697,0.33,0.1045,34,40,74,74,4,Sore
7756,2011-11-24,0,11,18,1,4,0,1,0.42,0.4242,0.5,0.0896,13,24,37,37,4,Sore
7757,2011-11-24,0,11,19,1,4,0,1,0.4,0.4091,0.54,0.1045,15,13,28,28,4,Malam
7758,2011-11-24,0,11,20,1,4,0,1,0.36,0.3485,0.76,0.1642,14,17,31,31,4,Malam
7759,2011-11-24,0,11,21,1,4,0,1,0.36,0.3485,0.71,0.1642,7,19,26,26,4,Malam
7760,2011-11-24,0,11,22,1,4,0,1,0.36,0.3485,0.71,0.1642,8,14,22,22,4,Malam
7761,2011-11-24,0,11,23,1,4,0,1,0.34,0.3485,0.76,0.1045,2,19,21,21,4,Malam
7762,2011-11-25,0,11,0,0,5,1,1,0.34,0.3333,0.76,0.1642,7,22,29,29,4,
7763,2011-11-25,0,11,1,0,5,1,1,0.34,0.3636,0.76,0.0,2,12,14,14,4,Pagi
7764,2011-11-25,0,11,2,0,5,1,1,0.28,0.2879,0.81,0.1045,4,6,10,10,4,Pagi
7765,2011-11-25,0,11,3,0,5,1,1,0.28,0.2879,0.75,0.1045,0,2,2,2,4,Pagi
7766,2011-11-25,0,11,4,0,5,1,1,0.3,0.3182,0.75,0.1045,4,3,7,7,4,Pagi
7767,2011-11-25,0,11,5,0,5,1,1,0.28,0.3182,0.75,0.0,2,3,5,5,4,Pagi
7768,2011-11-25,0,11,6,0,5,1,1,0.26,0.2727,0.81,0.1045,4,9,13,13,4,Pagi
7769,2011-11-25,0,11,7,0,5,1,1,0.26,0.303,0.81,0.0,4,31,35,35,4,Siang
7770,2011-11-25,0,11,8,0,5,1,1,0.26,0.2727,0.81,0.1343,6,68,74,74,4,Siang
7771,2011-11-25,0,11,9,0,5,1,1,0.32,0.3485,0.76,0.0,25,70,95,95,4,Siang
7772,2011-11-25,0,11,10,0,5,1,1,0.36,0.3485,0.71,0.1642,60,82,142,142,4,Siang
7773,2011-11-25,0,11,11,0,5,1,1,0.4,0.4091,0.66,0.1045,99,127,226,226,4,Siang
7774,2011-11-25,0,11,12,0,5,1,1,0.46,0.4545,0.51,0.1045,126,146,272,272,4,Siang
7775,2011-11-25,0,11,13,0,5,1,1,0.5,0.4848,0.45,0.2239,143,140,283,283,4,Sore
7776,2011-11-25,0,11,14,0,5,1,1,0.52,0.5,0.39,0.2239,122,150,272,272,4,Sore
7777,2011-11-25,0,11,15,0,5,1,1,0.52,0.5,0.36,0.194,165,145,310,310,4,Sore
7778,2011-11-25,0,11,16,0,5,1,1,0.5,0.4848,0.39,0.1642,122,139,261,261,4,Sore
7779,2011-11-25,0,11,17,0,5,1,1,0.5,0.4848,0.34,0.1045,57,127,184,184,4,Sore
7780,2011-11-25,0,11,18,0,5,1,1,0.46,0.4545,0.44,0.0896,45,108,153,153,4,Sore
7781,2011-11-25,0,11,19,0,5,1,1,0.42,0.4242,0.67,0.0,38,96,134,134,4,Malam
7782,2011-11-25,0,11,20,0,5,1,1,0.4,0.4091,0.58,0.0896,19,76,95,95,4,Malam
7783,2011-11-25,0,11,21,0,5,1,1,0.36,0.3788,0.71,0.0,24,61,85,85,4,Malam
7784,2011-11-25,0,11,22,0,5,1,1,0.34,0.3485,0.71,0.0896,12,46,58,58,4,Malam
7785,2011-11-25,0,11,23,0,5,1,1,0.34,0.3485,0.76,0.1045,5,28,33,33,4,Malam
7786,2011-11-26,0,11,0,0,6,0,1,0.34,0.3485,0.76,0.1045,9,38,47,47,4,
7787,2011-11-26,0,11,1,0,6,0,1,0.32,0.3333,0.76,0.0896,5,24,29,29,4,Pagi
7788,2011-11-26,0,11,2,0,6,0,1,0.3,0.3182,0.81,0.1045,3,20,23,23,4,Pagi
7789,2011-11-26,0,11,3,0,6,0,1,0.3,0.3333,0.81,0.0,8,9,17,17,4,Pagi
7790,2011-11-26,0,11,4,0,6,0,1,0.3,0.3333,0.81,0.0,0,4,4,4,4,Pagi
7791,2011-11-26,0,11,5,0,6,0,1,0.3,0.3182,0.75,0.1045,0,3,3,3,4,Pagi
7792,2011-11-26,0,11,6,0,6,0,2,0.3,0.3182,0.75,0.0896,2,8,10,10,4,Pagi
7793,2011-11-26,0,11,7,0,6,0,1,0.26,0.2727,0.87,0.1045,4,13,17,17,4,Siang
7794,2011-11-26,0,11,8,0,6,0,1,0.32,0.3333,0.76,0.0896,10,50,60,60,4,Siang
7795,2011-11-26,0,11,9,0,6,0,1,0.34,0.3485,0.76,0.0896,16,67,83,83,4,Siang
7796,2011-11-26,0,11,10,0,6,0,1,0.36,0.3788,0.81,0.0,57,84,141,141,4,Siang
7797,2011-11-26,0,11,11,0,6,0,1,0.4,0.4091,0.62,0.1045,107,123,230,230,4,Siang
7798,2011-11-26,0,11,12,0,6,0,1,0.44,0.4394,0.51,0.0,137,172,309,309,4,Siang
7799,2011-11-26,0,11,13,0,6,0,1,0.48,0.4697,0.44,0.0,177,148,325,325,4,Sore
7800,2011-11-26,0,11,14,0,6,0,2,0.48,0.4697,0.48,0.1343,141,158,299,299,4,Sore
7801,2011-11-26,0,11,15,0,6,0,2,0.5,0.4848,0.42,0.1045,154,160,314,314,4,Sore
7802,2011-11-26,0,11,16,0,6,0,2,0.46,0.4545,0.47,0.1343,137,138,275,275,4,Sore
7803,2011-11-26,0,11,17,0,6,0,2,0.46,0.4545,0.47,0.1343,62,122,184,184,4,Sore
7804,2011-11-26,0,11,18,0,6,0,2,0.42,0.4242,0.62,0.1642,67,118,185,185,4,Sore
7805,2011-11-26,0,11,19,0,6,0,2,0.4,0.4091,0.71,0.0896,46,100,146,146,4,Malam
7806,2011-11-26,0,11,20,0,6,0,2,0.42,0.4242,0.58,0.0,55,86,141,141,4,Malam
7807,2011-11-26,0,11,21,0,6,0,2,0.38,0.3939,0.82,0.0,20,72,92,92,4,Malam
7808,2011-11-26,0,11,22,0,6,0,2,0.38,0.3939,0.76,0.0,14,51,65,65,4,Malam
7809,2011-11-26,0,11,23,0,6,0,1,0.36,0.3788,0.81,0.0,18,51,69,69,4,Malam
7810,2011-11-27,0,11,0,0,0,0,1,0.36,0.3788,0.81,0.0,7,39,46,46,4,
7811,2011-11-27,0,11,1,0,0,0,1,0.36,0.3788,0.81,0.0,9,35,44,44,4,Pagi
7812,2011-11-27,0,11,2,0,0,0,1,0.34,0.3636,0.81,0.0,9,22,31,31,4,Pagi
7813,2011-11-27,0,11,3,0,0,0,1,0.34,0.3636,0.87,0.0,9,8,17,17,4,Pagi
7814,2011-11-27,0,11,4,0,0,0,1,0.34,0.3485,0.87,0.1045,0,4,4,4,4,Pagi
7815,2011-11-27,0,11,5,0,0,0,1,0.36,0.3485,0.87,0.194,0,5,5,5,4,Pagi
7816,2011-11-27,0,11,6,0,0,0,1,0.38,0.3939,0.82,0.1642,0,9,9,9,4,Pagi
7817,2011-11-27,0,11,7,0,0,0,1,0.38,0.3939,0.87,0.2239,12,11,23,23,4,Siang
7818,2011-11-27,0,11,8,0,0,0,1,0.4,0.4091,0.82,0.2985,6,36,42,42,4,Siang
7819,2011-11-27,0,11,9,0,0,0,1,0.46,0.4545,0.72,0.2836,21,90,111,111,4,Siang
7820,2011-11-27,0,11,10,0,0,0,1,0.46,0.4545,0.72,0.2836,58,131,189,189,4,Siang
7821,2011-11-27,0,11,11,0,0,0,1,0.5,0.4848,0.63,0.3582,83,157,240,240,4,Siang
7822,2011-11-27,0,11,12,0,0,0,1,0.54,0.5152,0.56,0.2836,63,193,256,256,4,Siang
7823,2011-11-27,0,11,13,0,0,0,1,0.54,0.5152,0.6,0.194,97,216,313,313,4,Sore
7824,2011-11-27,0,11,14,0,0,0,1,0.62,0.6212,0.43,0.4627,113,200,313,313,4,Sore
7825,2011-11-27,0,11,15,0,0,0,1,0.62,0.6212,0.43,0.2836,96,221,317,317,4,Sore
7826,2011-11-27,0,11,16,0,0,0,1,0.56,0.5303,0.52,0.2537,94,229,323,323,4,Sore
7827,2011-11-27,0,11,17,0,0,0,1,0.54,0.5152,0.56,0.194,37,167,204,204,4,Sore
7828,2011-11-27,0,11,18,0,0,0,1,0.5,0.4848,0.63,0.1642,25,130,155,155,4,Sore
7829,2011-11-27,0,11,19,0,0,0,1,0.48,0.4697,0.67,0.2239,30,109,139,139,4,Malam
7830,2011-11-27,0,11,20,0,0,0,1,0.5,0.4848,0.63,0.2537,10,94,104,104,4,Malam
7831,2011-11-27,0,11,21,0,0,0,1,0.48,0.4697,0.67,0.2836,13,75,88,88,4,Malam
7832,2011-11-27,0,11,22,0,0,0,1,0.48,0.4697,0.72,0.2537,13,53,66,66,4,Malam
7833,2011-11-27,0,11,23,0,0,0,1,0.48,0.4697,0.72,0.2537,5,27,32,32,4,Malam
7834,2011-11-28,0,11,0,0,1,1,1,0.46,0.4545,0.77,0.2836,6,10,16,16,4,
7835,2011-11-28,0,11,1,0,1,1,1,0.46,0.4545,0.77,0.2985,1,12,13,13,4,Pagi
7836,2011-11-28,0,11,3,0,1,1,1,0.44,0.4394,0.88,0.2239,1,4,5,5,4,Pagi
7837,2011-11-28,0,11,4,0,1,1,1,0.44,0.4394,0.82,0.0896,0,4,4,4,4,Pagi
7838,2011-11-28,0,11,5,0,1,1,1,0.4,0.4091,0.87,0.0,0,34,34,34,4,Pagi
7839,2011-11-28,0,11,6,0,1,1,1,0.42,0.4242,0.82,0.0896,6,98,104,104,4,Pagi
7840,2011-11-28,0,11,7,0,1,1,1,0.42,0.4242,0.88,0.0,7,270,277,277,4,Siang
7841,2011-11-28,0,11,8,0,1,1,2,0.42,0.4242,0.94,0.0,13,394,407,407,4,Siang
7842,2011-11-28,0,11,9,0,1,1,2,0.44,0.4394,0.88,0.2239,17,191,208,208,4,Siang
7843,2011-11-28,0,11,10,0,1,1,2,0.48,0.4697,0.77,0.1343,21,86,107,107,4,Siang
7844,2011-11-28,0,11,11,0,1,1,2,0.52,0.5,0.68,0.1045,11,107,118,118,4,Siang
7845,2011-11-28,0,11,12,0,1,1,1,0.56,0.5303,0.6,0.1045,13,165,178,178,4,Siang
7846,2011-11-28,0,11,13,0,1,1,2,0.58,0.5455,0.56,0.0,25,137,162,162,4,Sore
7847,2011-11-28,0,11,14,0,1,1,1,0.6,0.6212,0.56,0.0,14,129,143,143,4,Sore
7848,2011-11-28,0,11,15,0,1,1,1,0.58,0.5455,0.6,0.1642,18,132,150,150,4,Sore
7849,2011-11-28,0,11,16,0,1,1,1,0.56,0.5303,0.6,0.194,24,240,264,264,4,Sore
7850,2011-11-28,0,11,17,0,1,1,1,0.58,0.5455,0.56,0.194,24,444,468,468,4,Sore
7851,2011-11-28,0,11,18,0,1,1,1,0.56,0.5303,0.64,0.2239,20,396,416,416,4,Sore
7852,2011-11-28,0,11,19,0,1,1,1,0.54,0.5152,0.73,0.2239,4,260,264,264,4,Malam
7853,2011-11-28,0,11,20,0,1,1,2,0.54,0.5152,0.73,0.2537,12,206,218,218,4,Malam
7854,2011-11-28,0,11,21,0,1,1,2,0.54,0.5152,0.77,0.2239,4,152,156,156,4,Malam
7855,2011-11-28,0,11,22,0,1,1,2,0.52,0.5,0.83,0.1045,7,102,109,109,4,Malam
7856,2011-11-28,0,11,23,0,1,1,2,0.52,0.5,0.83,0.1343,5,41,46,46,4,Malam
7857,2011-11-29,0,11,0,0,2,1,1,0.52,0.5,0.83,0.0,4,18,22,22,4,
7858,2011-11-29,0,11,1,0,2,1,1,0.52,0.5,0.83,0.0896,1,16,17,17,4,Pagi
7859,2011-11-29,0,11,2,0,2,1,2,0.5,0.4848,0.88,0.0,0,5,5,5,4,Pagi
7860,2011-11-29,0,11,3,0,2,1,2,0.5,0.4848,0.88,0.0,0,2,2,2,4,Pagi
7861,2011-11-29,0,11,4,0,2,1,2,0.52,0.5,0.83,0.3284,1,5,6,6,4,Pagi
7862,2011-11-29,0,11,5,0,2,1,1,0.5,0.4848,0.88,0.2836,1,21,22,22,4,Pagi
7863,2011-11-29,0,11,6,0,2,1,1,0.52,0.5,0.83,0.2836,1,88,89,89,4,Pagi
7864,2011-11-29,0,11,7,0,2,1,1,0.52,0.5,0.77,0.2239,12,330,342,342,4,Siang
7865,2011-11-29,0,11,8,0,2,1,1,0.54,0.5152,0.77,0.2836,9,440,449,449,4,Siang
7866,2011-11-29,0,11,9,0,2,1,3,0.56,0.5303,0.73,0.4179,5,197,202,202,4,Siang
7867,2011-11-29,0,11,10,0,2,1,3,0.56,0.5303,0.73,0.4179,2,34,36,36,4,Siang
7868,2011-11-29,0,11,11,0,2,1,3,0.5,0.4848,0.88,0.2985,1,10,11,11,4,Siang
7869,2011-11-29,0,11,12,0,2,1,3,0.42,0.4242,0.82,0.4179,1,17,18,18,4,Siang
7870,2011-11-29,0,11,13,0,2,1,3,0.42,0.4242,0.77,0.2836,0,22,22,22,4,Sore
7871,2011-11-29,0,11,14,0,2,1,3,0.4,0.4091,0.94,0.194,1,35,36,36,4,Sore
7872,2011-11-29,0,11,15,0,2,1,3,0.4,0.4091,0.87,0.3284,5,60,65,65,4,Sore
7873,2011-11-29,0,11,16,0,2,1,3,0.4,0.4091,0.87,0.2239,5,146,151,151,4,Sore
7874,2011-11-29,0,11,17,0,2,1,2,0.4,0.4091,0.87,0.2985,8,346,354,354,4,Sore
7875,2011-11-29,0,11,18,0,2,1,2,0.4,0.4091,0.82,0.2985,11,347,358,358,4,Sore
7876,2011-11-29,0,11,19,0,2,1,2,0.4,0.4091,0.82,0.3284,6,244,250,250,4,Malam
7877,2011-11-29,0,11,20,0,2,1,2,0.38,0.3939,0.87,0.2537,8,176,184,184,4,Malam
7878,2011-11-29,0,11,21,0,2,1,2,0.38,0.3939,0.87,0.2537,9,116,125,125,4,Malam
7879,2011-11-29,0,11,22,0,2,1,1,0.38,0.3939,0.82,0.2985,5,90,95,95,4,Malam
7880,2011-11-29,0,11,23,0,2,1,1,0.36,0.3333,0.76,0.3881,0,53,53,53,4,Malam
7881,2011-11-30,0,11,0,0,3,1,1,0.36,0.3333,0.62,0.4179,1,23,24,24,4,
7882,2011-11-30,0,11,1,0,3,1,1,0.34,0.303,0.66,0.3284,0,8,8,8,4,Pagi
7883,2011-11-30,0,11,2,0,3,1,1,0.32,0.3182,0.7,0.1642,0,5,5,5,4,Pagi
7884,2011-11-30,0,11,3,0,3,1,1,0.32,0.3182,0.7,0.1642,0,1,1,1,4,Pagi
7885,2011-11-30,0,11,4,0,3,1,1,0.3,0.2879,0.75,0.2239,0,5,5,5,4,Pagi
7886,2011-11-30,0,11,5,0,3,1,1,0.28,0.2727,0.81,0.194,1,21,22,22,4,Pagi
7887,2011-11-30,0,11,6,0,3,1,1,0.26,0.2727,0.87,0.1045,3,100,103,103,4,Pagi
7888,2011-11-30,0,11,7,0,3,1,1,0.26,0.2727,0.81,0.1045,9,276,285,285,4,Siang
7889,2011-11-30,0,11,8,0,3,1,1,0.28,0.2727,0.81,0.194,13,465,478,478,4,Siang
7890,2011-11-30,0,11,9,0,3,1,1,0.3,0.2879,0.75,0.2836,7,186,193,193,4,Siang
7891,2011-11-30,0,11,10,0,3,1,1,0.34,0.3182,0.66,0.2239,15,95,110,110,4,Siang
7892,2011-11-30,0,11,11,0,3,1,1,0.38,0.3939,0.54,0.2985,10,112,122,122,4,Siang
7893,2011-11-30,0,11,12,0,3,1,2,0.36,0.3333,0.53,0.2836,12,148,160,160,4,Siang
7894,2011-11-30,0,11,13,0,3,1,2,0.38,0.3939,0.43,0.3582,16,131,147,147,4,Sore
7895,2011-11-30,0,11,14,0,3,1,2,0.38,0.3939,0.43,0.3582,13,99,112,112,4,Sore
7896,2011-11-30,0,11,15,0,3,1,1,0.36,0.3333,0.46,0.3284,11,104,115,115,4,Sore
7897,2011-11-30,0,11,16,0,3,1,1,0.36,0.3333,0.46,0.2836,27,199,226,226,4,Sore
7898,2011-11-30,0,11,17,0,3,1,2,0.34,0.303,0.49,0.3284,15,365,380,380,4,Sore
7899,2011-11-30,0,11,18,0,3,1,1,0.34,0.303,0.49,0.3284,7,369,376,376,4,Sore
7900,2011-11-30,0,11,19,0,3,1,2,0.32,0.303,0.57,0.2836,6,273,279,279,4,Malam
7901,2011-11-30,0,11,20,0,3,1,2,0.32,0.303,0.57,0.2836,6,184,190,190,4,Malam
7902,2011-11-30,0,11,21,0,3,1,1,0.32,0.2879,0.53,0.3881,7,128,135,135,4,Malam
7903,2011-11-30,0,11,22,0,3,1,1,0.3,0.2727,0.56,0.2985,5,82,87,87,4,Malam
7904,2011-11-30,0,11,23,0,3,1,1,0.28,0.2576,0.52,0.2836,4,46,50,50,4,Malam
7905,2011-12-01,0,12,0,0,4,1,1,0.28,0.2576,0.52,0.3284,1,19,20,20,4,
7906,2011-12-01,0,12,1,0,4,1,1,0.26,0.2424,0.6,0.2836,1,9,10,10,4,Pagi
7907,2011-12-01,0,12,2,0,4,1,1,0.26,0.2273,0.56,0.2985,1,8,9,9,4,Pagi
7908,2011-12-01,0,12,3,0,4,1,1,0.26,0.2424,0.56,0.2537,1,6,7,7,4,Pagi
7909,2011-12-01,0,12,4,0,4,1,1,0.26,0.2424,0.56,0.2836,0,1,1,1,4,Pagi
7910,2011-12-01,0,12,5,0,4,1,1,0.26,0.2424,0.56,0.2537,1,23,24,24,4,Pagi
7911,2011-12-01,0,12,6,0,4,1,1,0.24,0.2121,0.65,0.2836,5,92,97,97,4,Pagi
7912,2011-12-01,0,12,7,0,4,1,1,0.24,0.2121,0.65,0.3582,11,265,276,276,4,Siang
7913,2011-12-01,0,12,8,0,4,1,1,0.26,0.2273,0.6,0.3284,15,462,477,477,4,Siang
7914,2011-12-01,0,12,9,0,4,1,1,0.3,0.2727,0.52,0.3284,9,215,224,224,4,Siang
7915,2011-12-01,0,12,10,0,4,1,1,0.32,0.303,0.53,0.2985,7,86,93,93,4,Siang
7916,2011-12-01,0,12,11,0,4,1,1,0.34,0.3182,0.49,0.2537,7,95,102,102,4,Siang
7917,2011-12-01,0,12,12,0,4,1,1,0.36,0.3485,0.46,0.2239,9,139,148,148,4,Siang
7918,2011-12-01,0,12,13,0,4,1,1,0.4,0.4091,0.4,0.2239,17,137,154,154,4,Sore
7919,2011-12-01,0,12,14,0,4,1,1,0.4,0.4091,0.4,0.2239,20,130,150,150,4,Sore
7920,2011-12-01,0,12,15,0,4,1,1,0.4,0.4091,0.4,0.2239,10,144,154,154,4,Sore
7921,2011-12-01,0,12,16,0,4,1,1,0.4,0.4091,0.4,0.194,9,192,201,201,4,Sore
7922,2011-12-01,0,12,17,0,4,1,1,0.36,0.3485,0.46,0.1343,9,409,418,418,4,Sore
7923,2011-12-01,0,12,18,0,4,1,1,0.36,0.3636,0.43,0.1045,12,393,405,405,4,Sore
7924,2011-12-01,0,12,19,0,4,1,1,0.34,0.3485,0.46,0.1045,9,219,228,228,4,Malam
7925,2011-12-01,0,12,20,0,4,1,1,0.34,0.3485,0.46,0.1045,12,178,190,190,4,Malam
7926,2011-12-01,0,12,21,0,4,1,1,0.3,0.3182,0.61,0.1045,8,154,162,162,4,Malam
7927,2011-12-01,0,12,22,0,4,1,1,0.3,0.3333,0.61,0.0,5,99,104,104,4,Malam
7928,2011-12-01,0,12,23,0,4,1,1,0.26,0.2879,0.7,0.0896,3,70,73,73,4,Malam
7929,2011-12-02,0,12,0,0,5,1,1,0.26,0.2879,0.7,0.0896,6,32,38,38,4,
7930,2011-12-02,0,12,1,0,5,1,1,0.24,0.2879,0.75,0.0,1,14,15,15,4,Pagi
7931,2011-12-02,0,12,2,0,5,1,1,0.24,0.2879,0.75,0.0,0,10,10,10,4,Pagi
7932,2011-12-02,0,12,3,0,5,1,1,0.22,0.2727,0.8,0.0,0,1,1,1,4,Pagi
7933,2011-12-02,0,12,4,0,5,1,1,0.22,0.2727,0.8,0.0,0,3,3,3,4,Pagi
7934,2011-12-02,0,12,5,0,5,1,1,0.22,0.2576,0.8,0.0896,0,23,23,23,4,Pagi
7935,2011-12-02,0,12,6,0,5,1,1,0.22,0.2727,0.8,0.0,3,84,87,87,4,Pagi
7936,2011-12-02,0,12,7,0,5,1,1,0.22,0.2576,0.87,0.0896,6,199,205,205,4,Siang
7937,2011-12-02,0,12,8,0,5,1,1,0.24,0.2879,0.87,0.0,13,432,445,445,4,Siang
7938,2011-12-02,0,12,9,0,5,1,1,0.28,0.3182,0.81,0.0,12,234,246,246,4,Siang
7939,2011-12-02,0,12,10,0,5,1,1,0.3,0.2879,0.75,0.2239,16,89,105,105,4,Siang
7940,2011-12-02,0,12,11,0,5,1,1,0.34,0.3333,0.66,0.1642,18,142,160,160,4,Siang
7941,2011-12-02,0,12,12,0,5,1,1,0.36,0.3485,0.57,0.1343,18,186,204,204,4,Siang
7942,2011-12-02,0,12,13,0,5,1,1,0.4,0.4091,0.47,0.1343,19,188,207,207,4,Sore
7943,2011-12-02,0,12,14,0,5,1,1,0.42,0.4242,0.44,0.1045,25,145,170,170,4,Sore
7944,2011-12-02,0,12,15,0,5,1,1,0.42,0.4242,0.41,0.0896,24,175,199,199,4,Sore
7945,2011-12-02,0,12,16,0,5,1,1,0.42,0.4242,0.41,0.0896,22,254,276,276,4,Sore
7946,2011-12-02,0,12,17,0,5,1,1,0.42,0.4242,0.38,0.0,20,391,411,411,4,Sore
7947,2011-12-02,0,12,18,0,5,1,1,0.4,0.4091,0.5,0.0,10,362,372,372,4,Sore
7948,2011-12-02,0,12,19,0,5,1,1,0.34,0.3182,0.53,0.2537,13,252,265,265,4,Malam
7949,2011-12-02,0,12,20,0,5,1,1,0.38,0.3939,0.4,0.2836,12,178,190,190,4,Malam
7950,2011-12-02,0,12,21,0,5,1,1,0.34,0.3333,0.49,0.194,9,102,111,111,4,Malam
7951,2011-12-02,0,12,22,0,5,1,1,0.32,0.3182,0.53,0.194,7,95,102,102,4,Malam
7952,2011-12-02,0,12,23,0,5,1,1,0.32,0.303,0.53,0.2836,14,81,95,95,4,Malam
7953,2011-12-03,0,12,0,0,6,0,1,0.3,0.2879,0.56,0.2537,10,65,75,75,4,
7954,2011-12-03,0,12,1,0,6,0,1,0.26,0.2576,0.65,0.194,9,62,71,71,4,Pagi
7955,2011-12-03,0,12,2,0,6,0,1,0.26,0.2576,0.65,0.1642,9,41,50,50,4,Pagi
7956,2011-12-03,0,12,3,0,6,0,1,0.24,0.2424,0.7,0.1343,4,5,9,9,4,Pagi
7957,2011-12-03,0,12,4,0,6,0,1,0.22,0.2273,0.75,0.1343,1,7,8,8,4,Pagi
7958,2011-12-03,0,12,5,0,6,0,1,0.24,0.2576,0.7,0.0896,0,6,6,6,4,Pagi
7959,2011-12-03,0,12,6,0,6,0,1,0.24,0.2576,0.65,0.1045,1,10,11,11,4,Pagi
7960,2011-12-03,0,12,7,0,6,0,1,0.22,0.2576,0.75,0.0896,2,24,26,26,4,Siang
7961,2011-12-03,0,12,8,0,6,0,1,0.24,0.2576,0.75,0.0896,1,62,63,63,4,Siang
7962,2011-12-03,0,12,9,0,6,0,1,0.26,0.2727,0.7,0.1045,25,99,124,124,4,Siang
7963,2011-12-03,0,12,10,0,6,0,1,0.32,0.3333,0.61,0.1343,22,173,195,195,4,Siang
7964,2011-12-03,0,12,11,0,6,0,1,0.32,0.3333,0.57,0.0896,48,227,275,275,4,Siang
7965,2011-12-03,0,12,12,0,6,0,1,0.36,0.3788,0.5,0.0,78,280,358,358,4,Siang
7966,2011-12-03,0,12,13,0,6,0,1,0.36,0.3636,0.5,0.0896,70,222,292,292,4,Sore
7967,2011-12-03,0,12,14,0,6,0,1,0.36,0.3788,0.46,0.0,92,251,343,343,4,Sore
7968,2011-12-03,0,12,15,0,6,0,1,0.38,0.3939,0.46,0.0,100,237,337,337,4,Sore
7969,2011-12-03,0,12,16,0,6,0,1,0.38,0.3939,0.46,0.0,75,230,305,305,4,Sore
7970,2011-12-03,0,12,17,0,6,0,1,0.36,0.3788,0.62,0.0,46,186,232,232,4,Sore
7971,2011-12-03,0,12,18,0,6,0,1,0.34,0.3333,0.53,0.1343,31,193,224,224,4,Sore
7972,2011-12-03,0,12,19,0,6,0,1,0.3,0.3182,0.61,0.0896,31,144,175,175,4,Malam
7973,2011-12-03,0,12,20,0,6,0,1,0.3,0.3182,0.61,0.0896,17,110,127,127,4,Malam
7974,2011-12-03,0,12,21,0,6,0,2,0.3,0.3182,0.61,0.0896,5,104,109,109,4,Malam
7975,2011-12-03,0,12,22,0,6,0,2,0.32,0.3333,0.61,0.0896,17,97,114,114,4,Malam
7976,2011-12-03,0,12,23,0,6,0,1,0.3,0.303,0.7,0.1343,12,73,85,85,4,Malam
7977,2011-12-04,0,12,0,0,0,0,1,0.3,0.3182,0.7,0.1045,19,64,83,83,4,
7978,2011-12-04,0,12,1,0,0,0,1,0.3,0.3182,0.75,0.0896,20,54,74,74,4,Pagi
7979,2011-12-04,0,12,2,0,0,0,1,0.26,0.303,0.81,0.0,11,51,62,62,4,Pagi
7980,2011-12-04,0,12,3,0,0,0,1,0.28,0.3182,0.75,0.0,7,34,41,41,4,Pagi
7981,2011-12-04,0,12,4,0,0,0,1,0.26,0.303,0.87,0.0,2,9,11,11,4,Pagi
7982,2011-12-04,0,12,5,0,0,0,1,0.26,0.303,0.81,0.0,2,2,4,4,4,Pagi
7983,2011-12-04,0,12,6,0,0,0,1,0.24,0.2879,0.93,0.0,1,3,4,4,4,Pagi
7984,2011-12-04,0,12,7,0,0,0,1,0.26,0.303,0.87,0.0,3,23,26,26,4,Siang
7985,2011-12-04,0,12,8,0,0,0,1,0.26,0.303,0.87,0.0,7,48,55,55,4,Siang
7986,2011-12-04,0,12,9,0,0,0,1,0.3,0.3333,0.81,0.0,12,114,126,126,4,Siang
7987,2011-12-04,0,12,10,0,0,0,1,0.32,0.3333,0.81,0.1343,36,180,216,216,4,Siang
7988,2011-12-04,0,12,11,0,0,0,1,0.34,0.3333,0.81,0.1642,48,206,254,254,4,Siang
7989,2011-12-04,0,12,12,0,0,0,1,0.36,0.3485,0.81,0.1642,82,247,329,329,4,Siang
7990,2011-12-04,0,12,13,0,0,0,1,0.4,0.4091,0.66,0.2239,88,269,357,357,4,Sore
7991,2011-12-04,0,12,14,0,0,0,1,0.42,0.4242,0.62,0.1343,77,246,323,323,4,Sore
7992,2011-12-04,0,12,15,0,0,0,1,0.42,0.4242,0.62,0.194,69,227,296,296,4,Sore
7993,2011-12-04,0,12,16,0,0,0,1,0.42,0.4242,0.58,0.2239,64,266,330,330,4,Sore
7994,2011-12-04,0,12,17,0,0,0,1,0.38,0.3939,0.76,0.1343,38,207,245,245,4,Sore
7995,2011-12-04,0,12,18,0,0,0,1,0.38,0.3939,0.71,0.0,10,161,171,171,4,Sore
7996,2011-12-04,0,12,19,0,0,0,1,0.38,0.3939,0.76,0.0,15,158,173,173,4,Malam
7997,2011-12-04,0,12,20,0,0,0,1,0.36,0.3485,0.76,0.1343,8,116,124,124,4,Malam
7998,2011-12-04,0,12,21,0,0,0,1,0.36,0.3636,0.81,0.1045,7,65,72,72,4,Malam
7999,2011-12-04,0,12,22,0,0,0,1,0.34,0.3485,0.87,0.1045,5,59,64,64,4,Malam
8000,2011-12-04,0,12,23,0,0,0,1,0.34,0.3485,0.87,0.1045,3,42,45,45,4,Malam
8001,2011-12-05,0,12,0,0,1,1,1,0.32,0.3333,0.87,0.0896,3,21,24,24,4,
8002,2011-12-05,0,12,1,0,1,1,1,0.32,0.3485,0.87,0.0,2,10,12,12,4,Pagi
8003,2011-12-05,0,12,2,0,1,1,1,0.32,0.3485,0.87,0.0,0,8,8,8,4,Pagi
8004,2011-12-05,0,12,3,0,1,1,1,0.32,0.3485,0.87,0.0,0,2,2,2,4,Pagi
8005,2011-12-05,0,12,4,0,1,1,1,0.3,0.3182,0.87,0.1045,0,7,7,7,4,Pagi
8006,2011-12-05,0,12,5,0,1,1,1,0.3,0.3182,0.87,0.1045,1,24,25,25,4,Pagi
8007,2011-12-05,0,12,6,0,1,1,1,0.3,0.3182,0.93,0.0896,1,89,90,90,4,Pagi
8008,2011-12-05,0,12,7,0,1,1,1,0.32,0.3485,0.9,0.0,9,274,283,283,4,Siang
8009,2011-12-05,0,12,8,0,1,1,1,0.32,0.3485,0.93,0.0,12,392,404,404,4,Siang
8010,2011-12-05,0,12,9,0,1,1,2,0.36,0.3636,0.87,0.0896,12,178,190,190,4,Siang
8011,2011-12-05,0,12,10,0,1,1,2,0.36,0.3636,0.87,0.0896,9,78,87,87,4,Siang
8012,2011-12-05,0,12,11,0,1,1,2,0.36,0.3636,0.87,0.0896,17,106,123,123,4,Siang
8013,2011-12-05,0,12,12,0,1,1,2,0.4,0.4091,0.76,0.1045,29,125,154,154,4,Siang
8014,2011-12-05,0,12,13,0,1,1,2,0.42,0.4242,0.71,0.0896,18,153,171,171,4,Sore
8015,2011-12-05,0,12,14,0,1,1,2,0.46,0.4545,0.67,0.0,7,126,133,133,4,Sore
8016,2011-12-05,0,12,15,0,1,1,2,0.46,0.4545,0.72,0.0896,16,132,148,148,4,Sore
8017,2011-12-05,0,12,16,0,1,1,1,0.5,0.4848,0.63,0.0896,10,238,248,248,4,Sore
8018,2011-12-05,0,12,17,0,1,1,1,0.42,0.4242,0.77,0.0,16,430,446,446,4,Sore
8019,2011-12-05,0,12,18,0,1,1,1,0.44,0.4394,0.77,0.0,13,386,399,399,4,Sore
8020,2011-12-05,0,12,19,0,1,1,2,0.46,0.4545,0.77,0.0,13,295,308,308,4,Malam
8021,2011-12-05,0,12,20,0,1,1,2,0.46,0.4545,0.82,0.1045,15,190,205,205,4,Malam
8022,2011-12-05,0,12,21,0,1,1,2,0.44,0.4394,0.88,0.0896,10,166,176,176,4,Malam
8023,2011-12-05,0,12,22,0,1,1,2,0.44,0.4394,0.88,0.1343,12,94,106,106,4,Malam
8024,2011-12-05,0,12,23,0,1,1,2,0.46,0.4545,0.88,0.1343,8,54,62,62,4,Malam
8025,2011-12-06,0,12,0,0,2,1,2,0.5,0.4848,0.77,0.2985,3,25,28,28,4,
8026,2011-12-06,0,12,1,0,2,1,2,0.46,0.4545,0.88,0.2985,2,14,16,16,4,Pagi
8027,2011-12-06,0,12,2,0,2,1,2,0.46,0.4545,0.87,0.194,0,3,3,3,4,Pagi
8028,2011-12-06,0,12,3,0,2,1,2,0.46,0.4545,0.87,0.194,0,3,3,3,4,Pagi
8029,2011-12-06,0,12,4,0,2,1,3,0.46,0.4545,0.88,0.2239,0,7,7,7,4,Pagi
8030,2011-12-06,0,12,5,0,2,1,3,0.46,0.4545,0.88,0.2239,0,20,20,20,4,Pagi
8031,2011-12-06,0,12,6,0,2,1,2,0.44,0.4394,0.94,0.2836,5,81,86,86,4,Pagi
8032,2011-12-06,0,12,7,0,2,1,2,0.46,0.4545,0.94,0.194,7,227,234,234,4,Siang
8033,2011-12-06,0,12,8,0,2,1,2,0.46,0.4545,0.94,0.194,13,401,414,414,4,Siang
8034,2011-12-06,0,12,9,0,2,1,2,0.46,0.4545,0.94,0.2239,4,200,204,204,4,Siang
8035,2011-12-06,0,12,10,0,2,1,3,0.46,0.4545,0.94,0.2836,6,44,50,50,4,Siang
8036,2011-12-06,0,12,11,0,2,1,3,0.46,0.4545,0.94,0.2537,4,28,32,32,4,Siang
8037,2011-12-06,0,12,12,0,2,1,3,0.46,0.4545,1.0,0.2239,5,50,55,55,4,Siang
8038,2011-12-06,0,12,13,0,2,1,3,0.46,0.4545,1.0,0.194,6,65,71,71,4,Sore
8039,2011-12-06,0,12,14,0,2,1,3,0.48,0.4697,1.0,0.2239,6,69,75,75,4,Sore
8040,2011-12-06,0,12,15,0,2,1,3,0.5,0.4848,1.0,0.194,2,43,45,45,4,Sore
8041,2011-12-06,0,12,16,0,2,1,3,0.46,0.4545,1.0,0.2537,4,84,88,88,4,Sore
8042,2011-12-06,0,12,17,0,2,1,2,0.46,0.4545,1.0,0.2239,13,249,262,262,4,Sore
8043,2011-12-06,0,12,18,0,2,1,2,0.46,0.4545,1.0,0.2836,17,287,304,304,4,Sore
8044,2011-12-06,0,12,19,0,2,1,3,0.46,0.4545,1.0,0.2985,10,223,233,233,4,Malam
8045,2011-12-06,0,12,20,0,2,1,3,0.46,0.4545,1.0,0.2985,3,107,110,110,4,Malam
8046,2011-12-06,0,12,21,0,2,1,2,0.44,0.4394,1.0,0.194,6,108,114,114,4,Malam
8047,2011-12-06,0,12,22,0,2,1,3,0.46,0.4545,1.0,0.1642,5,82,87,87,4,Malam
8048,2011-12-06,0,12,23,0,2,1,3,0.46,0.4545,1.0,0.1642,5,48,53,53,4,Malam
8049,2011-12-07,0,12,0,0,3,1,1,0.44,0.4394,1.0,0.194,3,30,33,33,4,
8050,2011-12-07,0,12,1,0,3,1,2,0.46,0.4545,1.0,0.2537,4,9,13,13,4,Pagi
8051,2011-12-07,0,12,2,0,3,1,3,0.46,0.4545,1.0,0.2239,2,4,6,6,4,Pagi
8052,2011-12-07,0,12,3,0,3,1,3,0.46,0.4545,1.0,0.2239,0,3,3,3,4,Pagi
8053,2011-12-07,0,12,4,0,3,1,3,0.46,0.4545,1.0,0.1642,0,1,1,1,4,Pagi
8054,2011-12-07,0,12,5,0,3,1,3,0.46,0.4545,1.0,0.1642,0,3,3,3,4,Pagi
8055,2011-12-07,0,12,6,0,3,1,3,0.48,0.4697,1.0,0.4179,0,18,18,18,4,Pagi
8056,2011-12-07,0,12,7,0,3,1,3,0.44,0.4394,1.0,0.1045,3,43,46,46,4,Siang
8057,2011-12-07,0,12,8,0,3,1,3,0.44,0.4394,1.0,0.0,6,80,86,86,4,Siang
8058,2011-12-07,0,12,9,0,3,1,3,0.44,0.4394,1.0,0.2537,0,64,64,64,4,Siang
8059,2011-12-07,0,12,10,0,3,1,3,0.44,0.4394,1.0,0.0896,1,32,33,33,4,Siang
8060,2011-12-07,0,12,11,0,3,1,3,0.44,0.4394,1.0,0.0896,3,47,50,50,4,Siang
8061,2011-12-07,0,12,12,0,3,1,3,0.44,0.4394,1.0,0.1343,4,29,33,33,4,Siang
8062,2011-12-07,0,12,13,0,3,1,3,0.44,0.4394,1.0,0.194,5,28,33,33,4,Sore
8063,2011-12-07,0,12,14,0,3,1,3,0.44,0.4394,1.0,0.194,1,24,25,25,4,Sore
8064,2011-12-07,0,12,15,0,3,1,3,0.42,0.4242,0.94,0.2239,5,25,30,30,4,Sore
8065,2011-12-07,0,12,16,0,3,1,3,0.42,0.4242,0.94,0.194,3,28,31,31,4,Sore
8066,2011-12-07,0,12,17,0,3,1,3,0.4,0.4091,1.0,0.3284,4,48,52,52,4,Sore
8067,2011-12-07,0,12,18,0,3,1,3,0.4,0.4091,0.94,0.2985,3,48,51,51,4,Sore
8068,2011-12-07,0,12,19,0,3,1,3,0.34,0.2879,0.87,0.6418,2,31,33,33,4,Malam
8069,2011-12-07,0,12,20,0,3,1,3,0.34,0.2879,0.87,0.6418,1,25,26,26,4,Malam
8070,2011-12-07,0,12,21,0,3,1,3,0.3,0.2576,0.87,0.5224,0,6,6,6,4,Malam
8071,2011-12-07,0,12,22,0,3,1,3,0.24,0.197,0.93,0.4478,0,13,13,13,4,Malam
8072,2011-12-07,0,12,23,0,3,1,1,0.24,0.2121,0.93,0.3881,0,16,16,16,4,Malam
8073,2011-12-08,0,12,0,0,4,1,2,0.26,0.2273,0.87,0.2985,0,21,21,21,4,
8074,2011-12-08,0,12,1,0,4,1,1,0.26,0.2273,0.81,0.3582,1,6,7,7,4,Pagi
8075,2011-12-08,0,12,2,0,4,1,1,0.28,0.2727,0.65,0.2239,0,4,4,4,4,Pagi
8076,2011-12-08,0,12,3,0,4,1,1,0.26,0.2273,0.6,0.2985,0,1,1,1,4,Pagi
8077,2011-12-08,0,12,4,0,4,1,2,0.24,0.197,0.6,0.4627,0,2,2,2,4,Pagi
8078,2011-12-08,0,12,5,0,4,1,1,0.22,0.2121,0.64,0.2239,0,12,12,12,4,Pagi
8079,2011-12-08,0,12,6,0,4,1,1,0.22,0.2121,0.55,0.2836,0,71,71,71,4,Pagi
8080,2011-12-08,0,12,7,0,4,1,1,0.22,0.2121,0.6,0.2239,11,233,244,244,4,Siang
8081,2011-12-08,0,12,8,0,4,1,1,0.22,0.2121,0.55,0.2836,11,418,429,429,4,Siang
8082,2011-12-08,0,12,9,0,4,1,1,0.24,0.2121,0.52,0.3881,7,218,225,225,4,Siang
8083,2011-12-08,0,12,10,0,4,1,1,0.26,0.2273,0.52,0.3284,1,109,110,110,4,Siang
8084,2011-12-08,0,12,11,0,4,1,1,0.28,0.2727,0.52,0.2537,6,100,106,106,4,Siang
8085,2011-12-08,0,12,12,0,4,1,1,0.28,0.2576,0.52,0.3284,8,148,156,156,4,Siang
8086,2011-12-08,0,12,13,0,4,1,1,0.3,0.2727,0.49,0.3582,9,115,124,124,4,Sore
8087,2011-12-08,0,12,14,0,4,1,1,0.32,0.303,0.45,0.2537,16,121,137,137,4,Sore
8088,2011-12-08,0,12,15,0,4,1,1,0.32,0.3333,0.45,0.1343,19,98,117,117,4,Sore
8089,2011-12-08,0,12,16,0,4,1,1,0.32,0.3182,0.45,0.194,7,201,208,208,4,Sore
8090,2011-12-08,0,12,17,0,4,1,1,0.3,0.3182,0.49,0.1045,10,321,331,331,4,Sore
8091,2011-12-08,0,12,18,0,4,1,1,0.28,0.2727,0.52,0.2239,12,306,318,318,4,Sore
8092,2011-12-08,0,12,19,0,4,1,1,0.26,0.2727,0.56,0.1045,12,220,232,232,4,Malam
8093,2011-12-08,0,12,20,0,4,1,1,0.26,0.2727,0.6,0.1045,5,170,175,175,4,Malam
8094,2011-12-08,0,12,21,0,4,1,1,0.28,0.303,0.61,0.0896,4,135,139,139,4,Malam
8095,2011-12-08,0,12,22,0,4,1,1,0.26,0.2727,0.65,0.1343,8,84,92,92,4,Malam
8096,2011-12-08,0,12,23,0,4,1,1,0.24,0.2576,0.7,0.1045,3,58,61,61,4,Malam
8097,2011-12-09,0,12,0,0,5,1,1,0.24,0.2879,0.65,0.0,8,26,34,34,4,
8098,2011-12-09,0,12,1,0,5,1,1,0.24,0.2879,0.65,0.0,2,12,14,14,4,Pagi
8099,2011-12-09,0,12,2,0,5,1,1,0.24,0.2879,0.7,0.0,2,10,12,12,4,Pagi
8100,2011-12-09,0,12,3,0,5,1,1,0.22,0.2727,0.8,0.0,1,5,6,6,4,Pagi
8101,2011-12-09,0,12,4,0,5,1,1,0.22,0.2727,0.8,0.0,1,1,2,2,4,Pagi
8102,2011-12-09,0,12,5,0,5,1,1,0.22,0.2727,0.8,0.0,0,20,20,20,4,Pagi
8103,2011-12-09,0,12,6,0,5,1,1,0.22,0.2576,0.8,0.0896,1,62,63,63,4,Pagi
8104,2011-12-09,0,12,7,0,5,1,1,0.22,0.2576,0.75,0.0896,4,195,199,199,4,Siang
8105,2011-12-09,0,12,8,0,5,1,1,0.24,0.2879,0.81,0.0,7,378,385,385,4,Siang
8106,2011-12-09,0,12,9,0,5,1,1,0.26,0.2879,0.81,0.0896,8,256,264,264,4,Siang
8107,2011-12-09,0,12,10,0,5,1,2,0.3,0.303,0.7,0.1642,11,115,126,126,4,Siang
8108,2011-12-09,0,12,11,0,5,1,1,0.32,0.303,0.7,0.2537,15,121,136,136,4,Siang
8109,2011-12-09,0,12,12,0,5,1,1,0.36,0.3333,0.57,0.2985,27,146,173,173,4,Siang
8110,2011-12-09,0,12,13,0,5,1,1,0.38,0.3939,0.5,0.194,27,141,168,168,4,Sore
8111,2011-12-09,0,12,14,0,5,1,1,0.38,0.3939,0.46,0.2836,24,163,187,187,4,Sore
8112,2011-12-09,0,12,15,0,5,1,1,0.38,0.3939,0.46,0.2836,29,160,189,189,4,Sore
8113,2011-12-09,0,12,16,0,5,1,1,0.36,0.3485,0.62,0.1343,24,226,250,250,4,Sore
8114,2011-12-09,0,12,17,0,5,1,1,0.34,0.3485,0.66,0.1045,10,352,362,362,4,Sore
8115,2011-12-09,0,12,18,0,5,1,1,0.34,0.3636,0.61,0.0,10,308,318,318,4,Sore
8116,2011-12-09,0,12,19,0,5,1,1,0.34,0.3636,0.61,0.0,10,189,199,199,4,Malam
8117,2011-12-09,0,12,20,0,5,1,1,0.3,0.3333,0.81,0.0,10,140,150,150,4,Malam
8118,2011-12-09,0,12,21,0,5,1,1,0.3,0.3333,0.75,0.0,9,131,140,140,4,Malam
8119,2011-12-09,0,12,22,0,5,1,1,0.28,0.3182,0.87,0.0,15,114,129,129,4,Malam
8120,2011-12-09,0,12,23,0,5,1,1,0.28,0.3182,0.81,0.0,6,88,94,94,4,Malam
8121,2011-12-10,0,12,0,0,6,0,2,0.26,0.2727,0.81,0.1045,11,66,77,77,4,
8122,2011-12-10,0,12,1,0,6,0,2,0.26,0.2576,0.7,0.1642,11,55,66,66,4,Pagi
8123,2011-12-10,0,12,2,0,6,0,2,0.28,0.303,0.61,0.0896,12,48,60,60,4,Pagi
8124,2011-12-10,0,12,3,0,6,0,2,0.28,0.303,0.61,0.0896,5,20,25,25,4,Pagi
8125,2011-12-10,0,12,4,0,6,0,2,0.26,0.2727,0.65,0.1045,0,3,3,3,4,Pagi
8126,2011-12-10,0,12,5,0,6,0,1,0.26,0.2576,0.6,0.1642,0,6,6,6,4,Pagi
8127,2011-12-10,0,12,6,0,6,0,1,0.24,0.2576,0.65,0.1045,1,10,11,11,4,Pagi
8128,2011-12-10,0,12,7,0,6,0,1,0.24,0.2273,0.65,0.194,0,11,11,11,4,Siang
8129,2011-12-10,0,12,8,0,6,0,1,0.26,0.2727,0.65,0.1343,5,68,73,73,4,Siang
8130,2011-12-10,0,12,9,0,6,0,1,0.28,0.2576,0.61,0.2836,15,134,149,149,4,Siang
8131,2011-12-10,0,12,10,0,6,0,1,0.32,0.303,0.57,0.2537,31,161,192,192,4,Siang
8132,2011-12-10,0,12,11,0,6,0,1,0.32,0.2879,0.53,0.4179,44,192,236,236,4,Siang
8133,2011-12-10,0,12,12,0,6,0,1,0.32,0.2879,0.45,0.4179,48,235,283,283,4,Siang
8134,2011-12-10,0,12,13,0,6,0,1,0.34,0.303,0.34,0.4179,47,239,286,286,4,Sore
8135,2011-12-10,0,12,14,0,6,0,1,0.34,0.303,0.31,0.3284,51,242,293,293,4,Sore
8136,2011-12-10,0,12,15,0,6,0,1,0.34,0.303,0.34,0.3582,60,239,299,299,4,Sore
8137,2011-12-10,0,12,16,0,6,0,1,0.32,0.2879,0.31,0.3881,58,183,241,241,4,Sore
8138,2011-12-10,0,12,17,0,6,0,1,0.28,0.2576,0.36,0.3284,34,151,185,185,4,Sore
8139,2011-12-10,0,12,18,0,6,0,1,0.26,0.2576,0.38,0.2239,28,144,172,172,4,Sore
8140,2011-12-10,0,12,19,0,6,0,1,0.26,0.2424,0.38,0.2836,15,139,154,154,4,Malam
8141,2011-12-10,0,12,20,0,6,0,1,0.24,0.2273,0.35,0.2239,10,114,124,124,4,Malam
8142,2011-12-10,0,12,21,0,6,0,1,0.22,0.2121,0.44,0.2239,4,79,83,83,4,Malam
8143,2011-12-10,0,12,22,0,6,0,1,0.22,0.2273,0.41,0.1343,7,88,95,95,4,Malam
8144,2011-12-10,0,12,23,0,6,0,1,0.2,0.2121,0.47,0.1642,5,61,66,66,4,Malam
8145,2011-12-11,0,12,0,0,0,0,1,0.2,0.197,0.51,0.2239,5,69,74,74,4,
8146,2011-12-11,0,12,1,0,0,0,1,0.16,0.1515,0.59,0.2239,8,54,62,62,4,Pagi
8147,2011-12-11,0,12,2,0,0,0,1,0.18,0.1667,0.55,0.2537,5,47,52,52,4,Pagi
8148,2011-12-11,0,12,3,0,0,0,1,0.16,0.1818,0.59,0.1343,2,17,19,19,4,Pagi
8149,2011-12-11,0,12,4,0,0,0,1,0.16,0.1667,0.59,0.1642,0,5,5,5,4,Pagi
8150,2011-12-11,0,12,5,0,0,0,1,0.18,0.2121,0.59,0.1045,0,6,6,6,4,Pagi
8151,2011-12-11,0,12,6,0,0,0,1,0.16,0.2273,0.59,0.0,0,10,10,10,4,Pagi
8152,2011-12-11,0,12,7,0,0,0,1,0.18,0.2424,0.55,0.0,1,30,31,31,4,Siang
8153,2011-12-11,0,12,8,0,0,0,1,0.16,0.2273,0.69,0.0,4,68,72,72,4,Siang
8154,2011-12-11,0,12,9,0,0,0,1,0.2,0.2576,0.59,0.0,19,88,107,107,4,Siang
8155,2011-12-11,0,12,10,0,0,0,1,0.24,0.2879,0.44,0.0,30,164,194,194,4,Siang
8156,2011-12-11,0,12,11,0,0,0,1,0.26,0.303,0.35,0.0,31,166,197,197,4,Siang
8157,2011-12-11,0,12,12,0,0,0,1,0.26,0.303,0.35,0.0,42,246,288,288,4,Siang
8158,2011-12-11,0,12,13,0,0,0,1,0.3,0.3333,0.31,0.0,44,224,268,268,4,Sore
8159,2011-12-11,0,12,14,0,0,0,1,0.3,0.3333,0.28,0.0,44,198,242,242,4,Sore
8160,2011-12-11,0,12,15,0,0,0,1,0.3,0.3333,0.26,0.0,47,219,266,266,4,Sore
8161,2011-12-11,0,12,16,0,0,0,1,0.3,0.3333,0.26,0.0,32,174,206,206,4,Sore
8162,2011-12-11,0,12,17,0,0,0,1,0.28,0.3182,0.3,0.0,13,150,163,163,4,Sore
8163,2011-12-11,0,12,18,0,0,0,1,0.24,0.2273,0.48,0.194,12,151,163,163,4,Sore
8164,2011-12-11,0,12,19,0,0,0,1,0.22,0.2273,0.55,0.194,7,98,105,105,4,Malam
8165,2011-12-11,0,12,20,0,0,0,1,0.22,0.2424,0.55,0.1045,10,62,72,72,4,Malam
8166,2011-12-11,0,12,21,0,0,0,1,0.22,0.2727,0.55,0.0,10,53,63,63,4,Malam
8167,2011-12-11,0,12,22,0,0,0,1,0.22,0.2727,0.55,0.0,7,36,43,43,4,Malam
8168,2011-12-11,0,12,23,0,0,0,1,0.2,0.2576,0.69,0.0,4,31,35,35,4,Malam
8169,2011-12-12,0,12,0,0,1,1,1,0.2,0.2273,0.69,0.0896,4,16,20,20,4,
8170,2011-12-12,0,12,1,0,1,1,1,0.2,0.2576,0.69,0.0,0,9,9,9,4,Pagi
8171,2011-12-12,0,12,2,0,1,1,1,0.2,0.2576,0.69,0.0,0,4,4,4,4,Pagi
8172,2011-12-12,0,12,3,0,1,1,1,0.18,0.2424,0.74,0.0,0,2,2,2,4,Pagi
8173,2011-12-12,0,12,4,0,1,1,1,0.18,0.2424,0.74,0.0,0,3,3,3,4,Pagi
8174,2011-12-12,0,12,5,0,1,1,1,0.16,0.2273,0.8,0.0,0,21,21,21,4,Pagi
8175,2011-12-12,0,12,6,0,1,1,1,0.16,0.1818,0.8,0.1045,1,63,64,64,4,Pagi
8176,2011-12-12,0,12,7,0,1,1,1,0.14,0.1515,0.86,0.1343,4,231,235,235,4,Siang
8177,2011-12-12,0,12,8,0,1,1,2,0.16,0.1818,0.8,0.1045,7,378,385,385,4,Siang
8178,2011-12-12,0,12,9,0,1,1,2,0.18,0.2121,0.74,0.0896,12,208,220,220,4,Siang
8179,2011-12-12,0,12,10,0,1,1,2,0.22,0.2424,0.69,0.1045,14,91,105,105,4,Siang
8180,2011-12-12,0,12,11,0,1,1,2,0.26,0.2879,0.6,0.0896,15,100,115,115,4,Siang
8181,2011-12-12,0,12,12,0,1,1,1,0.28,0.2879,0.52,0.1045,7,138,145,145,4,Siang
8182,2011-12-12,0,12,13,0,1,1,2,0.3,0.3182,0.52,0.1045,13,153,166,166,4,Sore
8183,2011-12-12,0,12,14,0,1,1,2,0.32,0.3333,0.53,0.1343,16,95,111,111,4,Sore
8184,2011-12-12,0,12,15,0,1,1,2,0.32,0.3333,0.57,0.1045,8,124,132,132,4,Sore
8185,2011-12-12,0,12,16,0,1,1,2,0.32,0.3333,0.57,0.0896,5,209,214,214,4,Sore
8186,2011-12-12,0,12,17,0,1,1,2,0.3,0.3333,0.56,0.0,7,352,359,359,4,Sore
8187,2011-12-12,0,12,18,0,1,1,1,0.3,0.3182,0.56,0.0896,8,349,357,357,4,Sore
8188,2011-12-12,0,12,19,0,1,1,1,0.28,0.303,0.61,0.0896,9,232,241,241,4,Malam
8189,2011-12-12,0,12,20,0,1,1,1,0.3,0.3182,0.56,0.0896,8,157,165,165,4,Malam
8190,2011-12-12,0,12,21,0,1,1,1,0.26,0.303,0.81,0.0,2,119,121,121,4,Malam
8191,2011-12-12,0,12,22,0,1,1,1,0.26,0.303,0.7,0.0,0,71,71,71,4,Malam
8192,2011-12-12,0,12,23,0,1,1,1,0.24,0.2879,0.75,0.0,3,42,45,45,4,Malam
8193,2011-12-13,0,12,0,0,2,1,1,0.22,0.2727,0.8,0.0,1,16,17,17,4,
8194,2011-12-13,0,12,1,0,2,1,1,0.2,0.2576,0.8,0.0,0,4,4,4,4,Pagi
8195,2011-12-13,0,12,2,0,2,1,1,0.2,0.2576,0.8,0.0,1,1,2,2,4,Pagi
8196,2011-12-13,0,12,3,0,2,1,1,0.18,0.2424,0.8,0.0,0,3,3,3,4,Pagi
8197,2011-12-13,0,12,4,0,2,1,1,0.2,0.2576,0.8,0.0,0,4,4,4,4,Pagi
8198,2011-12-13,0,12,5,0,2,1,1,0.18,0.2424,0.86,0.0,0,20,20,20,4,Pagi
8199,2011-12-13,0,12,6,0,2,1,1,0.2,0.2576,0.8,0.0,0,92,92,92,4,Pagi
8200,2011-12-13,0,12,7,0,2,1,1,0.16,0.1667,0.8,0.1642,2,221,223,223,4,Siang
8201,2011-12-13,0,12,8,0,2,1,1,0.2,0.2273,0.69,0.1045,9,391,400,400,4,Siang
8202,2011-12-13,0,12,9,0,2,1,1,0.26,0.2576,0.6,0.1642,10,223,233,233,4,Siang
8203,2011-12-13,0,12,10,0,2,1,1,0.3,0.303,0.52,0.1642,3,99,102,102,4,Siang
8204,2011-12-13,0,12,11,0,2,1,1,0.34,0.3182,0.46,0.2537,9,115,124,124,4,Siang
8205,2011-12-13,0,12,12,0,2,1,1,0.36,0.3333,0.43,0.3582,20,147,167,167,4,Siang
8206,2011-12-13,0,12,13,0,2,1,1,0.4,0.4091,0.37,0.3284,7,120,127,127,4,Sore
8207,2011-12-13,0,12,14,0,2,1,1,0.4,0.4091,0.37,0.2537,18,116,134,134,4,Sore
8208,2011-12-13,0,12,15,0,2,1,1,0.4,0.4091,0.35,0.2537,7,144,151,151,4,Sore
8209,2011-12-13,0,12,16,0,2,1,1,0.38,0.3939,0.37,0.2537,13,194,207,207,4,Sore
8210,2011-12-13,0,12,17,0,2,1,1,0.36,0.3485,0.4,0.194,17,381,398,398,4,Sore
8211,2011-12-13,0,12,18,0,2,1,1,0.34,0.3182,0.42,0.2239,12,370,382,382,4,Sore
8212,2011-12-13,0,12,19,0,2,1,1,0.32,0.3182,0.49,0.1642,5,262,267,267,4,Malam
8213,2011-12-13,0,12,20,0,2,1,1,0.32,0.3182,0.49,0.1642,7,154,161,161,4,Malam
8214,2011-12-13,0,12,21,0,2,1,1,0.3,0.303,0.52,0.1642,5,134,139,139,4,Malam
8215,2011-12-13,0,12,22,0,2,1,1,0.3,0.303,0.52,0.1642,5,102,107,107,4,Malam
8216,2011-12-13,0,12,23,0,2,1,1,0.26,0.303,0.7,0.0,4,55,59,59,4,Malam
8217,2011-12-14,0,12,0,0,3,1,1,0.26,0.303,0.75,0.0,0,22,22,22,4,
8218,2011-12-14,0,12,1,0,3,1,1,0.26,0.303,0.75,0.0,0,8,8,8,4,Pagi
8219,2011-12-14,0,12,2,0,3,1,1,0.26,0.303,0.75,0.0,0,2,2,2,4,Pagi
8220,2011-12-14,0,12,3,0,3,1,1,0.28,0.3182,0.65,0.0,0,3,3,3,4,Pagi
8221,2011-12-14,0,12,4,0,3,1,1,0.26,0.303,0.75,0.0,0,4,4,4,4,Pagi
8222,2011-12-14,0,12,5,0,3,1,2,0.26,0.303,0.81,0.0,0,26,26,26,4,Pagi
8223,2011-12-14,0,12,6,0,3,1,2,0.26,0.303,0.87,0.0,0,87,87,87,4,Pagi
8224,2011-12-14,0,12,7,0,3,1,1,0.28,0.3182,0.75,0.0,4,243,247,247,4,Siang
8225,2011-12-14,0,12,8,0,3,1,2,0.26,0.303,0.87,0.0,9,458,467,467,4,Siang
8226,2011-12-14,0,12,9,0,3,1,2,0.3,0.3333,0.61,0.0,9,230,239,239,4,Siang
8227,2011-12-14,0,12,10,0,3,1,2,0.32,0.3485,0.57,0.0,9,133,142,142,4,Siang
8228,2011-12-14,0,12,11,0,3,1,2,0.34,0.3636,0.55,0.0,12,103,115,115,4,Siang
8229,2011-12-14,0,12,12,0,3,1,2,0.36,0.3636,0.57,0.0896,6,138,144,144,4,Siang
8230,2011-12-14,0,12,13,0,3,1,2,0.36,0.3636,0.57,0.1045,14,119,133,133,4,Sore
8231,2011-12-14,0,12,14,0,3,1,2,0.38,0.3939,0.54,0.0896,17,134,151,151,4,Sore
8232,2011-12-14,0,12,15,0,3,1,2,0.38,0.3939,0.54,0.1045,24,143,167,167,4,Sore
8233,2011-12-14,0,12,16,0,3,1,2,0.38,0.3939,0.54,0.1045,12,233,245,245,4,Sore
8234,2011-12-14,0,12,17,0,3,1,2,0.36,0.3636,0.57,0.1045,19,377,396,396,4,Sore
8235,2011-12-14,0,12,18,0,3,1,2,0.36,0.3485,0.62,0.1642,11,379,390,390,4,Sore
8236,2011-12-14,0,12,19,0,3,1,2,0.36,0.3636,0.62,0.1045,9,259,268,268,4,Malam
8237,2011-12-14,0,12,20,0,3,1,2,0.34,0.3485,0.66,0.1045,6,169,175,175,4,Malam
8238,2011-12-14,0,12,21,0,3,1,2,0.34,0.3333,0.66,0.1642,9,145,154,154,4,Malam
8239,2011-12-14,0,12,22,0,3,1,1,0.34,0.3333,0.66,0.1642,5,99,104,104,4,Malam
8240,2011-12-14,0,12,23,0,3,1,1,0.32,0.3182,0.7,0.1642,3,48,51,51,4,Malam
8241,2011-12-15,0,12,0,0,4,1,1,0.32,0.3182,0.7,0.1642,5,45,50,50,4,
8242,2011-12-15,0,12,1,0,4,1,2,0.32,0.3182,0.7,0.1642,5,15,20,20,4,Pagi
8243,2011-12-15,0,12,2,0,4,1,2,0.32,0.3333,0.7,0.1343,2,5,7,7,4,Pagi
8244,2011-12-15,0,12,3,0,4,1,2,0.32,0.3333,0.7,0.1343,1,2,3,3,4,Pagi
8245,2011-12-15,0,12,4,0,4,1,2,0.32,0.303,0.7,0.2239,0,6,6,6,4,Pagi
8246,2011-12-15,0,12,5,0,4,1,2,0.32,0.303,0.7,0.2836,0,24,24,24,4,Pagi
8247,2011-12-15,0,12,6,0,4,1,1,0.32,0.3182,0.66,0.194,2,90,92,92,4,Pagi
8248,2011-12-15,0,12,7,0,4,1,1,0.32,0.3182,0.7,0.194,6,252,258,258,4,Siang
8249,2011-12-15,0,12,8,0,4,1,2,0.34,0.3182,0.66,0.2239,8,449,457,457,4,Siang
8250,2011-12-15,0,12,9,0,4,1,2,0.36,0.3333,0.62,0.2836,6,274,280,280,4,Siang
8251,2011-12-15,0,12,10,0,4,1,2,0.4,0.4091,0.58,0.2985,4,105,109,109,4,Siang
8252,2011-12-15,0,12,11,0,4,1,2,0.4,0.4091,0.62,0.4179,9,126,135,135,4,Siang
8253,2011-12-15,0,12,12,0,4,1,2,0.46,0.4545,0.59,0.4925,17,140,157,157,4,Siang
8254,2011-12-15,0,12,13,0,4,1,2,0.5,0.4848,0.55,0.3582,14,150,164,164,4,Sore
8255,2011-12-15,0,12,14,0,4,1,2,0.52,0.5,0.52,0.3284,8,124,132,132,4,Sore
8256,2011-12-15,0,12,15,0,4,1,3,0.52,0.5,0.55,0.2239,6,76,82,82,4,Sore
8257,2011-12-15,0,12,16,0,4,1,3,0.46,0.4545,0.72,0.1642,7,124,131,131,4,Sore
8258,2011-12-15,0,12,17,0,4,1,2,0.52,0.5,0.59,0.2836,14,310,324,324,4,Sore
8259,2011-12-15,0,12,18,0,4,1,2,0.52,0.5,0.59,0.2985,14,363,377,377,4,Sore
8260,2011-12-15,0,12,19,0,4,1,2,0.52,0.5,0.59,0.2836,13,274,287,287,4,Malam
8261,2011-12-15,0,12,20,0,4,1,1,0.52,0.5,0.59,0.3284,12,209,221,221,4,Malam
8262,2011-12-15,0,12,21,0,4,1,1,0.5,0.4848,0.63,0.2985,10,145,155,155,4,Malam
8263,2011-12-15,0,12,22,0,4,1,1,0.52,0.5,0.63,0.3284,8,116,124,124,4,Malam
8264,2011-12-15,0,12,23,0,4,1,1,0.52,0.5,0.63,0.3284,10,104,114,114,4,Malam
8265,2011-12-16,0,12,0,0,5,1,1,0.5,0.4848,0.72,0.3284,12,60,72,72,4,
8266,2011-12-16,0,12,1,0,5,1,1,0.5,0.4848,0.72,0.2239,3,28,31,31,4,Pagi
8267,2011-12-16,0,12,2,0,5,1,1,0.48,0.4697,0.77,0.1045,0,23,23,23,4,Pagi
8268,2011-12-16,0,12,3,0,5,1,1,0.46,0.4545,0.82,0.1343,2,3,5,5,4,Pagi
8269,2011-12-16,0,12,4,0,5,1,2,0.5,0.4848,0.59,0.194,1,4,5,5,4,Pagi
8270,2011-12-16,0,12,5,0,5,1,1,0.48,0.4697,0.44,0.3881,0,26,26,26,4,Pagi
8271,2011-12-16,0,12,6,0,5,1,2,0.44,0.4394,0.33,0.2985,2,80,82,82,4,Pagi
8272,2011-12-16,0,12,7,0,5,1,2,0.38,0.3939,0.46,0.2985,5,226,231,231,4,Siang
8273,2011-12-16,0,12,8,0,5,1,1,0.36,0.3333,0.46,0.4179,10,449,459,459,4,Siang
8274,2011-12-16,0,12,9,0,5,1,1,0.36,0.3333,0.46,0.3881,8,235,243,243,4,Siang
8275,2011-12-16,0,12,10,0,5,1,1,0.34,0.303,0.46,0.2985,10,122,132,132,4,Siang
8276,2011-12-16,0,12,11,0,5,1,2,0.34,0.303,0.42,0.2985,9,135,144,144,4,Siang
8277,2011-12-16,0,12,12,0,5,1,2,0.34,0.303,0.42,0.3582,10,163,173,173,4,Siang
8278,2011-12-16,0,12,13,0,5,1,2,0.34,0.303,0.39,0.3582,12,125,137,137,4,Sore
8279,2011-12-16,0,12,14,0,5,1,2,0.34,0.3182,0.42,0.2239,13,115,128,128,4,Sore
8280,2011-12-16,0,12,15,0,5,1,2,0.32,0.303,0.45,0.2985,12,141,153,153,4,Sore
8281,2011-12-16,0,12,16,0,5,1,2,0.32,0.303,0.45,0.2239,12,212,224,224,4,Sore
8282,2011-12-16,0,12,17,0,5,1,2,0.32,0.303,0.45,0.2836,13,352,365,365,4,Sore
8283,2011-12-16,0,12,18,0,5,1,2,0.32,0.303,0.45,0.2537,10,285,295,295,4,Sore
8284,2011-12-16,0,12,19,0,5,1,2,0.32,0.303,0.45,0.2239,11,203,214,214,4,Malam
8285,2011-12-16,0,12,20,0,5,1,2,0.32,0.3182,0.45,0.194,6,146,152,152,4,Malam
8286,2011-12-16,0,12,21,0,5,1,2,0.32,0.3182,0.45,0.1642,7,95,102,102,4,Malam
8287,2011-12-16,0,12,22,0,5,1,2,0.3,0.303,0.49,0.1642,6,100,106,106,4,Malam
8288,2011-12-16,0,12,23,0,5,1,2,0.3,0.303,0.49,0.1343,4,71,75,75,4,Malam
8289,2011-12-17,0,12,0,0,6,0,1,0.3,0.2879,0.49,0.2836,3,59,62,62,4,
8290,2011-12-17,0,12,1,0,6,0,2,0.3,0.2879,0.52,0.2537,4,39,43,43,4,Pagi
8291,2011-12-17,0,12,2,0,6,0,2,0.28,0.2727,0.56,0.2239,11,47,58,58,4,Pagi
8292,2011-12-17,0,12,3,0,6,0,1,0.26,0.2576,0.6,0.194,4,22,26,26,4,Pagi
8293,2011-12-17,0,12,4,0,6,0,1,0.24,0.2424,0.65,0.1642,0,9,9,9,4,Pagi
8294,2011-12-17,0,12,5,0,6,0,2,0.26,0.2576,0.6,0.194,2,7,9,9,4,Pagi
8295,2011-12-17,0,12,6,0,6,0,2,0.26,0.2424,0.56,0.2836,0,17,17,17,4,Pagi
8296,2011-12-17,0,12,7,0,6,0,2,0.26,0.2576,0.56,0.2239,0,20,20,20,4,Siang
8297,2011-12-17,0,12,8,0,6,0,2,0.26,0.2576,0.56,0.2239,4,55,59,59,4,Siang
8298,2011-12-17,0,12,9,0,6,0,2,0.26,0.2424,0.56,0.2537,5,95,100,100,4,Siang
8299,2011-12-17,0,12,10,0,6,0,2,0.26,0.2424,0.52,0.2836,10,171,181,181,4,Siang
8300,2011-12-17,0,12,11,0,6,0,2,0.28,0.2576,0.45,0.3284,21,188,209,209,4,Siang
8301,2011-12-17,0,12,12,0,6,0,2,0.28,0.2576,0.45,0.2836,28,216,244,244,4,Siang
8302,2011-12-17,0,12,13,0,6,0,2,0.28,0.2727,0.48,0.2537,32,204,236,236,4,Sore
8303,2011-12-17,0,12,14,0,6,0,1,0.28,0.2576,0.45,0.3582,30,207,237,237,4,Sore
8304,2011-12-17,0,12,15,0,6,0,1,0.28,0.2576,0.45,0.2836,33,195,228,228,4,Sore
8305,2011-12-17,0,12,16,0,6,0,1,0.28,0.2727,0.45,0.2239,30,192,222,222,4,Sore
8306,2011-12-17,0,12,17,0,6,0,1,0.26,0.2576,0.48,0.2239,12,153,165,165,4,Sore
8307,2011-12-17,0,12,18,0,6,0,1,0.26,0.2273,0.48,0.3881,7,150,157,157,4,Sore
8308,2011-12-17,0,12,19,0,6,0,3,0.24,0.2121,0.65,0.3284,11,95,106,106,4,Malam
8309,2011-12-17,0,12,20,0,6,0,1,0.22,0.2121,0.69,0.2537,7,99,106,106,4,Malam
8310,2011-12-17,0,12,21,0,6,0,1,0.2,0.2121,0.75,0.1642,8,88,96,96,4,Malam
8311,2011-12-17,0,12,22,0,6,0,1,0.2,0.2121,0.75,0.1642,7,73,80,80,4,Malam
8312,2011-12-17,0,12,23,0,6,0,1,0.2,0.2273,0.75,0.0,6,63,69,69,4,Malam
8313,2011-12-18,0,12,0,0,0,0,1,0.2,0.2121,0.75,0.1343,7,64,71,71,4,
8314,2011-12-18,0,12,1,0,0,0,1,0.2,0.2273,0.69,0.1045,3,43,46,46,4,Pagi
8315,2011-12-18,0,12,2,0,0,0,1,0.22,0.2424,0.55,0.1045,2,39,41,41,4,Pagi
8316,2011-12-18,0,12,3,0,0,0,1,0.22,0.2121,0.55,0.2239,2,16,18,18,4,Pagi
8317,2011-12-18,0,12,4,0,0,0,1,0.22,0.2121,0.55,0.2239,0,1,1,1,4,Pagi
8318,2011-12-18,0,12,5,0,0,0,1,0.2,0.2273,0.59,0.1045,1,4,5,5,4,Pagi
8319,2011-12-18,0,12,6,0,0,0,1,0.2,0.2121,0.59,0.1343,0,3,3,3,4,Pagi
8320,2011-12-18,0,12,7,0,0,0,1,0.2,0.2121,0.59,0.1642,1,11,12,12,4,Siang
8321,2011-12-18,0,12,8,0,0,0,1,0.2,0.2576,0.69,0.0,1,31,32,32,4,Siang
8322,2011-12-18,0,12,9,0,0,0,1,0.22,0.2273,0.64,0.1642,6,75,81,81,4,Siang
8323,2011-12-18,0,12,10,0,0,0,1,0.24,0.2273,0.6,0.2537,7,122,129,129,4,Siang
8324,2011-12-18,0,12,11,0,0,0,2,0.24,0.2273,0.6,0.2239,20,168,188,188,4,Siang
8325,2011-12-18,0,12,12,0,0,0,1,0.26,0.2576,0.6,0.2239,26,202,228,228,4,Siang
8326,2011-12-18,0,12,13,0,0,0,1,0.3,0.2727,0.49,0.2985,18,210,228,228,4,Sore
8327,2011-12-18,0,12,14,0,0,0,1,0.3,0.2879,0.49,0.2836,19,200,219,219,4,Sore
8328,2011-12-18,0,12,15,0,0,0,1,0.32,0.303,0.45,0.2836,23,184,207,207,4,Sore
8329,2011-12-18,0,12,16,0,0,0,1,0.28,0.2727,0.48,0.2537,27,207,234,234,4,Sore
8330,2011-12-18,0,12,17,0,0,0,1,0.28,0.2727,0.46,0.1642,10,126,136,136,4,Sore
8331,2011-12-18,0,12,18,0,0,0,1,0.28,0.2727,0.45,0.194,15,123,138,138,4,Sore
8332,2011-12-18,0,12,19,0,0,0,1,0.26,0.2727,0.52,0.1343,5,130,135,135,4,Malam
8333,2011-12-18,0,12,20,0,0,0,1,0.24,0.2576,0.6,0.1045,10,94,104,104,4,Malam
8334,2011-12-18,0,12,21,0,0,0,1,0.22,0.2727,0.64,0.0,9,80,89,89,4,Malam
8335,2011-12-18,0,12,22,0,0,0,1,0.22,0.2273,0.75,0.194,2,47,49,49,4,Malam
8336,2011-12-18,0,12,23,0,0,0,1,0.2,0.2273,0.75,0.1045,6,31,37,37,4,Malam
8337,2011-12-19,0,12,0,0,1,1,1,0.2,0.2273,0.75,0.0896,3,14,17,17,4,
8338,2011-12-19,0,12,1,0,1,1,1,0.18,0.2121,0.8,0.0896,3,8,11,11,4,Pagi
8339,2011-12-19,0,12,2,0,1,1,1,0.18,0.2121,0.8,0.0896,0,3,3,3,4,Pagi
8340,2011-12-19,0,12,3,0,1,1,1,0.16,0.197,0.86,0.0896,0,3,3,3,4,Pagi
8341,2011-12-19,0,12,4,0,1,1,1,0.16,0.1818,0.86,0.1343,0,4,4,4,4,Pagi
8342,2011-12-19,0,12,5,0,1,1,1,0.14,0.1667,0.93,0.1045,0,21,21,21,4,Pagi
8343,2011-12-19,0,12,6,0,1,1,1,0.16,0.1818,0.86,0.1045,0,68,68,68,4,Pagi
8344,2011-12-19,0,12,7,0,1,1,1,0.18,0.2121,0.74,0.1045,4,187,191,191,4,Siang
8345,2011-12-19,0,12,8,0,1,1,1,0.2,0.197,0.75,0.194,8,389,397,397,4,Siang
8346,2011-12-19,0,12,9,0,1,1,1,0.22,0.2121,0.69,0.2239,17,166,183,183,4,Siang
8347,2011-12-19,0,12,10,0,1,1,1,0.24,0.2273,0.67,0.194,12,96,108,108,4,Siang
8348,2011-12-19,0,12,11,0,1,1,1,0.26,0.2424,0.65,0.2537,22,105,127,127,4,Siang
8349,2011-12-19,0,12,12,0,1,1,1,0.3,0.2727,0.61,0.3284,13,128,141,141,4,Siang
8350,2011-12-19,0,12,13,0,1,1,1,0.34,0.303,0.49,0.3284,15,127,142,142,4,Sore
8351,2011-12-19,0,12,14,0,1,1,1,0.36,0.3485,0.46,0.2239,30,107,137,137,4,Sore
8352,2011-12-19,0,12,15,0,1,1,1,0.38,0.3939,0.46,0.1642,24,135,159,159,4,Sore
8353,2011-12-19,0,12,16,0,1,1,1,0.4,0.4091,0.4,0.2537,19,189,208,208,4,Sore
8354,2011-12-19,0,12,17,0,1,1,1,0.38,0.3939,0.46,0.194,16,362,378,378,4,Sore
8355,2011-12-19,0,12,18,0,1,1,1,0.36,0.3485,0.5,0.194,11,343,354,354,4,Sore
8356,2011-12-19,0,12,19,0,1,1,2,0.36,0.3485,0.53,0.1642,17,234,251,251,4,Malam
8357,2011-12-19,0,12,20,0,1,1,1,0.4,0.4091,0.4,0.1642,9,197,206,206,4,Malam
8358,2011-12-19,0,12,21,0,1,1,2,0.36,0.3485,0.53,0.1343,15,112,127,127,4,Malam
8359,2011-12-19,0,12,22,0,1,1,2,0.36,0.3485,0.57,0.1642,12,95,107,107,4,Malam
8360,2011-12-19,0,12,23,0,1,1,1,0.36,0.3485,0.53,0.1642,10,50,60,60,4,Malam
8361,2011-12-20,0,12,0,0,2,1,1,0.36,0.3636,0.57,0.1045,0,21,21,21,4,
8362,2011-12-20,0,12,1,0,2,1,1,0.36,0.3788,0.53,0.0,0,6,6,6,4,Pagi
8363,2011-12-20,0,12,2,0,2,1,2,0.34,0.3636,0.61,0.0,1,10,11,11,4,Pagi
8364,2011-12-20,0,12,3,0,2,1,2,0.34,0.3636,0.61,0.0,1,1,2,2,4,Pagi
8365,2011-12-20,0,12,4,0,2,1,2,0.36,0.3636,0.53,0.1045,0,4,4,4,4,Pagi
8366,2011-12-20,0,12,5,0,2,1,2,0.36,0.3788,0.57,0.0,0,15,15,15,4,Pagi
8367,2011-12-20,0,12,6,0,2,1,2,0.36,0.3788,0.57,0.0,1,71,72,72,4,Pagi
8368,2011-12-20,0,12,7,0,2,1,2,0.36,0.3788,0.62,0.0,7,261,268,268,4,Siang
8369,2011-12-20,0,12,8,0,2,1,2,0.42,0.4242,0.54,0.0896,10,422,432,432,4,Siang
8370,2011-12-20,0,12,9,0,2,1,2,0.36,0.3788,0.66,0.0,14,245,259,259,4,Siang
8371,2011-12-20,0,12,10,0,2,1,2,0.42,0.4242,0.58,0.194,20,109,129,129,4,Siang
8372,2011-12-20,0,12,11,0,2,1,2,0.4,0.4091,0.62,0.1642,13,116,129,129,4,Siang
8373,2011-12-20,0,12,12,0,2,1,2,0.44,0.4394,0.54,0.1343,16,159,175,175,4,Siang
8374,2011-12-20,0,12,13,0,2,1,2,0.44,0.4394,0.54,0.1343,18,163,181,181,4,Sore
8375,2011-12-20,0,12,14,0,2,1,2,0.44,0.4394,0.58,0.1045,11,127,138,138,4,Sore
8376,2011-12-20,0,12,15,0,2,1,2,0.44,0.4394,0.54,0.0,15,139,154,154,4,Sore
8377,2011-12-20,0,12,16,0,2,1,1,0.44,0.4394,0.54,0.0,20,218,238,238,4,Sore
8378,2011-12-20,0,12,17,0,2,1,1,0.4,0.4091,0.62,0.1642,14,417,431,431,4,Sore
8379,2011-12-20,0,12,18,0,2,1,1,0.38,0.3939,0.66,0.194,26,385,411,411,4,Sore
8380,2011-12-20,0,12,19,0,2,1,1,0.38,0.3939,0.66,0.0,6,218,224,224,4,Malam
8381,2011-12-20,0,12,20,0,2,1,1,0.36,0.3788,0.66,0.0,3,144,147,147,4,Malam
8382,2011-12-20,0,12,21,0,2,1,1,0.36,0.3636,0.66,0.0896,4,139,143,143,4,Malam
8383,2011-12-20,0,12,22,0,2,1,2,0.36,0.3788,0.66,0.0,3,104,107,107,4,Malam
8384,2011-12-20,0,12,23,0,2,1,2,0.38,0.3939,0.62,0.0,13,40,53,53,4,Malam
8385,2011-12-21,0,12,0,0,3,1,2,0.34,0.3333,0.71,0.1343,7,18,25,25,1,
8386,2011-12-21,0,12,1,0,3,1,2,0.36,0.3636,0.66,0.1045,1,10,11,11,1,Pagi
8387,2011-12-21,0,12,2,0,3,1,2,0.36,0.3788,0.71,0.0,0,4,4,4,1,Pagi
8388,2011-12-21,0,12,3,0,3,1,2,0.36,0.3788,0.71,0.0,0,2,2,2,1,Pagi
8389,2011-12-21,0,12,4,0,3,1,2,0.36,0.3788,0.71,0.0,0,2,2,2,1,Pagi
8390,2011-12-21,0,12,5,0,3,1,2,0.38,0.3939,0.82,0.1045,0,28,28,28,1,Pagi
8391,2011-12-21,0,12,6,0,3,1,2,0.36,0.3788,0.87,0.0,1,75,76,76,1,Pagi
8392,2011-12-21,0,12,7,0,3,1,2,0.36,0.3636,0.87,0.1045,5,224,229,229,1,Siang
8393,2011-12-21,0,12,8,0,3,1,3,0.36,0.3788,0.93,0.0,12,393,405,405,1,Siang
8394,2011-12-21,0,12,9,0,3,1,2,0.4,0.4091,0.87,0.2239,14,220,234,234,1,Siang
8395,2011-12-21,0,12,10,0,3,1,2,0.48,0.4697,0.82,0.4179,6,83,89,89,1,Siang
8396,2011-12-21,0,12,11,0,3,1,2,0.48,0.4697,0.82,0.4179,3,53,56,56,1,Siang
8397,2011-12-21,0,12,12,0,3,1,3,0.46,0.4545,0.88,0.3881,3,58,61,61,1,Siang
8398,2011-12-21,0,12,13,0,3,1,3,0.44,0.4394,0.94,0.2985,3,55,58,58,1,Sore
8399,2011-12-21,0,12,14,0,3,1,2,0.48,0.4697,0.88,0.3582,11,40,51,51,1,Sore
8400,2011-12-21,0,12,15,0,3,1,2,0.48,0.4697,0.88,0.3881,4,57,61,61,1,Sore
8401,2011-12-21,0,12,16,0,3,1,3,0.44,0.4394,1.0,0.3284,6,95,101,101,1,Sore
8402,2011-12-21,0,12,17,0,3,1,3,0.44,0.4394,1.0,0.3284,3,226,229,229,1,Sore
8403,2011-12-21,0,12,18,0,3,1,2,0.44,0.4394,1.0,0.2985,2,278,280,280,1,Sore
8404,2011-12-21,0,12,19,0,3,1,2,0.5,0.4848,0.94,0.3284,9,200,209,209,1,Malam
8405,2011-12-21,0,12,20,0,3,1,2,0.5,0.4848,0.94,0.3582,5,162,167,167,1,Malam
8406,2011-12-21,0,12,21,0,3,1,1,0.5,0.4848,0.88,0.2836,9,114,123,123,1,Malam
8407,2011-12-21,0,12,22,0,3,1,1,0.5,0.4848,0.88,0.2537,3,102,105,105,1,Malam
8408,2011-12-21,0,12,23,0,3,1,1,0.5,0.4848,0.88,0.194,0,54,54,54,1,Malam
8409,2011-12-22,0,12,0,0,4,1,2,0.5,0.4848,0.82,0.1045,3,24,27,27,1,
8410,2011-12-22,0,12,1,0,4,1,1,0.44,0.4394,0.94,0.0896,0,15,15,15,1,Pagi
8411,2011-12-22,0,12,2,0,4,1,1,0.48,0.4697,0.82,0.1045,1,10,11,11,1,Pagi
8412,2011-12-22,0,12,3,0,4,1,1,0.44,0.4394,0.67,0.1642,0,6,6,6,1,Pagi
8413,2011-12-22,0,12,4,0,4,1,1,0.38,0.3939,0.82,0.1343,0,3,3,3,1,Pagi
8414,2011-12-22,0,12,5,0,4,1,1,0.38,0.3939,0.82,0.0,1,15,16,16,1,Pagi
8415,2011-12-22,0,12,6,0,4,1,1,0.36,0.3788,0.87,0.0,1,63,64,64,1,Pagi
8416,2011-12-22,0,12,7,0,4,1,1,0.34,0.3636,0.93,0.0,4,182,186,186,1,Siang
8417,2011-12-22,0,12,8,0,4,1,2,0.36,0.3788,0.87,0.0,10,333,343,343,1,Siang
8418,2011-12-22,0,12,9,0,4,1,2,0.38,0.3939,0.87,0.0896,10,218,228,228,1,Siang
8419,2011-12-22,0,12,10,0,4,1,2,0.4,0.4091,0.82,0.0896,13,128,141,141,1,Siang
8420,2011-12-22,0,12,11,0,4,1,2,0.44,0.4394,0.77,0.0,10,135,145,145,1,Siang
8421,2011-12-22,0,12,12,0,4,1,2,0.48,0.4697,0.55,0.0,22,180,202,202,1,Siang
8422,2011-12-22,0,12,13,0,4,1,2,0.46,0.4545,0.63,0.0,21,167,188,188,1,Sore
8423,2011-12-22,0,12,14,0,4,1,2,0.46,0.4545,0.63,0.0,23,136,159,159,1,Sore
8424,2011-12-22,0,12,15,0,4,1,2,0.48,0.4697,0.59,0.0,28,186,214,214,1,Sore
8425,2011-12-22,0,12,16,0,4,1,2,0.46,0.4545,0.63,0.0,30,226,256,256,1,Sore
8426,2011-12-22,0,12,17,0,4,1,2,0.44,0.4394,0.67,0.1642,24,332,356,356,1,Sore
8427,2011-12-22,0,12,18,0,4,1,2,0.44,0.4394,0.62,0.0896,11,277,288,288,1,Sore
8428,2011-12-22,0,12,19,0,4,1,2,0.44,0.4394,0.62,0.0,12,130,142,142,1,Malam
8429,2011-12-22,0,12,20,0,4,1,3,0.42,0.4242,0.71,0.0,0,33,33,33,1,Malam
8430,2011-12-22,0,12,21,0,4,1,3,0.42,0.4242,0.71,0.0,2,15,17,17,1,Malam
8431,2011-12-22,0,12,22,0,4,1,3,0.36,0.3636,0.93,0.1045,0,17,17,17,1,Malam
8432,2011-12-22,0,12,23,0,4,1,3,0.4,0.4091,0.87,0.0,1,10,11,11,1,Malam
8433,2011-12-23,0,12,0,0,5,1,3,0.4,0.4091,0.87,0.194,2,7,9,9,1,
8434,2011-12-23,0,12,1,0,5,1,3,0.4,0.4091,0.87,0.194,1,11,12,12,1,Pagi
8435,2011-12-23,0,12,2,0,5,1,3,0.38,0.3939,0.94,0.1343,1,12,13,13,1,Pagi
8436,2011-12-23,0,12,3,0,5,1,3,0.38,0.3939,0.94,0.1343,0,4,4,4,1,Pagi
8437,2011-12-23,0,12,4,0,5,1,3,0.38,0.3939,0.94,0.2836,0,2,2,2,1,Pagi
8438,2011-12-23,0,12,5,0,5,1,1,0.36,0.3485,0.93,0.194,0,8,8,8,1,Pagi
8439,2011-12-23,0,12,6,0,5,1,1,0.38,0.3939,0.82,0.2537,0,40,40,40,1,Pagi
8440,2011-12-23,0,12,7,0,5,1,1,0.38,0.3939,0.82,0.2239,4,88,92,92,1,Siang
8441,2011-12-23,0,12,8,0,5,1,1,0.4,0.4091,0.76,0.2537,9,173,182,182,1,Siang
8442,2011-12-23,0,12,9,0,5,1,1,0.4,0.4091,0.66,0.2985,4,152,156,156,1,Siang
8443,2011-12-23,0,12,10,0,5,1,1,0.4,0.4091,0.62,0.3582,8,96,104,104,1,Siang
8444,2011-12-23,0,12,11,0,5,1,1,0.4,0.4091,0.58,0.4478,26,148,174,174,1,Siang
8445,2011-12-23,0,12,12,0,5,1,1,0.4,0.4091,0.54,0.5224,14,156,170,170,1,Siang
8446,2011-12-23,0,12,13,0,5,1,1,0.4,0.4091,0.5,0.4627,17,177,194,194,1,Sore
8447,2011-12-23,0,12,14,0,5,1,1,0.4,0.4091,0.54,0.4179,23,177,200,200,1,Sore
8448,2011-12-23,0,12,15,0,5,1,1,0.38,0.3939,0.54,0.3582,12,191,203,203,1,Sore
8449,2011-12-23,0,12,16,0,5,1,1,0.38,0.3939,0.5,0.2985,15,166,181,181,1,Sore
8450,2011-12-23,0,12,17,0,5,1,1,0.36,0.3485,0.53,0.2239,11,129,140,140,1,Sore
8451,2011-12-23,0,12,18,0,5,1,1,0.36,0.3333,0.5,0.2537,4,91,95,95,1,Sore
8452,2011-12-23,0,12,19,0,5,1,1,0.34,0.3333,0.53,0.194,1,75,76,76,1,Malam
8453,2011-12-23,0,12,20,0,5,1,1,0.32,0.303,0.61,0.3284,3,47,50,50,1,Malam
8454,2011-12-23,0,12,21,0,5,1,1,0.32,0.303,0.61,0.2239,0,32,32,32,1,Malam
8455,2011-12-23,0,12,22,0,5,1,1,0.32,0.3182,0.66,0.194,4,43,47,47,1,Malam
8456,2011-12-23,0,12,23,0,5,1,1,0.32,0.3333,0.66,0.1343,4,21,25,25,1,Malam
8457,2011-12-24,0,12,0,0,6,0,2,0.32,0.3182,0.7,0.1642,3,20,23,23,1,
8458,2011-12-24,0,12,1,0,6,0,2,0.32,0.3485,0.66,0.0,1,15,16,16,1,Pagi
8459,2011-12-24,0,12,2,0,6,0,2,0.32,0.3333,0.66,0.0896,4,22,26,26,1,Pagi
8460,2011-12-24,0,12,3,0,6,0,2,0.32,0.3333,0.7,0.0896,0,5,5,5,1,Pagi
8461,2011-12-24,0,12,4,0,6,0,2,0.32,0.3182,0.66,0.1642,0,3,3,3,1,Pagi
8462,2011-12-24,0,12,5,0,6,0,2,0.32,0.3182,0.66,0.1642,1,3,4,4,1,Pagi
8463,2011-12-24,0,12,6,0,6,0,2,0.3,0.303,0.75,0.1642,0,10,10,10,1,Pagi
8464,2011-12-24,0,12,7,0,6,0,1,0.3,0.2727,0.7,0.3582,0,10,10,10,1,Siang
8465,2011-12-24,0,12,8,0,6,0,1,0.28,0.2727,0.7,0.194,0,27,27,27,1,Siang
8466,2011-12-24,0,12,9,0,6,0,1,0.3,0.2727,0.45,0.4179,3,53,56,56,1,Siang
8467,2011-12-24,0,12,10,0,6,0,1,0.3,0.2576,0.42,0.4925,4,52,56,56,1,Siang
8468,2011-12-24,0,12,11,0,6,0,1,0.32,0.2879,0.39,0.3582,9,62,71,71,1,Siang
8469,2011-12-24,0,12,12,0,6,0,1,0.34,0.3182,0.39,0.2836,15,79,94,94,1,Siang
8470,2011-12-24,0,12,13,0,6,0,1,0.34,0.303,0.39,0.2985,24,97,121,121,1,Sore
8471,2011-12-24,0,12,14,0,6,0,1,0.34,0.303,0.39,0.2985,15,70,85,85,1,Sore
8472,2011-12-24,0,12,15,0,6,0,1,0.32,0.303,0.39,0.2239,15,82,97,97,1,Sore
8473,2011-12-24,0,12,16,0,6,0,1,0.32,0.3182,0.42,0.194,25,74,99,99,1,Sore
8474,2011-12-24,0,12,17,0,6,0,1,0.28,0.2879,0.45,0.1343,15,53,68,68,1,Sore
8475,2011-12-24,0,12,18,0,6,0,1,0.3,0.3182,0.42,0.0896,2,33,35,35,1,Sore
8476,2011-12-24,0,12,19,0,6,0,1,0.3,0.3182,0.52,0.0896,1,24,25,25,1,Malam
8477,2011-12-24,0,12,20,0,6,0,1,0.26,0.2727,0.56,0.1343,5,19,24,24,1,Malam
8478,2011-12-24,0,12,21,0,6,0,1,0.26,0.2576,0.56,0.1642,4,15,19,19,1,Malam
8479,2011-12-24,0,12,22,0,6,0,1,0.24,0.2879,0.52,0.0,8,12,20,20,1,Malam
8480,2011-12-24,0,12,23,0,6,0,1,0.24,0.2576,0.56,0.0,1,16,17,17,1,Malam
8481,2011-12-25,0,12,0,0,0,0,1,0.24,0.2273,0.6,0.194,2,4,6,6,1,
8482,2011-12-25,0,12,1,0,0,0,1,0.22,0.2273,0.69,0.1343,2,2,4,4,1,Pagi
8483,2011-12-25,0,12,2,0,0,0,1,0.22,0.2576,0.75,0.0896,0,2,2,2,1,Pagi
8484,2011-12-25,0,12,3,0,0,0,1,0.22,0.2727,0.72,0.0,1,3,4,4,1,Pagi
8485,2011-12-25,0,12,5,0,0,0,1,0.2,0.2273,0.75,0.1045,0,1,1,1,1,Pagi
8486,2011-12-25,0,12,6,0,0,0,1,0.2,0.2273,0.75,0.1045,0,1,1,1,1,Pagi
8487,2011-12-25,0,12,7,0,0,0,1,0.22,0.2424,0.8,0.1045,0,4,4,4,1,Siang
8488,2011-12-25,0,12,8,0,0,0,1,0.2,0.2121,0.8,0.1642,1,4,5,5,1,Siang
8489,2011-12-25,0,12,9,0,0,0,1,0.24,0.2424,0.87,0.1642,3,20,23,23,1,Siang
8490,2011-12-25,0,12,10,0,0,0,1,0.26,0.2424,0.81,0.2537,31,12,43,43,1,Siang
8491,2011-12-25,0,12,11,0,0,0,1,0.3,0.303,0.7,0.1642,43,42,85,85,1,Siang
8492,2011-12-25,0,12,12,0,0,0,1,0.3,0.2727,0.75,0.2985,25,41,66,66,1,Siang
8493,2011-12-25,0,12,13,0,0,0,1,0.32,0.303,0.7,0.2537,40,39,79,79,1,Sore
8494,2011-12-25,0,12,14,0,0,0,1,0.34,0.3182,0.61,0.2537,41,45,86,86,1,Sore
8495,2011-12-25,0,12,15,0,0,0,1,0.34,0.3333,0.61,0.194,43,48,91,91,1,Sore
8496,2011-12-25,0,12,16,0,0,0,1,0.36,0.3636,0.57,0.1045,35,51,86,86,1,Sore
8497,2011-12-25,0,12,17,0,0,0,1,0.34,0.3333,0.61,0.1343,11,33,44,44,1,Sore
8498,2011-12-25,0,12,18,0,0,0,1,0.32,0.3182,0.7,0.194,7,23,30,30,1,Sore
8499,2011-12-25,0,12,19,0,0,0,1,0.32,0.3333,0.57,0.1343,2,14,16,16,1,Malam
8500,2011-12-25,0,12,20,0,0,0,1,0.32,0.3333,0.49,0.0896,8,18,26,26,1,Malam
8501,2011-12-25,0,12,21,0,0,0,1,0.3,0.303,0.56,0.1343,4,15,19,19,1,Malam
8502,2011-12-25,0,12,22,0,0,0,1,0.28,0.2727,0.61,0.1642,2,15,17,17,1,Malam
8503,2011-12-25,0,12,23,0,0,0,1,0.26,0.2727,0.65,0.1343,2,14,16,16,1,Malam
8504,2011-12-26,0,12,0,1,1,0,1,0.22,0.2273,0.75,0.1642,5,6,11,11,1,
8505,2011-12-26,0,12,1,1,1,0,1,0.28,0.2727,0.56,0.194,3,7,10,10,1,Pagi
8506,2011-12-26,0,12,2,1,1,0,1,0.34,0.3182,0.46,0.2239,2,5,7,7,1,Pagi
8507,2011-12-26,0,12,4,1,1,0,1,0.34,0.303,0.46,0.2985,0,2,2,2,1,Pagi
8508,2011-12-26,0,12,5,1,1,0,1,0.34,0.303,0.42,0.3881,0,4,4,4,1,Pagi
8509,2011-12-26,0,12,6,1,1,0,1,0.32,0.303,0.45,0.2836,0,4,4,4,1,Pagi
8510,2011-12-26,0,12,7,1,1,0,1,0.32,0.3182,0.45,0.194,2,17,19,19,1,Siang
8511,2011-12-26,0,12,8,1,1,0,1,0.32,0.3333,0.45,0.1343,5,13,18,18,1,Siang
8512,2011-12-26,0,12,9,1,1,0,1,0.34,0.303,0.46,0.2985,24,38,62,62,1,Siang
8513,2011-12-26,0,12,10,1,1,0,1,0.34,0.2879,0.42,0.5224,31,39,70,70,1,Siang
8514,2011-12-26,0,12,11,1,1,0,1,0.34,0.2879,0.46,0.5821,40,51,91,91,1,Siang
8515,2011-12-26,0,12,12,1,1,0,1,0.36,0.3182,0.43,0.4627,34,66,100,100,1,Siang
8516,2011-12-26,0,12,13,1,1,0,1,0.38,0.3939,0.4,0.2985,57,83,140,140,1,Sore
8517,2011-12-26,0,12,14,1,1,0,1,0.38,0.3939,0.4,0.3284,73,80,153,153,1,Sore
8518,2011-12-26,0,12,15,1,1,0,1,0.38,0.3939,0.4,0.2537,26,105,131,131,1,Sore
8519,2011-12-26,0,12,16,1,1,0,1,0.36,0.3333,0.43,0.2836,28,69,97,97,1,Sore
8520,2011-12-26,0,12,17,1,1,0,1,0.34,0.3182,0.46,0.2239,30,67,97,97,1,Sore
8521,2011-12-26,0,12,18,1,1,0,1,0.32,0.3333,0.49,0.0896,21,54,75,75,1,Sore
8522,2011-12-26,0,12,19,1,1,0,1,0.3,0.3182,0.65,0.0896,16,49,65,65,1,Malam
8523,2011-12-26,0,12,20,1,1,0,1,0.3,0.3182,0.56,0.0896,14,42,56,56,1,Malam
8524,2011-12-26,0,12,21,1,1,0,1,0.26,0.303,0.7,0.0,10,39,49,49,1,Malam
8525,2011-12-26,0,12,22,1,1,0,1,0.26,0.303,0.7,0.0,5,22,27,27,1,Malam
8526,2011-12-26,0,12,23,1,1,0,1,0.26,0.2727,0.7,0.1045,4,25,29,29,1,Malam
8527,2011-12-27,0,12,0,0,2,1,1,0.26,0.2576,0.7,0.1642,3,9,12,12,1,
8528,2011-12-27,0,12,1,0,2,1,1,0.26,0.2727,0.7,0.1343,0,6,6,6,1,Pagi
8529,2011-12-27,0,12,2,0,2,1,1,0.26,0.2727,0.7,0.1343,2,2,4,4,1,Pagi
8530,2011-12-27,0,12,3,0,2,1,2,0.3,0.2879,0.61,0.2239,0,3,3,3,1,Pagi
8531,2011-12-27,0,12,4,0,2,1,2,0.3,0.2879,0.65,0.2239,0,3,3,3,1,Pagi
8532,2011-12-27,0,12,5,0,2,1,2,0.3,0.2727,0.64,0.2836,0,8,8,8,1,Pagi
8533,2011-12-27,0,12,6,0,2,1,2,0.3,0.2727,0.61,0.2985,0,35,35,35,1,Pagi
8534,2011-12-27,0,12,7,0,2,1,2,0.3,0.2879,0.65,0.2836,1,79,80,80,1,Siang
8535,2011-12-27,0,12,8,0,2,1,2,0.3,0.303,0.65,0.1642,9,155,164,164,1,Siang
8536,2011-12-27,0,12,9,0,2,1,3,0.32,0.3333,0.66,0.1045,19,85,104,104,1,Siang
8537,2011-12-27,0,12,10,0,2,1,2,0.32,0.3333,0.66,0.0896,13,47,60,60,1,Siang
8538,2011-12-27,0,12,11,0,2,1,3,0.32,0.3333,0.66,0.1045,6,24,30,30,1,Siang
8539,2011-12-27,0,12,12,0,2,1,3,0.3,0.3182,0.81,0.0896,8,16,24,24,1,Siang
8540,2011-12-27,0,12,13,0,2,1,3,0.3,0.303,0.87,0.1343,1,19,20,20,1,Sore
8541,2011-12-27,0,12,14,0,2,1,3,0.42,0.4242,0.82,0.3881,0,14,14,14,1,Sore
8542,2011-12-27,0,12,15,0,2,1,3,0.42,0.4242,0.82,0.3881,2,17,19,19,1,Sore
8543,2011-12-27,0,12,16,0,2,1,3,0.44,0.4394,0.88,0.3284,2,44,46,46,1,Sore
8544,2011-12-27,0,12,17,0,2,1,3,0.4,0.4091,0.87,0.1343,6,109,115,115,1,Sore
8545,2011-12-27,0,12,18,0,2,1,1,0.38,0.3939,0.87,0.2836,9,126,135,135,1,Sore
8546,2011-12-27,0,12,19,0,2,1,1,0.34,0.3333,0.87,0.1642,3,87,90,90,1,Malam
8547,2011-12-27,0,12,20,0,2,1,1,0.32,0.3333,0.93,0.0896,3,66,69,69,1,Malam
8548,2011-12-27,0,12,21,0,2,1,1,0.32,0.3333,0.87,0.0896,11,52,63,63,1,Malam
8549,2011-12-27,0,12,22,0,2,1,1,0.32,0.3333,0.87,0.0896,3,29,32,32,1,Malam
8550,2011-12-27,0,12,23,0,2,1,1,0.3,0.303,0.93,0.1343,2,24,26,26,1,Malam
8551,2011-12-28,0,12,0,0,3,1,1,0.32,0.3182,0.87,0.1642,0,10,10,10,1,
8552,2011-12-28,0,12,1,0,3,1,1,0.32,0.3182,0.76,0.1642,0,12,12,12,1,Pagi
8553,2011-12-28,0,12,2,0,3,1,1,0.32,0.303,0.61,0.2537,0,7,7,7,1,Pagi
8554,2011-12-28,0,12,3,0,3,1,1,0.32,0.303,0.61,0.2537,0,4,4,4,1,Pagi
8555,2011-12-28,0,12,5,0,3,1,1,0.32,0.2879,0.57,0.3582,0,9,9,9,1,Pagi
8556,2011-12-28,0,12,6,0,3,1,1,0.32,0.303,0.57,0.2537,1,42,43,43,1,Pagi
8557,2011-12-28,0,12,7,0,3,1,1,0.32,0.303,0.57,0.2537,4,106,110,110,1,Siang
8558,2011-12-28,0,12,8,0,3,1,1,0.32,0.2879,0.57,0.3582,11,206,217,217,1,Siang
8559,2011-12-28,0,12,9,0,3,1,1,0.32,0.303,0.57,0.3284,18,171,189,189,1,Siang
8560,2011-12-28,0,12,10,0,3,1,1,0.34,0.3182,0.57,0.2239,12,84,96,96,1,Siang
8561,2011-12-28,0,12,11,0,3,1,1,0.36,0.3333,0.46,0.3582,18,93,111,111,1,Siang
8562,2011-12-28,0,12,12,0,3,1,1,0.34,0.2879,0.46,0.5522,32,108,140,140,1,Siang
8563,2011-12-28,0,12,13,0,3,1,1,0.34,0.2879,0.39,0.4627,24,135,159,159,1,Sore
8564,2011-12-28,0,12,14,0,3,1,1,0.32,0.2879,0.39,0.3881,24,96,120,120,1,Sore
8565,2011-12-28,0,12,15,0,3,1,1,0.32,0.2879,0.36,0.4179,16,101,117,117,1,Sore
8566,2011-12-28,0,12,16,0,3,1,1,0.3,0.2727,0.36,0.4179,23,144,167,167,1,Sore
8567,2011-12-28,0,12,17,0,3,1,1,0.28,0.2727,0.38,0.2537,25,225,250,250,1,Sore
8568,2011-12-28,0,12,18,0,3,1,1,0.26,0.2273,0.38,0.3284,10,159,169,169,1,Sore
8569,2011-12-28,0,12,19,0,3,1,1,0.24,0.2273,0.41,0.2537,16,135,151,151,1,Malam
8570,2011-12-28,0,12,20,0,3,1,1,0.24,0.2273,0.41,0.2239,9,70,79,79,1,Malam
8571,2011-12-28,0,12,21,0,3,1,1,0.22,0.2273,0.44,0.1343,7,63,70,70,1,Malam
8572,2011-12-28,0,12,22,0,3,1,1,0.22,0.2424,0.44,0.1045,2,31,33,33,1,Malam
8573,2011-12-28,0,12,23,0,3,1,1,0.22,0.2121,0.44,0.2537,3,36,39,39,1,Malam
8574,2011-12-29,0,12,0,0,4,1,2,0.22,0.2273,0.47,0.194,4,24,28,28,1,
8575,2011-12-29,0,12,1,0,4,1,1,0.22,0.2121,0.47,0.2239,0,15,15,15,1,Pagi
8576,2011-12-29,0,12,2,0,4,1,1,0.2,0.2273,0.51,0.1045,0,3,3,3,1,Pagi
8577,2011-12-29,0,12,3,0,4,1,1,0.2,0.197,0.55,0.194,0,2,2,2,1,Pagi
8578,2011-12-29,0,12,4,0,4,1,1,0.2,0.2121,0.55,0.1642,1,2,3,3,1,Pagi
8579,2011-12-29,0,12,5,0,4,1,1,0.2,0.2273,0.55,0.1045,0,10,10,10,1,Pagi
8580,2011-12-29,0,12,6,0,4,1,1,0.2,0.2576,0.59,0.0,2,39,41,41,1,Pagi
8581,2011-12-29,0,12,7,0,4,1,1,0.18,0.2121,0.64,0.0896,2,104,106,106,1,Siang
8582,2011-12-29,0,12,8,0,4,1,2,0.2,0.2576,0.64,0.0,3,207,210,210,1,Siang
8583,2011-12-29,0,12,9,0,4,1,2,0.2,0.2121,0.64,0.1343,15,155,170,170,1,Siang
8584,2011-12-29,0,12,10,0,4,1,2,0.22,0.2273,0.64,0.1642,13,97,110,110,1,Siang
8585,2011-12-29,0,12,11,0,4,1,2,0.24,0.2576,0.6,0.0896,23,99,122,122,1,Siang
8586,2011-12-29,0,12,12,0,4,1,2,0.26,0.2727,0.56,0.1045,12,118,130,130,1,Siang
8587,2011-12-29,0,12,13,0,4,1,2,0.28,0.2879,0.52,0.1045,36,95,131,131,1,Sore
8588,2011-12-29,0,12,14,0,4,1,2,0.3,0.3333,0.52,0.0,30,112,142,142,1,Sore
8589,2011-12-29,0,12,15,0,4,1,2,0.3,0.3182,0.52,0.0896,27,150,177,177,1,Sore
8590,2011-12-29,0,12,16,0,4,1,1,0.3,0.303,0.52,0.1642,22,155,177,177,1,Sore
8591,2011-12-29,0,12,17,0,4,1,1,0.3,0.303,0.61,0.1642,14,226,240,240,1,Sore
8592,2011-12-29,0,12,18,0,4,1,1,0.3,0.303,0.56,0.1343,15,192,207,207,1,Sore
8593,2011-12-29,0,12,19,0,4,1,1,0.3,0.3182,0.56,0.1045,11,124,135,135,1,Malam
8594,2011-12-29,0,12,20,0,4,1,1,0.28,0.2879,0.65,0.1045,8,88,96,96,1,Malam
8595,2011-12-29,0,12,21,0,4,1,2,0.28,0.2879,0.61,0.1343,8,60,68,68,1,Malam
8596,2011-12-29,0,12,22,0,4,1,1,0.28,0.2879,0.65,0.1343,7,48,55,55,1,Malam
8597,2011-12-29,0,12,23,0,4,1,1,0.3,0.303,0.65,0.1642,1,44,45,45,1,Malam
8598,2011-12-30,0,12,0,0,5,1,1,0.28,0.2879,0.7,0.1343,4,26,30,30,1,
8599,2011-12-30,0,12,1,0,5,1,1,0.26,0.2879,0.65,0.0896,9,11,20,20,1,Pagi
8600,2011-12-30,0,12,2,0,5,1,1,0.24,0.2576,0.7,0.1045,2,10,12,12,1,Pagi
8601,2011-12-30,0,12,3,0,5,1,1,0.24,0.2576,0.7,0.1045,0,6,6,6,1,Pagi
8602,2011-12-30,0,12,4,0,5,1,1,0.24,0.2576,0.7,0.0896,0,2,2,2,1,Pagi
8603,2011-12-30,0,12,5,0,5,1,1,0.22,0.2576,0.75,0.0896,0,10,10,10,1,Pagi
8604,2011-12-30,0,12,6,0,5,1,1,0.24,0.2576,0.7,0.0896,1,31,32,32,1,Pagi
8605,2011-12-30,0,12,7,0,5,1,1,0.24,0.2576,0.75,0.0896,3,92,95,95,1,Siang
8606,2011-12-30,0,12,8,0,5,1,2,0.24,0.2576,0.75,0.0896,12,193,205,205,1,Siang
8607,2011-12-30,0,12,9,0,5,1,1,0.26,0.303,0.75,0.0,19,175,194,194,1,Siang
8608,2011-12-30,0,12,10,0,5,1,1,0.3,0.2879,0.65,0.2537,10,108,118,118,1,Siang
8609,2011-12-30,0,12,11,0,5,1,1,0.32,0.3182,0.66,0.194,45,126,171,171,1,Siang
8610,2011-12-30,0,12,12,0,5,1,1,0.32,0.3333,0.57,0.1343,38,159,197,197,1,Siang
8611,2011-12-30,0,12,13,0,5,1,2,0.36,0.3485,0.53,0.1343,53,154,207,207,1,Sore
8612,2011-12-30,0,12,14,0,5,1,2,0.4,0.4091,0.47,0.0896,67,178,245,245,1,Sore
8613,2011-12-30,0,12,15,0,5,1,1,0.42,0.4242,0.44,0.0,56,236,292,292,1,Sore
8614,2011-12-30,0,12,16,0,5,1,1,0.42,0.4242,0.47,0.194,36,247,283,283,1,Sore
8615,2011-12-30,0,12,17,0,5,1,1,0.38,0.3939,0.54,0.1642,54,188,242,242,1,Sore
8616,2011-12-30,0,12,18,0,5,1,1,0.36,0.3485,0.62,0.1343,19,163,182,182,1,Sore
8617,2011-12-30,0,12,19,0,5,1,2,0.34,0.303,0.49,0.4179,16,96,112,112,1,Malam
8618,2011-12-30,0,12,20,0,5,1,2,0.34,0.3485,0.66,0.1045,16,75,91,91,1,Malam
8619,2011-12-30,0,12,21,0,5,1,2,0.36,0.3636,0.66,0.1045,11,84,95,95,1,Malam
8620,2011-12-30,0,12,22,0,5,1,2,0.34,0.3333,0.71,0.1642,7,78,85,85,1,Malam
8621,2011-12-30,0,12,23,0,5,1,2,0.36,0.3333,0.66,0.2537,13,60,73,73,1,Malam
8622,2011-12-31,0,12,0,0,6,0,2,0.38,0.3939,0.62,0.3284,7,37,44,44,1,
8623,2011-12-31,0,12,1,0,6,0,2,0.4,0.4091,0.62,0.2836,4,31,35,35,1,Pagi
8624,2011-12-31,0,12,2,0,6,0,2,0.4,0.4091,0.62,0.2836,1,27,28,28,1,Pagi
8625,2011-12-31,0,12,3,0,6,0,2,0.4,0.4091,0.62,0.2836,1,17,18,18,1,Pagi
8626,2011-12-31,0,12,4,0,6,0,1,0.38,0.3939,0.71,0.2239,1,9,10,10,1,Pagi
8627,2011-12-31,0,12,5,0,6,0,2,0.36,0.3485,0.76,0.2239,1,0,1,1,1,Pagi
8628,2011-12-31,0,12,6,0,6,0,2,0.4,0.4091,0.71,0.0896,1,5,6,6,1,Pagi
8629,2011-12-31,0,12,7,0,6,0,3,0.38,0.3939,0.76,0.0,6,13,19,19,1,Siang
8630,2011-12-31,0,12,8,0,6,0,1,0.34,0.3333,0.81,0.1343,7,42,49,49,1,Siang
8631,2011-12-31,0,12,9,0,6,0,1,0.38,0.3939,0.76,0.0,18,72,90,90,1,Siang
8632,2011-12-31,0,12,10,0,6,0,1,0.4,0.4091,0.76,0.1642,20,108,128,128,1,Siang
8633,2011-12-31,0,12,11,0,6,0,1,0.42,0.4242,0.71,0.1642,65,152,217,217,1,Siang
8634,2011-12-31,0,12,12,0,6,0,1,0.52,0.5,0.39,0.2985,93,180,273,273,1,Siang
8635,2011-12-31,0,12,13,0,6,0,1,0.5,0.4848,0.42,0.4925,108,205,313,313,1,Sore
8636,2011-12-31,0,12,14,0,6,0,1,0.46,0.4545,0.51,0.3284,115,185,300,300,1,Sore
8637,2011-12-31,0,12,15,0,6,0,1,0.46,0.4545,0.47,0.4925,89,164,253,253,1,Sore
8638,2011-12-31,0,12,16,0,6,0,1,0.44,0.4394,0.51,0.3881,52,143,195,195,1,Sore
8639,2011-12-31,0,12,17,0,6,0,1,0.42,0.4242,0.54,0.194,28,101,129,129,1,Sore
8640,2011-12-31,0,12,18,0,6,0,1,0.42,0.4242,0.54,0.1343,13,80,93,93,1,Sore
8641,2011-12-31,0,12,19,0,6,0,1,0.42,0.4242,0.54,0.2239,19,73,92,92,1,Malam
8642,2011-12-31,0,12,20,0,6,0,1,0.42,0.4242,0.54,0.2239,8,63,71,71,1,Malam
8643,2011-12-31,0,12,21,0,6,0,1,0.4,0.4091,0.58,0.194,2,50,52,52,1,Malam
8644,2011-12-31,0,12,22,0,6,0,1,0.38,0.3939,0.62,0.1343,2,36,38,38,1,Malam
8645,2011-12-31,0,12,23,0,6,0,1,0.36,0.3788,0.66,0.0,4,27,31,31,1,Malam
8646,2012-01-01,1,1,0,0,0,0,1,0.36,0.3788,0.66,0.0,5,43,48,48,1,
8647,2012-01-01,1,1,1,0,0,0,1,0.36,0.3485,0.66,0.1343,15,78,93,93,1,Pagi
8648,2012-01-01,1,1,2,0,0,0,1,0.32,0.3485,0.76,0.0,16,59,75,75,1,Pagi
8649,2012-01-01,1,1,3,0,0,0,1,0.3,0.3333,0.81,0.0,11,41,52,52,1,Pagi
8650,2012-01-01,1,1,4,0,0,0,1,0.28,0.303,0.81,0.0896,0,8,8,8,1,Pagi
8651,2012-01-01,1,1,5,0,0,0,1,0.28,0.2879,0.81,0.1045,0,5,5,5,1,Pagi
8652,2012-01-01,1,1,6,0,0,0,1,0.26,0.2727,0.93,0.1343,1,1,2,2,1,Pagi
8653,2012-01-01,1,1,7,0,0,0,1,0.26,0.2576,0.93,0.1642,1,6,7,7,1,Siang
8654,2012-01-01,1,1,8,0,0,0,1,0.26,0.2727,0.87,0.1045,4,10,14,14,1,Siang
8655,2012-01-01,1,1,9,0,0,0,1,0.26,0.2727,0.93,0.1045,13,27,40,40,1,Siang
8656,2012-01-01,1,1,10,0,0,0,1,0.3,0.3182,0.81,0.1045,18,52,70,70,1,Siang
8657,2012-01-01,1,1,11,0,0,0,1,0.34,0.3333,0.76,0.1343,40,98,138,138,1,Siang
8658,2012-01-01,1,1,12,0,0,0,1,0.4,0.4091,0.62,0.2836,58,143,201,201,1,Siang
8659,2012-01-01,1,1,13,0,0,0,1,0.42,0.4242,0.58,0.2836,82,141,223,223,1,Sore
8660,2012-01-01,1,1,14,0,0,0,1,0.44,0.4394,0.54,0.2985,120,147,267,267,1,Sore
8661,2012-01-01,1,1,15,0,0,0,1,0.46,0.4545,0.51,0.2985,101,164,265,265,1,Sore
8662,2012-01-01,1,1,16,0,0,0,2,0.44,0.4394,0.54,0.2985,68,147,215,215,1,Sore
8663,2012-01-01,1,1,17,0,0,0,2,0.48,0.4697,0.48,0.1642,36,75,111,111,1,Sore
8664,2012-01-01,1,1,18,0,0,0,3,0.46,0.4545,0.59,0.2537,25,81,106,106,1,Sore
8665,2012-01-01,1,1,19,0,0,0,3,0.42,0.4242,0.67,0.3881,20,85,105,105,1,Malam
8666,2012-01-01,1,1,20,0,0,0,2,0.44,0.4394,0.62,0.2985,25,58,83,83,1,Malam
8667,2012-01-01,1,1,21,0,0,0,2,0.44,0.4394,0.67,0.2537,10,61,71,71,1,Malam
8668,2012-01-01,1,1,22,0,0,0,1,0.46,0.4545,0.55,0.4179,13,53,66,66,1,Malam
8669,2012-01-01,1,1,23,0,0,0,1,0.44,0.4394,0.51,0.2985,4,25,29,29,1,Malam
8670,2012-01-02,1,1,0,1,1,0,1,0.4,0.4091,0.4,0.4627,8,31,39,39,1,
8671,2012-01-02,1,1,1,1,1,0,1,0.36,0.3333,0.43,0.4179,1,11,12,12,1,Pagi
8672,2012-01-02,1,1,2,1,1,0,1,0.36,0.3182,0.34,0.4478,1,6,7,7,1,Pagi
8673,2012-01-02,1,1,4,1,1,0,1,0.28,0.2576,0.45,0.3284,0,4,4,4,1,Pagi
8674,2012-01-02,1,1,5,1,1,0,1,0.28,0.2576,0.45,0.3284,1,3,4,4,1,Pagi
8675,2012-01-02,1,1,6,1,1,0,1,0.26,0.2273,0.41,0.3881,0,14,14,14,1,Pagi
8676,2012-01-02,1,1,7,1,1,0,1,0.24,0.2121,0.32,0.3881,0,16,16,16,1,Siang
8677,2012-01-02,1,1,8,1,1,0,1,0.24,0.2273,0.35,0.2537,2,51,53,53,1,Siang
8678,2012-01-02,1,1,9,1,1,0,1,0.24,0.2576,0.35,0.0,15,53,68,68,1,Siang
8679,2012-01-02,1,1,10,1,1,0,1,0.26,0.2424,0.35,0.2836,20,89,109,109,1,Siang
8680,2012-01-02,1,1,11,1,1,0,1,0.26,0.2121,0.35,0.4925,33,142,175,175,1,Siang
8681,2012-01-02,1,1,12,1,1,0,1,0.28,0.2727,0.36,0.2537,41,161,202,202,1,Siang
8682,2012-01-02,1,1,13,1,1,0,1,0.3,0.2727,0.36,0.2985,26,150,176,176,1,Sore
8683,2012-01-02,1,1,14,1,1,0,1,0.3,0.2727,0.36,0.4179,10,141,151,151,1,Sore
8684,2012-01-02,1,1,15,1,1,0,1,0.28,0.2424,0.38,0.4478,29,139,168,168,1,Sore
8685,2012-01-02,1,1,16,1,1,0,1,0.26,0.2273,0.35,0.4179,10,144,154,154,1,Sore
8686,2012-01-02,1,1,17,1,1,0,1,0.26,0.2273,0.35,0.3881,17,136,153,153,1,Sore
8687,2012-01-02,1,1,18,1,1,0,1,0.26,0.2424,0.33,0.2537,13,113,126,126,1,Sore
8688,2012-01-02,1,1,19,1,1,0,1,0.24,0.2273,0.38,0.2239,4,89,93,93,1,Malam
8689,2012-01-02,1,1,20,1,1,0,1,0.24,0.2273,0.41,0.2239,5,83,88,88,1,Malam
8690,2012-01-02,1,1,21,1,1,0,2,0.24,0.2121,0.41,0.3284,3,63,66,66,1,Malam
8691,2012-01-02,1,1,22,1,1,0,2,0.22,0.2121,0.44,0.2836,3,36,39,39,1,Malam
8692,2012-01-02,1,1,23,1,1,0,1,0.22,0.2121,0.44,0.2537,2,32,34,34,1,Malam
8693,2012-01-03,1,1,0,0,2,1,1,0.2,0.197,0.51,0.2537,0,13,13,13,1,
8694,2012-01-03,1,1,1,0,2,1,1,0.18,0.1818,0.55,0.2239,1,5,6,6,1,Pagi
8695,2012-01-03,1,1,2,0,2,1,1,0.18,0.1667,0.51,0.2537,0,3,3,3,1,Pagi
8696,2012-01-03,1,1,3,0,2,1,1,0.16,0.1364,0.55,0.2836,0,2,2,2,1,Pagi
8697,2012-01-03,1,1,4,0,2,1,1,0.16,0.1515,0.55,0.2537,0,5,5,5,1,Pagi
8698,2012-01-03,1,1,5,0,2,1,1,0.14,0.1364,0.54,0.194,0,12,12,12,1,Pagi
8699,2012-01-03,1,1,6,0,2,1,1,0.14,0.1212,0.59,0.2836,4,81,85,85,1,Pagi
8700,2012-01-03,1,1,7,0,2,1,1,0.14,0.1212,0.59,0.2537,2,168,170,170,1,Siang
8701,2012-01-03,1,1,8,0,2,1,1,0.16,0.1364,0.55,0.2836,5,349,354,354,1,Siang
8702,2012-01-03,1,1,9,0,2,1,1,0.16,0.1364,0.5,0.2836,8,145,153,153,1,Siang
8703,2012-01-03,1,1,10,0,2,1,1,0.16,0.1212,0.47,0.4627,5,55,60,60,1,Siang
8704,2012-01-03,1,1,11,0,2,1,1,0.18,0.1364,0.37,0.5224,12,63,75,75,1,Siang
8705,2012-01-03,1,1,12,0,2,1,1,0.18,0.1364,0.37,0.5224,4,70,74,74,1,Siang
8706,2012-01-03,1,1,13,0,2,1,1,0.18,0.1212,0.34,0.6567,5,68,73,73,1,Sore
8707,2012-01-03,1,1,14,0,2,1,1,0.16,0.1212,0.43,0.5224,7,72,79,79,1,Sore
8708,2012-01-03,1,1,15,0,2,1,1,0.16,0.1212,0.37,0.4179,9,68,77,77,1,Sore
8709,2012-01-03,1,1,16,0,2,1,1,0.14,0.0909,0.39,0.5821,7,129,136,136,1,Sore
8710,2012-01-03,1,1,17,0,2,1,1,0.14,0.1061,0.26,0.4627,4,241,245,245,1,Sore
8711,2012-01-03,1,1,18,0,2,1,1,0.14,0.0909,0.26,0.5224,10,214,224,224,1,Sore
8712,2012-01-03,1,1,19,0,2,1,1,0.12,0.0909,0.28,0.4179,4,152,156,156,1,Malam
8713,2012-01-03,1,1,20,0,2,1,1,0.12,0.1212,0.33,0.2537,0,115,115,115,1,Malam
8714,2012-01-03,1,1,21,0,2,1,1,0.1,0.1061,0.36,0.2239,2,66,68,68,1,Malam
8715,2012-01-03,1,1,22,0,2,1,1,0.1,0.1061,0.46,0.2537,0,33,33,33,1,Malam
8716,2012-01-03,1,1,23,0,2,1,1,0.1,0.0758,0.46,0.3881,0,18,18,18,1,Malam
8717,2012-01-04,1,1,0,0,3,1,1,0.08,0.0606,0.42,0.3284,0,9,9,9,1,
8718,2012-01-04,1,1,1,0,3,1,1,0.04,0.0303,0.38,0.2985,0,3,3,3,1,Pagi
8719,2012-01-04,1,1,2,0,3,1,1,0.02,0.0152,0.34,0.2836,0,1,1,1,1,Pagi
8720,2012-01-04,1,1,3,0,3,1,1,0.02,0.0152,0.34,0.2836,0,1,1,1,1,Pagi
8721,2012-01-04,1,1,4,0,3,1,1,0.02,0.0455,0.41,0.194,0,2,2,2,1,Pagi
8722,2012-01-04,1,1,5,0,3,1,1,0.02,0.0455,0.41,0.194,0,14,14,14,1,Pagi
8723,2012-01-04,1,1,6,0,3,1,1,0.02,0.0455,0.41,0.1642,0,59,59,59,1,Pagi
8724,2012-01-04,1,1,7,0,3,1,1,0.02,0.0455,0.44,0.194,1,151,152,152,1,Siang
8725,2012-01-04,1,1,8,0,3,1,1,0.02,0.0606,0.44,0.1343,5,310,315,315,1,Siang
8726,2012-01-04,1,1,9,0,3,1,1,0.04,0.0606,0.45,0.1343,7,173,180,180,1,Siang
8727,2012-01-04,1,1,10,0,3,1,1,0.06,0.1061,0.45,0.0,7,57,64,64,1,Siang
8728,2012-01-04,1,1,11,0,3,1,2,0.08,0.1212,0.42,0.0896,6,40,46,46,1,Siang
8729,2012-01-04,1,1,12,0,3,1,2,0.1,0.1061,0.46,0.194,9,75,84,84,1,Siang
8730,2012-01-04,1,1,13,0,3,1,2,0.14,0.1212,0.43,0.2537,9,82,91,91,1,Sore
8731,2012-01-04,1,1,14,0,3,1,2,0.14,0.1212,0.46,0.2537,6,69,75,75,1,Sore
8732,2012-01-04,1,1,15,0,3,1,2,0.18,0.1515,0.37,0.3284,9,81,90,90,1,Sore
8733,2012-01-04,1,1,16,0,3,1,2,0.18,0.1667,0.4,0.2836,8,123,131,131,1,Sore
8734,2012-01-04,1,1,17,0,3,1,2,0.2,0.197,0.4,0.194,9,272,281,281,1,Sore
8735,2012-01-04,1,1,18,0,3,1,2,0.2,0.2121,0.37,0.1343,9,280,289,289,1,Sore
8736,2012-01-04,1,1,19,0,3,1,2,0.2,0.2273,0.4,0.1045,2,182,184,184,1,Malam
8737,2012-01-04,1,1,20,0,3,1,2,0.2,0.197,0.4,0.194,2,121,123,123,1,Malam
8738,2012-01-04,1,1,21,0,3,1,2,0.2,0.2576,0.44,0.0,2,88,90,90,1,Malam
8739,2012-01-04,1,1,22,0,3,1,2,0.2,0.2273,0.47,0.0896,4,48,52,52,1,Malam
8740,2012-01-04,1,1,23,0,3,1,2,0.2,0.2273,0.44,0.1045,0,32,32,32,1,Malam
8741,2012-01-05,1,1,0,0,4,1,2,0.22,0.2273,0.47,0.194,1,13,14,14,1,
8742,2012-01-05,1,1,1,0,4,1,1,0.2,0.2273,0.51,0.0896,0,5,5,5,1,Pagi
8743,2012-01-05,1,1,2,0,4,1,1,0.2,0.2273,0.51,0.0896,0,4,4,4,1,Pagi
8744,2012-01-05,1,1,3,0,4,1,1,0.2,0.2576,0.61,0.0,0,4,4,4,1,Pagi
8745,2012-01-05,1,1,4,0,4,1,2,0.2,0.2273,0.59,0.0896,0,5,5,5,1,Pagi
8746,2012-01-05,1,1,5,0,4,1,2,0.2,0.2273,0.59,0.0896,0,26,26,26,1,Pagi
8747,2012-01-05,1,1,6,0,4,1,2,0.2,0.2121,0.75,0.1343,0,78,78,78,1,Pagi
8748,2012-01-05,1,1,7,0,4,1,2,0.2,0.2273,0.69,0.0896,3,212,215,215,1,Siang
8749,2012-01-05,1,1,8,0,4,1,2,0.2,0.2576,0.75,0.0,11,377,388,388,1,Siang
8750,2012-01-05,1,1,9,0,4,1,2,0.22,0.2727,0.69,0.0,7,220,227,227,1,Siang
8751,2012-01-05,1,1,10,0,4,1,2,0.24,0.2576,0.52,0.0896,5,81,86,86,1,Siang
8752,2012-01-05,1,1,11,0,4,1,1,0.3,0.3333,0.49,0.0,6,78,84,84,1,Siang
8753,2012-01-05,1,1,12,0,4,1,1,0.3,0.2879,0.49,0.2537,6,114,120,120,1,Siang
8754,2012-01-05,1,1,13,0,4,1,1,0.34,0.303,0.42,0.2985,6,112,118,118,1,Sore
8755,2012-01-05,1,1,14,0,4,1,1,0.34,0.3182,0.39,0.2836,13,104,117,117,1,Sore
8756,2012-01-05,1,1,15,0,4,1,1,0.36,0.3333,0.34,0.2836,6,113,119,119,1,Sore
8757,2012-01-05,1,1,16,0,4,1,1,0.36,0.3333,0.34,0.2836,19,178,197,197,1,Sore
8758,2012-01-05,1,1,17,0,4,1,2,0.36,0.3485,0.34,0.194,19,393,412,412,1,Sore
8759,2012-01-05,1,1,18,0,4,1,1,0.34,0.3333,0.36,0.1642,9,374,383,383,1,Sore
8760,2012-01-05,1,1,19,0,4,1,1,0.34,0.3485,0.34,0.0896,10,255,265,265,1,Malam
8761,2012-01-05,1,1,20,0,4,1,1,0.3,0.3333,0.49,0.0,5,172,177,177,1,Malam
8762,2012-01-05,1,1,21,0,4,1,1,0.26,0.2727,0.6,0.1343,9,88,97,97,1,Malam
8763,2012-01-05,1,1,22,0,4,1,1,0.26,0.2576,0.6,0.1642,1,70,71,71,1,Malam
8764,2012-01-05,1,1,23,0,4,1,1,0.24,0.2576,0.7,0.1045,4,56,60,60,1,Malam
8765,2012-01-06,1,1,0,0,5,1,1,0.22,0.2576,0.75,0.0896,1,24,25,25,1,
8766,2012-01-06,1,1,1,0,5,1,1,0.22,0.2727,0.75,0.0,2,6,8,8,1,Pagi
8767,2012-01-06,1,1,2,0,5,1,1,0.22,0.2273,0.69,0.1642,2,3,5,5,1,Pagi
8768,2012-01-06,1,1,3,0,5,1,1,0.22,0.2424,0.69,0.1045,1,3,4,4,1,Pagi
8769,2012-01-06,1,1,4,0,5,1,1,0.22,0.2273,0.69,0.1343,0,3,3,3,1,Pagi
8770,2012-01-06,1,1,5,0,5,1,2,0.2,0.2121,0.8,0.1343,0,13,13,13,1,Pagi
8771,2012-01-06,1,1,6,0,5,1,2,0.22,0.2424,0.73,0.1045,1,69,70,70,1,Pagi
8772,2012-01-06,1,1,7,0,5,1,2,0.24,0.2879,0.65,0.0,4,201,205,205,1,Siang
8773,2012-01-06,1,1,8,0,5,1,1,0.24,0.2424,0.7,0.1343,11,436,447,447,1,Siang
8774,2012-01-06,1,1,9,0,5,1,1,0.24,0.2424,0.7,0.1642,4,237,241,241,1,Siang
8775,2012-01-06,1,1,10,0,5,1,1,0.26,0.2576,0.65,0.194,14,102,116,116,1,Siang
8776,2012-01-06,1,1,11,0,5,1,1,0.3,0.303,0.56,0.1642,8,130,138,138,1,Siang
8777,2012-01-06,1,1,12,0,5,1,1,0.36,0.3333,0.5,0.2537,23,168,191,191,1,Siang
8778,2012-01-06,1,1,13,0,5,1,1,0.4,0.4091,0.43,0.2836,16,188,204,204,1,Sore
8779,2012-01-06,1,1,14,0,5,1,1,0.46,0.4545,0.36,0.194,26,152,178,178,1,Sore
8780,2012-01-06,1,1,15,0,5,1,1,0.52,0.5,0.27,0.2537,44,178,222,222,1,Sore
8781,2012-01-06,1,1,16,0,5,1,1,0.52,0.5,0.27,0.2836,35,259,294,294,1,Sore
8782,2012-01-06,1,1,17,0,5,1,1,0.46,0.4545,0.36,0.2239,20,456,476,476,1,Sore
8783,2012-01-06,1,1,18,0,5,1,1,0.5,0.4848,0.29,0.2537,28,391,419,419,1,Sore
8784,2012-01-06,1,1,19,0,5,1,1,0.46,0.4545,0.33,0.2836,11,261,272,272,1,Malam
8785,2012-01-06,1,1,20,0,5,1,1,0.42,0.4242,0.41,0.194,14,163,177,177,1,Malam
8786,2012-01-06,1,1,21,0,5,1,1,0.4,0.4091,0.43,0.2239,17,137,154,154,1,Malam
8787,2012-01-06,1,1,22,0,5,1,1,0.36,0.3485,0.5,0.194,12,123,135,135,1,Malam
8788,2012-01-06,1,1,23,0,5,1,1,0.36,0.3788,0.5,0.0,13,88,101,101,1,Malam
8789,2012-01-07,1,1,0,0,6,0,1,0.36,0.3485,0.5,0.1642,2,77,79,79,1,
8790,2012-01-07,1,1,1,0,6,0,1,0.38,0.3939,0.46,0.1642,6,56,62,62,1,Pagi
8791,2012-01-07,1,1,2,0,6,0,1,0.36,0.3636,0.5,0.1045,2,36,38,38,1,Pagi
8792,2012-01-07,1,1,3,0,6,0,1,0.32,0.3333,0.57,0.1045,1,19,20,20,1,Pagi
8793,2012-01-07,1,1,4,0,6,0,1,0.32,0.3333,0.57,0.0896,1,9,10,10,1,Pagi
8794,2012-01-07,1,1,5,0,6,0,1,0.26,0.2727,0.75,0.1045,2,7,9,9,1,Pagi
8795,2012-01-07,1,1,6,0,6,0,1,0.26,0.2727,0.75,0.1045,0,7,7,7,1,Pagi
8796,2012-01-07,1,1,7,0,6,0,1,0.22,0.2273,0.87,0.194,0,20,20,20,1,Siang
8797,2012-01-07,1,1,8,0,6,0,1,0.24,0.2576,0.75,0.1045,0,64,64,64,1,Siang
8798,2012-01-07,1,1,9,0,6,0,1,0.22,0.2273,0.8,0.1343,14,116,130,130,1,Siang
8799,2012-01-07,1,1,10,0,6,0,1,0.28,0.303,0.75,0.0896,43,160,203,203,1,Siang
8800,2012-01-07,1,1,11,0,6,0,1,0.34,0.3182,0.57,0.2239,74,250,324,324,1,Siang
8801,2012-01-07,1,1,12,0,6,0,1,0.4,0.4091,0.43,0.2239,100,276,376,376,1,Siang
8802,2012-01-07,1,1,13,0,6,0,1,0.44,0.4394,0.44,0.194,149,296,445,445,1,Sore
8803,2012-01-07,1,1,14,0,6,0,1,0.5,0.4848,0.42,0.2836,156,356,512,512,1,Sore
8804,2012-01-07,1,1,15,0,6,0,1,0.58,0.5455,0.37,0.2985,132,317,449,449,1,Sore
8805,2012-01-07,1,1,16,0,6,0,2,0.56,0.5303,0.37,0.2836,133,268,401,401,1,Sore
8806,2012-01-07,1,1,17,0,6,0,2,0.54,0.5152,0.43,0.1343,87,235,322,322,1,Sore
8807,2012-01-07,1,1,18,0,6,0,1,0.54,0.5152,0.45,0.1343,49,248,297,297,1,Sore
8808,2012-01-07,1,1,19,0,6,0,1,0.52,0.5,0.42,0.1045,44,171,215,215,1,Malam
8809,2012-01-07,1,1,20,0,6,0,1,0.5,0.4848,0.39,0.2537,21,149,170,170,1,Malam
8810,2012-01-07,1,1,21,0,6,0,1,0.44,0.4394,0.44,0.2239,22,118,140,140,1,Malam
8811,2012-01-07,1,1,22,0,6,0,1,0.44,0.4394,0.38,0.2537,16,93,109,109,1,Malam
8812,2012-01-07,1,1,23,0,6,0,1,0.42,0.4242,0.38,0.2239,16,103,119,119,1,Malam
8813,2012-01-08,1,1,0,0,0,0,1,0.38,0.3939,0.4,0.2836,14,77,91,91,1,
8814,2012-01-08,1,1,1,0,0,0,1,0.34,0.3333,0.42,0.194,10,62,72,72,1,Pagi
8815,2012-01-08,1,1,2,0,0,0,1,0.36,0.3333,0.37,0.2836,10,57,67,67,1,Pagi
8816,2012-01-08,1,1,3,0,0,0,1,0.34,0.3333,0.42,0.1343,6,26,32,32,1,Pagi
8817,2012-01-08,1,1,4,0,0,0,1,0.32,0.303,0.49,0.2537,2,4,6,6,1,Pagi
8818,2012-01-08,1,1,5,0,0,0,2,0.32,0.3333,0.49,0.1045,0,2,2,2,1,Pagi
8819,2012-01-08,1,1,6,0,0,0,2,0.3,0.3333,0.52,0.0,0,2,2,2,1,Pagi
8820,2012-01-08,1,1,7,0,0,0,2,0.3,0.3333,0.52,0.0,1,23,24,24,1,Siang
8821,2012-01-08,1,1,8,0,0,0,1,0.3,0.303,0.52,0.1343,4,53,57,57,1,Siang
8822,2012-01-08,1,1,9,0,0,0,1,0.32,0.3333,0.53,0.1343,23,102,125,125,1,Siang
8823,2012-01-08,1,1,10,0,0,0,1,0.34,0.3333,0.49,0.1642,27,181,208,208,1,Siang
8824,2012-01-08,1,1,11,0,0,0,1,0.36,0.3485,0.46,0.2239,55,201,256,256,1,Siang
8825,2012-01-08,1,1,12,0,0,0,1,0.38,0.3939,0.43,0.2239,78,273,351,351,1,Siang
8826,2012-01-08,1,1,13,0,0,0,1,0.4,0.4091,0.37,0.2985,77,266,343,343,1,Sore
8827,2012-01-08,1,1,14,0,0,0,1,0.4,0.4091,0.4,0.194,75,253,328,328,1,Sore
8828,2012-01-08,1,1,15,0,0,0,1,0.4,0.4091,0.37,0.2836,89,241,330,330,1,Sore
8829,2012-01-08,1,1,16,0,0,0,1,0.4,0.4091,0.37,0.2985,58,256,314,314,1,Sore
8830,2012-01-08,1,1,17,0,0,0,1,0.38,0.3939,0.4,0.2239,22,197,219,219,1,Sore
8831,2012-01-08,1,1,18,0,0,0,1,0.34,0.3182,0.46,0.2239,19,162,181,181,1,Sore
8832,2012-01-08,1,1,19,0,0,0,1,0.32,0.3182,0.49,0.194,8,104,112,112,1,Malam
8833,2012-01-08,1,1,20,0,0,0,1,0.3,0.303,0.52,0.1642,7,119,126,126,1,Malam
8834,2012-01-08,1,1,21,0,0,0,1,0.28,0.2727,0.56,0.2239,10,81,91,91,1,Malam
8835,2012-01-08,1,1,22,0,0,0,1,0.26,0.2727,0.6,0.1045,4,54,58,58,1,Malam
8836,2012-01-08,1,1,23,0,0,0,1,0.26,0.2424,0.56,0.2537,0,30,30,30,1,Malam
8837,2012-01-09,1,1,0,0,1,1,1,0.24,0.2273,0.6,0.2239,3,12,15,15,1,
8838,2012-01-09,1,1,1,0,1,1,1,0.24,0.2424,0.6,0.1343,1,4,5,5,1,Pagi
8839,2012-01-09,1,1,2,0,1,1,1,0.24,0.2424,0.56,0.1343,2,3,5,5,1,Pagi
8840,2012-01-09,1,1,3,0,1,1,1,0.24,0.2424,0.52,0.1642,0,3,3,3,1,Pagi
8841,2012-01-09,1,1,4,0,1,1,1,0.22,0.2424,0.64,0.1045,0,4,4,4,1,Pagi
8842,2012-01-09,1,1,5,0,1,1,2,0.2,0.2273,0.64,0.0896,0,21,21,21,1,Pagi
8843,2012-01-09,1,1,6,0,1,1,2,0.22,0.2273,0.6,0.1343,3,85,88,88,1,Pagi
8844,2012-01-09,1,1,7,0,1,1,2,0.22,0.2424,0.6,0.1045,1,239,240,240,1,Siang
8845,2012-01-09,1,1,8,0,1,1,2,0.22,0.2576,0.55,0.0896,13,407,420,420,1,Siang
8846,2012-01-09,1,1,9,0,1,1,2,0.22,0.2727,0.64,0.0,9,188,197,197,1,Siang
8847,2012-01-09,1,1,10,0,1,1,1,0.24,0.2879,0.6,0.0,13,95,108,108,1,Siang
8848,2012-01-09,1,1,11,0,1,1,2,0.26,0.2879,0.56,0.0896,6,82,88,88,1,Siang
8849,2012-01-09,1,1,12,0,1,1,2,0.26,0.2727,0.56,0.1045,10,93,103,103,1,Siang
8850,2012-01-09,1,1,13,0,1,1,2,0.26,0.2727,0.56,0.1045,3,77,80,80,1,Sore
8851,2012-01-09,1,1,14,0,1,1,3,0.22,0.2273,0.75,0.1642,5,45,50,50,1,Sore
8852,2012-01-09,1,1,15,0,1,1,3,0.22,0.2273,0.75,0.1642,5,64,69,69,1,Sore
8853,2012-01-09,1,1,16,0,1,1,3,0.22,0.2576,0.87,0.0896,3,46,49,49,1,Sore
8854,2012-01-09,1,1,17,0,1,1,3,0.22,0.2727,0.87,0.0,5,147,152,152,1,Sore
8855,2012-01-09,1,1,18,0,1,1,4,0.2,0.2273,0.86,0.0896,6,158,164,164,1,Sore
8856,2012-01-09,1,1,19,0,1,1,3,0.2,0.2273,0.93,0.0896,3,187,190,190,1,Malam
8857,2012-01-09,1,1,20,0,1,1,2,0.2,0.2273,0.86,0.0896,5,127,132,132,1,Malam
8858,2012-01-09,1,1,21,0,1,1,2,0.2,0.2576,0.93,0.0,1,78,79,79,1,Malam
8859,2012-01-09,1,1,22,0,1,1,2,0.2,0.2273,0.92,0.1045,8,54,62,62,1,Malam
8860,2012-01-09,1,1,23,0,1,1,2,0.22,0.2424,0.87,0.1045,1,51,52,52,1,Malam
8861,2012-01-10,1,1,0,0,2,1,2,0.22,0.2424,0.87,0.1045,0,14,14,14,1,
8862,2012-01-10,1,1,1,0,2,1,2,0.22,0.2424,0.93,0.1045,2,3,5,5,1,Pagi
8863,2012-01-10,1,1,2,0,2,1,2,0.22,0.2273,0.87,0.1642,2,2,4,4,1,Pagi
8864,2012-01-10,1,1,4,0,2,1,2,0.2,0.2121,0.86,0.1642,0,4,4,4,1,Pagi
8865,2012-01-10,1,1,5,0,2,1,1,0.4,0.4091,0.47,0.2239,0,23,23,23,1,Pagi
8866,2012-01-10,1,1,6,0,2,1,2,0.18,0.1818,0.93,0.194,0,79,79,79,1,Pagi
8867,2012-01-10,1,1,7,0,2,1,2,0.18,0.197,0.93,0.1642,3,219,222,222,1,Siang
8868,2012-01-10,1,1,8,0,2,1,2,0.18,0.197,0.93,0.1642,6,465,471,471,1,Siang
8869,2012-01-10,1,1,9,0,2,1,2,0.18,0.197,0.93,0.1642,11,184,195,195,1,Siang
8870,2012-01-10,1,1,10,0,2,1,2,0.18,0.197,0.93,0.1642,3,80,83,83,1,Siang
8871,2012-01-10,1,1,11,0,2,1,1,0.42,0.4242,0.38,0.2985,8,93,101,101,1,Siang
8872,2012-01-10,1,1,12,0,2,1,1,0.42,0.4242,0.38,0.2985,13,127,140,140,1,Siang
8873,2012-01-10,1,1,13,0,2,1,1,0.42,0.4242,0.38,0.2985,15,163,178,178,1,Sore
8874,2012-01-10,1,1,14,0,2,1,1,0.42,0.4242,0.38,0.2985,10,96,106,106,1,Sore
8875,2012-01-10,1,1,15,0,2,1,1,0.42,0.4242,0.38,0.2985,17,119,136,136,1,Sore
8876,2012-01-10,1,1,16,0,2,1,1,0.42,0.4242,0.38,0.3582,15,225,240,240,1,Sore
8877,2012-01-10,1,1,17,0,2,1,1,0.42,0.4242,0.38,0.2537,14,446,460,460,1,Sore
8878,2012-01-10,1,1,18,0,2,1,1,0.4,0.4091,0.4,0.1045,13,372,385,385,1,Sore
8879,2012-01-10,1,1,19,0,2,1,1,0.38,0.3939,0.46,0.1045,11,270,281,281,1,Malam
8880,2012-01-10,1,1,20,0,2,1,1,0.34,0.3485,0.53,0.1045,10,190,200,200,1,Malam
8881,2012-01-10,1,1,21,0,2,1,1,0.32,0.3333,0.66,0.0896,7,109,116,116,1,Malam
8882,2012-01-10,1,1,22,0,2,1,1,0.3,0.303,0.7,0.0896,10,104,114,114,1,Malam
8883,2012-01-10,1,1,23,0,2,1,1,0.26,0.2727,0.81,0.1045,3,38,41,41,1,Malam
8884,2012-01-11,1,1,0,0,3,1,1,0.26,0.303,0.81,0.0,2,26,28,28,1,
8885,2012-01-11,1,1,1,0,3,1,1,0.24,0.2576,0.87,0.0896,1,6,7,7,1,Pagi
8886,2012-01-11,1,1,2,0,3,1,1,0.2,0.2121,0.85,0.1642,0,5,5,5,1,Pagi
8887,2012-01-11,1,1,3,0,3,1,1,0.22,0.2727,0.8,0.0,0,4,4,4,1,Pagi
8888,2012-01-11,1,1,4,0,3,1,1,0.2,0.2121,0.8,0.1343,0,2,2,2,1,Pagi
8889,2012-01-11,1,1,5,0,3,1,1,0.2,0.2121,0.8,0.1343,0,22,22,22,1,Pagi
8890,2012-01-11,1,1,6,0,3,1,1,0.2,0.2121,0.86,0.1343,2,72,74,74,1,Pagi
8891,2012-01-11,1,1,7,0,3,1,1,0.2,0.2121,0.8,0.1343,9,247,256,256,1,Siang
8892,2012-01-11,1,1,8,0,3,1,1,0.2,0.2273,0.82,0.1045,11,488,499,499,1,Siang
8893,2012-01-11,1,1,9,0,3,1,2,0.2,0.2121,0.86,0.1343,7,218,225,225,1,Siang
8894,2012-01-11,1,1,10,0,3,1,2,0.24,0.2424,0.87,0.1343,13,84,97,97,1,Siang
8895,2012-01-11,1,1,11,0,3,1,2,0.26,0.2879,0.87,0.0896,9,90,99,99,1,Siang
8896,2012-01-11,1,1,12,0,3,1,3,0.3,0.3333,0.81,0.0,4,51,55,55,1,Siang
8897,2012-01-11,1,1,13,0,3,1,3,0.32,0.3485,0.76,0.0,8,57,65,65,1,Sore
8898,2012-01-11,1,1,14,0,3,1,3,0.32,0.3333,0.81,0.1045,3,70,73,73,1,Sore
8899,2012-01-11,1,1,15,0,3,1,2,0.34,0.3485,0.87,0.0896,6,73,79,79,1,Sore
8900,2012-01-11,1,1,16,0,3,1,2,0.34,0.3182,0.87,0.2537,6,112,118,118,1,Sore
8901,2012-01-11,1,1,17,0,3,1,3,0.34,0.3182,0.87,0.2239,6,128,134,134,1,Sore
8902,2012-01-11,1,1,18,0,3,1,3,0.34,0.3333,0.87,0.194,2,96,98,98,1,Sore
8903,2012-01-11,1,1,19,0,3,1,3,0.32,0.303,0.93,0.2239,1,92,93,93,1,Malam
8904,2012-01-11,1,1,20,0,3,1,3,0.32,0.3182,0.93,0.1642,2,55,57,57,1,Malam
8905,2012-01-11,1,1,21,0,3,1,3,0.34,0.3182,0.87,0.2239,0,29,29,29,1,Malam
8906,2012-01-11,1,1,22,0,3,1,3,0.34,0.3333,0.87,0.194,0,49,49,49,1,Malam
8907,2012-01-11,1,1,23,0,3,1,3,0.34,0.3182,0.87,0.2239,0,9,9,9,1,Malam
8908,2012-01-12,1,1,0,0,4,1,3,0.34,0.3333,0.93,0.194,0,3,3,3,1,
8909,2012-01-12,1,1,1,0,4,1,3,0.36,0.3485,0.93,0.194,0,3,3,3,1,Pagi
8910,2012-01-12,1,1,2,0,4,1,3,0.36,0.3485,0.93,0.2537,1,1,2,2,1,Pagi
8911,2012-01-12,1,1,3,0,4,1,3,0.36,0.3485,0.93,0.2537,0,3,3,3,1,Pagi
8912,2012-01-12,1,1,4,0,4,1,3,0.36,0.3485,0.93,0.194,0,2,2,2,1,Pagi
8913,2012-01-12,1,1,5,0,4,1,3,0.34,0.3485,0.93,0.0896,0,16,16,16,1,Pagi
8914,2012-01-12,1,1,6,0,4,1,3,0.36,0.3485,0.93,0.1343,1,88,89,89,1,Pagi
8915,2012-01-12,1,1,7,0,4,1,2,0.34,0.3182,0.87,0.2836,2,218,220,220,1,Siang
8916,2012-01-12,1,1,8,0,4,1,1,0.32,0.3182,0.81,0.194,11,497,508,508,1,Siang
8917,2012-01-12,1,1,9,0,4,1,1,0.32,0.3333,0.81,0.1045,10,220,230,230,1,Siang
8918,2012-01-12,1,1,10,0,4,1,1,0.34,0.3485,0.81,0.1045,6,84,90,90,1,Siang
8919,2012-01-12,1,1,11,0,4,1,2,0.34,0.3485,0.81,0.1045,18,101,119,119,1,Siang
8920,2012-01-12,1,1,12,0,4,1,2,0.34,0.3485,0.81,0.1045,14,130,144,144,1,Siang
8921,2012-01-12,1,1,13,0,4,1,1,0.42,0.4242,0.77,0.1642,13,170,183,183,1,Sore
8922,2012-01-12,1,1,14,0,4,1,1,0.42,0.4242,0.77,0.1642,24,132,156,156,1,Sore
8923,2012-01-12,1,1,15,0,4,1,1,0.44,0.4394,0.72,0.1343,32,156,188,188,1,Sore
8924,2012-01-12,1,1,16,0,4,1,1,0.46,0.4545,0.67,0.194,33,248,281,281,1,Sore
8925,2012-01-12,1,1,17,0,4,1,1,0.46,0.4545,0.63,0.1642,23,472,495,495,1,Sore
8926,2012-01-12,1,1,18,0,4,1,1,0.44,0.4394,0.67,0.194,22,399,421,421,1,Sore
8927,2012-01-12,1,1,19,0,4,1,2,0.42,0.4242,0.71,0.1642,17,313,330,330,1,Malam
8928,2012-01-12,1,1,20,0,4,1,2,0.42,0.4242,0.71,0.194,11,229,240,240,1,Malam
8929,2012-01-12,1,1,21,0,4,1,1,0.44,0.4394,0.67,0.1343,12,162,174,174,1,Malam
8930,2012-01-12,1,1,22,0,4,1,1,0.38,0.3939,0.76,0.2985,12,121,133,133,1,Malam
8931,2012-01-12,1,1,23,0,4,1,1,0.4,0.4091,0.76,0.3284,7,60,67,67,1,Malam
8932,2012-01-13,1,1,0,0,5,1,2,0.4,0.4091,0.71,0.2836,4,38,42,42,1,
8933,2012-01-13,1,1,1,0,5,1,2,0.38,0.3939,0.76,0.2985,0,12,12,12,1,Pagi
8934,2012-01-13,1,1,2,0,5,1,1,0.4,0.4091,0.76,0.3582,1,13,14,14,1,Pagi
8935,2012-01-13,1,1,3,0,5,1,1,0.36,0.3333,0.87,0.2537,3,4,7,7,1,Pagi
8936,2012-01-13,1,1,4,0,5,1,3,0.32,0.2879,0.7,0.4925,1,2,3,3,1,Pagi
8937,2012-01-13,1,1,5,0,5,1,2,0.3,0.2424,0.7,0.5522,0,21,21,21,1,Pagi
8938,2012-01-13,1,1,6,0,5,1,2,0.26,0.2576,0.75,0.2239,2,71,73,73,1,Pagi
8939,2012-01-13,1,1,7,0,5,1,1,0.26,0.2576,0.6,0.2239,3,174,177,177,1,Siang
8940,2012-01-13,1,1,8,0,5,1,1,0.24,0.2121,0.52,0.3582,11,408,419,419,1,Siang
8941,2012-01-13,1,1,9,0,5,1,1,0.22,0.197,0.47,0.3881,10,204,214,214,1,Siang
8942,2012-01-13,1,1,10,0,5,1,1,0.24,0.197,0.44,0.4478,2,101,103,103,1,Siang
8943,2012-01-13,1,1,11,0,5,1,1,0.24,0.1818,0.38,0.6119,12,102,114,114,1,Siang
8944,2012-01-13,1,1,12,0,5,1,1,0.24,0.197,0.38,0.4925,14,140,154,154,1,Siang
8945,2012-01-13,1,1,13,0,5,1,1,0.26,0.2121,0.33,0.5224,14,140,154,154,1,Sore
8946,2012-01-13,1,1,14,0,5,1,1,0.26,0.2121,0.33,0.5522,10,119,129,129,1,Sore
8947,2012-01-13,1,1,15,0,5,1,1,0.26,0.2121,0.33,0.5821,15,123,138,138,1,Sore
8948,2012-01-13,1,1,16,0,5,1,1,0.28,0.2424,0.3,0.4627,18,215,233,233,1,Sore
8949,2012-01-13,1,1,17,0,5,1,1,0.28,0.2424,0.33,0.4179,15,317,332,332,1,Sore
8950,2012-01-13,1,1,18,0,5,1,1,0.26,0.2273,0.38,0.2985,7,294,301,301,1,Sore
8951,2012-01-13,1,1,19,0,5,1,1,0.26,0.2424,0.38,0.2836,7,199,206,206,1,Malam
8952,2012-01-13,1,1,20,0,5,1,1,0.24,0.2424,0.41,0.1642,6,130,136,136,1,Malam
8953,2012-01-13,1,1,21,0,5,1,1,0.24,0.2121,0.41,0.2836,7,95,102,102,1,Malam
8954,2012-01-13,1,1,22,0,5,1,1,0.2,0.1818,0.47,0.3284,7,58,65,65,1,Malam
8955,2012-01-13,1,1,23,0,5,1,1,0.18,0.1818,0.47,0.194,5,60,65,65,1,Malam
8956,2012-01-14,1,1,0,0,6,0,1,0.16,0.1818,0.47,0.1045,2,42,44,44,1,
8957,2012-01-14,1,1,1,0,6,0,1,0.16,0.1515,0.47,0.194,6,44,50,50,1,Pagi
8958,2012-01-14,1,1,2,0,6,0,1,0.16,0.1667,0.47,0.1642,6,32,38,38,1,Pagi
8959,2012-01-14,1,1,3,0,6,0,1,0.14,0.1667,0.54,0.1045,6,14,20,20,1,Pagi
8960,2012-01-14,1,1,4,0,6,0,1,0.14,0.1515,0.5,0.1343,0,3,3,3,1,Pagi
8961,2012-01-14,1,1,5,0,6,0,1,0.14,0.1515,0.5,0.1343,0,4,4,4,1,Pagi
8962,2012-01-14,1,1,6,0,6,0,1,0.14,0.1515,0.5,0.0,0,5,5,5,1,Pagi
8963,2012-01-14,1,1,7,0,6,0,1,0.14,0.1515,0.5,0.1343,0,24,24,24,1,Siang
8964,2012-01-14,1,1,8,0,6,0,1,0.12,0.1515,0.54,0.1045,3,89,92,92,1,Siang
8965,2012-01-14,1,1,9,0,6,0,1,0.14,0.1667,0.5,0.1045,3,78,81,81,1,Siang
8966,2012-01-14,1,1,10,0,6,0,1,0.16,0.2273,0.47,0.0,14,135,149,149,1,Siang
8967,2012-01-14,1,1,11,0,6,0,1,0.2,0.197,0.4,0.194,28,150,178,178,1,Siang
8968,2012-01-14,1,1,12,0,6,0,1,0.22,0.2121,0.41,0.2537,30,189,219,219,1,Siang
8969,2012-01-14,1,1,13,0,6,0,1,0.22,0.2121,0.44,0.2836,38,182,220,220,1,Sore
8970,2012-01-14,1,1,14,0,6,0,1,0.24,0.2121,0.41,0.2985,52,179,231,231,1,Sore
8971,2012-01-14,1,1,15,0,6,0,1,0.24,0.2121,0.38,0.2985,49,177,226,226,1,Sore
8972,2012-01-14,1,1,16,0,6,0,1,0.24,0.2273,0.38,0.2239,28,178,206,206,1,Sore
8973,2012-01-14,1,1,17,0,6,0,1,0.24,0.2273,0.41,0.2537,15,129,144,144,1,Sore
8974,2012-01-14,1,1,18,0,6,0,1,0.22,0.2273,0.41,0.194,21,122,143,143,1,Sore
8975,2012-01-14,1,1,19,0,6,0,1,0.2,0.197,0.47,0.2239,12,90,102,102,1,Malam
8976,2012-01-14,1,1,20,0,6,0,1,0.2,0.197,0.44,0.2537,8,95,103,103,1,Malam
8977,2012-01-14,1,1,21,0,6,0,1,0.18,0.1667,0.43,0.2537,3,66,69,69,1,Malam
8978,2012-01-14,1,1,22,0,6,0,1,0.16,0.1364,0.47,0.3582,4,62,66,66,1,Malam
8979,2012-01-14,1,1,23,0,6,0,1,0.16,0.1515,0.47,0.2239,5,71,76,76,1,Malam
8980,2012-01-15,1,1,0,0,0,0,1,0.16,0.1364,0.47,0.3284,9,50,59,59,1,
8981,2012-01-15,1,1,1,0,0,0,2,0.16,0.1364,0.47,0.2985,2,40,42,42,1,Pagi
8982,2012-01-15,1,1,2,0,0,0,2,0.16,0.1364,0.47,0.2836,5,38,43,43,1,Pagi
8983,2012-01-15,1,1,3,0,0,0,2,0.16,0.1364,0.48,0.3881,1,24,25,25,1,Pagi
8984,2012-01-15,1,1,4,0,0,0,2,0.16,0.1364,0.47,0.3881,1,5,6,6,1,Pagi
8985,2012-01-15,1,1,5,0,0,0,2,0.16,0.1364,0.47,0.3284,0,5,5,5,1,Pagi
8986,2012-01-15,1,1,6,0,0,0,2,0.14,0.1212,0.5,0.2836,1,7,8,8,1,Pagi
8987,2012-01-15,1,1,7,0,0,0,1,0.12,0.1212,0.54,0.2836,3,14,17,17,1,Siang
8988,2012-01-15,1,1,8,0,0,0,1,0.12,0.1212,0.54,0.2239,2,34,36,36,1,Siang
8989,2012-01-15,1,1,9,0,0,0,1,0.12,0.1364,0.54,0.194,10,80,90,90,1,Siang
8990,2012-01-15,1,1,10,0,0,0,1,0.14,0.1212,0.54,0.2836,11,115,126,126,1,Siang
8991,2012-01-15,1,1,11,0,0,0,1,0.16,0.1515,0.47,0.2239,21,144,165,165,1,Siang
8992,2012-01-15,1,1,12,0,0,0,1,0.18,0.1667,0.4,0.2985,42,192,234,234,1,Siang
8993,2012-01-15,1,1,13,0,0,0,1,0.2,0.1818,0.34,0.2836,40,184,224,224,1,Sore
8994,2012-01-15,1,1,14,0,0,0,1,0.2,0.1818,0.32,0.3582,25,163,188,188,1,Sore
8995,2012-01-15,1,1,15,0,0,0,1,0.22,0.2273,0.27,0.194,33,173,206,206,1,Sore
8996,2012-01-15,1,1,16,0,0,0,1,0.22,0.2121,0.29,0.2985,31,174,205,205,1,Sore
8997,2012-01-15,1,1,17,0,0,0,1,0.22,0.2121,0.25,0.2537,15,131,146,146,1,Sore
8998,2012-01-15,1,1,18,0,0,0,1,0.18,0.1818,0.29,0.2239,7,113,120,120,1,Sore
8999,2012-01-15,1,1,19,0,0,0,1,0.16,0.1667,0.37,0.1642,9,101,110,110,1,Malam
9000,2012-01-15,1,1,20,0,0,0,1,0.16,0.1818,0.37,0.1045,10,85,95,95,1,Malam
9001,2012-01-15,1,1,21,0,0,0,1,0.16,0.1667,0.4,0.1642,1,71,72,72,1,Malam
9002,2012-01-15,1,1,22,0,0,0,1,0.18,0.2121,0.37,0.0896,2,58,60,60,1,Malam
9003,2012-01-15,1,1,23,0,0,0,1,0.16,0.197,0.43,0.0896,3,26,29,29,1,Malam
9004,2012-01-16,1,1,0,1,1,0,1,0.14,0.1515,0.46,0.1343,2,23,25,25,1,
9005,2012-01-16,1,1,1,1,1,0,1,0.14,0.1667,0.43,0.1045,2,18,20,20,1,Pagi
9006,2012-01-16,1,1,2,1,1,0,1,0.14,0.2121,0.46,0.0,3,14,17,17,1,Pagi
9007,2012-01-16,1,1,3,1,1,0,1,0.12,0.197,0.5,0.0,0,3,3,3,1,Pagi
9008,2012-01-16,1,1,4,1,1,0,1,0.12,0.1515,0.58,0.1045,2,6,8,8,1,Pagi
9009,2012-01-16,1,1,5,1,1,0,1,0.12,0.1667,0.54,0.0896,1,5,6,6,1,Pagi
9010,2012-01-16,1,1,6,1,1,0,1,0.1,0.1364,0.54,0.0896,0,13,13,13,1,Pagi
9011,2012-01-16,1,1,7,1,1,0,1,0.1,0.1364,0.54,0.1045,5,28,33,33,1,Siang
9012,2012-01-16,1,1,8,1,1,0,1,0.1,0.1212,0.58,0.1642,3,75,78,78,1,Siang
9013,2012-01-16,1,1,9,1,1,0,1,0.1,0.1212,0.58,0.1642,7,89,96,96,1,Siang
9014,2012-01-16,1,1,10,1,1,0,2,0.14,0.1364,0.59,0.194,19,107,126,126,1,Siang
9015,2012-01-16,1,1,11,1,1,0,1,0.16,0.1515,0.59,0.2537,21,158,179,179,1,Siang
9016,2012-01-16,1,1,12,1,1,0,1,0.2,0.1818,0.55,0.3284,20,165,185,185,1,Siang
9017,2012-01-16,1,1,13,1,1,0,2,0.24,0.197,0.41,0.4179,26,202,228,228,1,Sore
9018,2012-01-16,1,1,14,1,1,0,1,0.24,0.2121,0.44,0.3881,23,158,181,181,1,Sore
9019,2012-01-16,1,1,15,1,1,0,1,0.26,0.2121,0.44,0.4478,17,175,192,192,1,Sore
9020,2012-01-16,1,1,16,1,1,0,1,0.26,0.2273,0.44,0.3582,22,158,180,180,1,Sore
9021,2012-01-16,1,1,17,1,1,0,1,0.26,0.2273,0.48,0.3284,19,174,193,193,1,Sore
9022,2012-01-16,1,1,18,1,1,0,1,0.26,0.2273,0.52,0.3284,6,175,181,181,1,Sore
9023,2012-01-16,1,1,19,1,1,0,1,0.26,0.2424,0.56,0.2836,10,134,144,144,1,Malam
9024,2012-01-16,1,1,20,1,1,0,1,0.26,0.2424,0.6,0.2836,2,88,90,90,1,Malam
9025,2012-01-16,1,1,21,1,1,0,1,0.28,0.2576,0.52,0.3284,3,46,49,49,1,Malam
9026,2012-01-16,1,1,22,1,1,0,2,0.3,0.2727,0.49,0.3582,4,39,43,43,1,Malam
9027,2012-01-16,1,1,23,1,1,0,3,0.26,0.2273,0.7,0.2985,0,28,28,28,1,Malam
9028,2012-01-17,1,1,0,0,2,1,2,0.26,0.2273,0.7,0.3284,0,12,12,12,1,
9029,2012-01-17,1,1,1,0,2,1,2,0.28,0.2576,0.65,0.3582,0,2,2,2,1,Pagi
9030,2012-01-17,1,1,2,0,2,1,3,0.28,0.2727,0.75,0.2537,0,12,12,12,1,Pagi
9031,2012-01-17,1,1,4,0,2,1,3,0.32,0.303,0.66,0.3284,0,2,2,2,1,Pagi
9032,2012-01-17,1,1,5,0,2,1,3,0.32,0.303,0.66,0.3284,0,13,13,13,1,Pagi
9033,2012-01-17,1,1,6,0,2,1,3,0.3,0.2879,0.75,0.2537,0,57,57,57,1,Pagi
9034,2012-01-17,1,1,7,0,2,1,3,0.3,0.2879,0.81,0.2239,5,121,126,126,1,Siang
9035,2012-01-17,1,1,8,0,2,1,3,0.3,0.2879,0.81,0.2836,3,90,93,93,1,Siang
9036,2012-01-17,1,1,9,0,2,1,3,0.32,0.303,0.81,0.2537,7,61,68,68,1,Siang
9037,2012-01-17,1,1,10,0,2,1,3,0.3,0.2879,0.87,0.2537,1,61,62,62,1,Siang
9038,2012-01-17,1,1,11,0,2,1,2,0.34,0.3485,0.87,0.1045,2,73,75,75,1,Siang
9039,2012-01-17,1,1,12,0,2,1,2,0.32,0.303,0.87,0.2836,3,83,86,86,1,Siang
9040,2012-01-17,1,1,13,0,2,1,2,0.38,0.3939,0.76,0.3284,8,95,103,103,1,Sore
9041,2012-01-17,1,1,14,0,2,1,1,0.44,0.4394,0.62,0.4925,12,120,132,132,1,Sore
9042,2012-01-17,1,1,15,0,2,1,1,0.44,0.4394,0.62,0.4925,6,123,129,129,1,Sore
9043,2012-01-17,1,1,16,0,2,1,1,0.46,0.4545,0.63,0.5522,14,205,219,219,1,Sore
9044,2012-01-17,1,1,17,0,2,1,1,0.46,0.4545,0.63,0.4478,20,442,462,462,1,Sore
9045,2012-01-17,1,1,18,0,2,1,1,0.46,0.4545,0.63,0.4478,12,451,463,463,1,Sore
9046,2012-01-17,1,1,19,0,2,1,1,0.46,0.4545,0.63,0.4179,11,297,308,308,1,Malam
9047,2012-01-17,1,1,20,0,2,1,1,0.46,0.4545,0.63,0.3582,11,169,180,180,1,Malam
9048,2012-01-17,1,1,21,0,2,1,1,0.46,0.4545,0.67,0.4627,6,174,180,180,1,Malam
9049,2012-01-17,1,1,22,0,2,1,1,0.46,0.4545,0.72,0.3881,5,85,90,90,1,Malam
9050,2012-01-17,1,1,23,0,2,1,1,0.46,0.4545,0.72,0.3881,1,60,61,61,1,Malam
9051,2012-01-18,1,1,0,0,3,1,2,0.46,0.4545,0.77,0.3284,3,14,17,17,1,
9052,2012-01-18,1,1,1,0,3,1,2,0.46,0.4545,0.77,0.3284,0,10,10,10,1,Pagi
9053,2012-01-18,1,1,2,0,3,1,2,0.44,0.4394,0.51,0.4925,1,1,2,2,1,Pagi
9054,2012-01-18,1,1,3,0,3,1,2,0.44,0.4394,0.51,0.4925,1,3,4,4,1,Pagi
9055,2012-01-18,1,1,4,0,3,1,1,0.34,0.2879,0.46,0.5224,0,1,1,1,1,Pagi
9056,2012-01-18,1,1,5,0,3,1,1,0.34,0.2879,0.46,0.5224,0,29,29,29,1,Pagi
9057,2012-01-18,1,1,6,0,3,1,1,0.34,0.2879,0.36,0.5224,0,88,88,88,1,Pagi
9058,2012-01-18,1,1,7,0,3,1,1,0.32,0.2879,0.42,0.3582,1,262,263,263,1,Siang
9059,2012-01-18,1,1,8,0,3,1,1,0.3,0.2727,0.52,0.4179,15,474,489,489,1,Siang
9060,2012-01-18,1,1,9,0,3,1,1,0.28,0.2576,0.52,0.3284,6,196,202,202,1,Siang
9061,2012-01-18,1,1,10,0,3,1,1,0.3,0.2727,0.42,0.4627,5,88,93,93,1,Siang
9062,2012-01-18,1,1,11,0,3,1,1,0.3,0.2727,0.42,0.3881,4,110,114,114,1,Siang
9063,2012-01-18,1,1,12,0,3,1,1,0.3,0.2576,0.39,0.4925,6,155,161,161,1,Siang
9064,2012-01-18,1,1,13,0,3,1,1,0.3,0.2727,0.42,0.4627,6,124,130,130,1,Sore
9065,2012-01-18,1,1,14,0,3,1,1,0.3,0.2727,0.33,0.3881,7,98,105,105,1,Sore
9066,2012-01-18,1,1,15,0,3,1,1,0.3,0.2576,0.33,0.5224,8,122,130,130,1,Sore
9067,2012-01-18,1,1,16,0,3,1,1,0.28,0.2273,0.3,0.5224,13,163,176,176,1,Sore
9068,2012-01-18,1,1,17,0,3,1,1,0.26,0.2121,0.33,0.4478,8,338,346,346,1,Sore
9069,2012-01-18,1,1,18,0,3,1,1,0.24,0.2121,0.32,0.3582,8,347,355,355,1,Sore
9070,2012-01-18,1,1,19,0,3,1,1,0.22,0.197,0.37,0.3881,5,251,256,256,1,Malam
9071,2012-01-18,1,1,20,0,3,1,1,0.22,0.2121,0.37,0.2537,1,164,165,165,1,Malam
9072,2012-01-18,1,1,21,0,3,1,1,0.2,0.1667,0.4,0.4179,5,119,124,124,1,Malam
9073,2012-01-18,1,1,22,0,3,1,1,0.18,0.1667,0.47,0.2537,4,74,78,78,1,Malam
9074,2012-01-18,1,1,23,0,3,1,1,0.16,0.1364,0.47,0.2985,2,36,38,38,1,Malam
9075,2012-01-19,1,1,0,0,4,1,1,0.14,0.1364,0.5,0.194,0,16,16,16,1,
9076,2012-01-19,1,1,1,0,4,1,1,0.14,0.1515,0.5,0.1642,0,5,5,5,1,Pagi
9077,2012-01-19,1,1,2,0,4,1,1,0.14,0.1515,0.5,0.1343,0,3,3,3,1,Pagi
9078,2012-01-19,1,1,3,0,4,1,1,0.12,0.1515,0.54,0.1045,0,4,4,4,1,Pagi
9079,2012-01-19,1,1,4,0,4,1,1,0.12,0.1515,0.54,0.1045,0,1,1,1,1,Pagi
9080,2012-01-19,1,1,5,0,4,1,1,0.12,0.1212,0.55,0.2537,0,19,19,19,1,Pagi
9081,2012-01-19,1,1,6,0,4,1,1,0.12,0.1364,0.54,0.1642,0,86,86,86,1,Pagi
9082,2012-01-19,1,1,7,0,4,1,1,0.12,0.1667,0.54,0.0896,2,204,206,206,1,Siang
9083,2012-01-19,1,1,8,0,4,1,1,0.12,0.1515,0.54,0.1045,9,414,423,423,1,Siang
9084,2012-01-19,1,1,9,0,4,1,1,0.12,0.197,0.54,0.0,6,204,210,210,1,Siang
9085,2012-01-19,1,1,10,0,4,1,1,0.14,0.2121,0.59,0.0,10,98,108,108,1,Siang
9086,2012-01-19,1,1,11,0,4,1,1,0.16,0.1667,0.55,0.1642,6,93,99,99,1,Siang
9087,2012-01-19,1,1,12,0,4,1,1,0.2,0.197,0.51,0.194,5,106,111,111,1,Siang
9088,2012-01-19,1,1,13,0,4,1,1,0.22,0.2121,0.47,0.2836,6,118,124,124,1,Sore
9089,2012-01-19,1,1,14,0,4,1,1,0.24,0.2273,0.44,0.194,15,104,119,119,1,Sore
9090,2012-01-19,1,1,15,0,4,1,1,0.26,0.2273,0.44,0.2985,9,118,127,127,1,Sore
9091,2012-01-19,1,1,16,0,4,1,1,0.26,0.2273,0.41,0.3284,8,185,193,193,1,Sore
9092,2012-01-19,1,1,17,0,4,1,2,0.26,0.2273,0.44,0.3284,21,364,385,385,1,Sore
9093,2012-01-19,1,1,18,0,4,1,2,0.26,0.2273,0.44,0.3284,16,345,361,361,1,Sore
9094,2012-01-19,1,1,19,0,4,1,2,0.26,0.2273,0.48,0.2985,5,229,234,234,1,Malam
9095,2012-01-19,1,1,20,0,4,1,1,0.26,0.2121,0.52,0.4478,7,184,191,191,1,Malam
9096,2012-01-19,1,1,21,0,4,1,1,0.26,0.2273,0.44,0.3582,4,117,121,121,1,Malam
9097,2012-01-19,1,1,22,0,4,1,2,0.26,0.2273,0.44,0.4179,0,90,90,90,1,Malam
9098,2012-01-19,1,1,23,0,4,1,1,0.26,0.2273,0.48,0.3284,1,55,56,56,1,Malam
9099,2012-01-20,1,1,0,0,5,1,2,0.26,0.2273,0.48,0.2985,3,24,27,27,1,
9100,2012-01-20,1,1,1,0,5,1,1,0.26,0.2727,0.48,0.1343,0,15,15,15,1,Pagi
9101,2012-01-20,1,1,2,0,5,1,1,0.26,0.2727,0.48,0.1343,0,11,11,11,1,Pagi
9102,2012-01-20,1,1,3,0,5,1,1,0.24,0.2576,0.52,0.1045,0,4,4,4,1,Pagi
9103,2012-01-20,1,1,4,0,5,1,1,0.22,0.2424,0.6,0.1045,0,3,3,3,1,Pagi
9104,2012-01-20,1,1,5,0,5,1,1,0.22,0.2424,0.6,0.1045,0,19,19,19,1,Pagi
9105,2012-01-20,1,1,6,0,5,1,1,0.24,0.2121,0.6,0.2836,0,68,68,68,1,Pagi
9106,2012-01-20,1,1,7,0,5,1,1,0.22,0.2121,0.69,0.2239,2,183,185,185,1,Siang
9107,2012-01-20,1,1,8,0,5,1,1,0.22,0.2121,0.64,0.2537,4,421,425,425,1,Siang
9108,2012-01-20,1,1,9,0,5,1,1,0.22,0.197,0.47,0.3881,21,242,263,263,1,Siang
9109,2012-01-20,1,1,10,0,5,1,2,0.22,0.2121,0.44,0.2836,1,96,97,97,1,Siang
9110,2012-01-20,1,1,11,0,5,1,2,0.2,0.1818,0.32,0.3582,6,117,123,123,1,Siang
9111,2012-01-20,1,1,12,0,5,1,2,0.2,0.1818,0.34,0.3284,5,119,124,124,1,Siang
9112,2012-01-20,1,1,13,0,5,1,1,0.22,0.2121,0.32,0.2985,12,144,156,156,1,Sore
9113,2012-01-20,1,1,14,0,5,1,2,0.22,0.2121,0.35,0.2985,8,107,115,115,1,Sore
9114,2012-01-20,1,1,15,0,5,1,2,0.22,0.2273,0.35,0.194,12,144,156,156,1,Sore
9115,2012-01-20,1,1,16,0,5,1,2,0.2,0.2121,0.37,0.1642,11,163,174,174,1,Sore
9116,2012-01-20,1,1,17,0,5,1,2,0.22,0.2576,0.32,0.0896,9,340,349,349,1,Sore
9117,2012-01-20,1,1,18,0,5,1,2,0.2,0.2273,0.34,0.0896,5,296,301,301,1,Sore
9118,2012-01-20,1,1,19,0,5,1,2,0.2,0.2273,0.37,0.1045,6,186,192,192,1,Malam
9119,2012-01-20,1,1,20,0,5,1,2,0.2,0.2273,0.34,0.0896,1,141,142,142,1,Malam
9120,2012-01-20,1,1,21,0,5,1,2,0.2,0.2273,0.37,0.0896,5,99,104,104,1,Malam
9121,2012-01-20,1,1,22,0,5,1,2,0.2,0.197,0.37,0.2239,1,71,72,72,1,Malam
9122,2012-01-20,1,1,23,0,5,1,3,0.16,0.1515,0.64,0.2239,3,35,38,38,1,Malam
9123,2012-01-21,1,1,0,0,6,0,3,0.16,0.1515,0.64,0.2239,0,24,24,24,1,
9124,2012-01-21,1,1,1,0,6,0,4,0.14,0.1364,0.86,0.194,1,22,23,23,1,Pagi
9125,2012-01-21,1,1,2,0,6,0,3,0.14,0.2121,0.86,0.0,1,25,26,26,1,Pagi
9126,2012-01-21,1,1,3,0,6,0,3,0.14,0.1818,0.93,0.0896,0,13,13,13,1,Pagi
9127,2012-01-21,1,1,4,0,6,0,3,0.16,0.197,0.86,0.0896,0,1,1,1,1,Pagi
9128,2012-01-21,1,1,5,0,6,0,3,0.16,0.1818,0.86,0.1045,0,2,2,2,1,Pagi
9129,2012-01-21,1,1,6,0,6,0,3,0.16,0.1667,0.93,0.1642,0,1,1,1,1,Pagi
9130,2012-01-21,1,1,7,0,6,0,3,0.16,0.1667,0.93,0.1642,3,10,13,13,1,Siang
9131,2012-01-21,1,1,8,0,6,0,2,0.16,0.1515,0.93,0.2537,3,22,25,25,1,Siang
9132,2012-01-21,1,1,9,0,6,0,2,0.16,0.1515,0.93,0.2537,2,40,42,42,1,Siang
9133,2012-01-21,1,1,10,0,6,0,3,0.16,0.1515,0.93,0.2537,0,45,45,45,1,Siang
9134,2012-01-21,1,1,11,0,6,0,2,0.18,0.2121,0.86,0.1045,1,62,63,63,1,Siang
9135,2012-01-21,1,1,12,0,6,0,2,0.2,0.2121,0.8,0.1642,5,62,67,67,1,Siang
9136,2012-01-21,1,1,13,0,6,0,2,0.2,0.197,0.8,0.2537,10,66,76,76,1,Sore
9137,2012-01-21,1,1,14,0,6,0,3,0.2,0.197,0.8,0.194,6,89,95,95,1,Sore
9138,2012-01-21,1,1,15,0,6,0,3,0.2,0.197,0.8,0.194,6,113,119,119,1,Sore
9139,2012-01-21,1,1,16,0,6,0,2,0.2,0.1818,0.8,0.2985,5,113,118,118,1,Sore
9140,2012-01-21,1,1,17,0,6,0,2,0.2,0.1818,0.8,0.3881,7,99,106,106,1,Sore
9141,2012-01-21,1,1,18,0,6,0,2,0.2,0.1818,0.75,0.3881,3,107,110,110,1,Sore
9142,2012-01-21,1,1,19,0,6,0,2,0.18,0.1515,0.8,0.3881,0,85,85,85,1,Malam
9143,2012-01-21,1,1,20,0,6,0,2,0.18,0.1667,0.8,0.2985,5,62,67,67,1,Malam
9144,2012-01-21,1,1,21,0,6,0,1,0.18,0.1515,0.74,0.3284,5,64,69,69,1,Malam
9145,2012-01-21,1,1,22,0,6,0,2,0.18,0.1667,0.74,0.2985,3,56,59,59,1,Malam
9146,2012-01-21,1,1,23,0,6,0,2,0.16,0.1515,0.8,0.2537,1,51,52,52,1,Malam
9147,2012-01-22,1,1,0,0,0,0,1,0.16,0.1364,0.8,0.2985,1,51,52,52,1,
9148,2012-01-22,1,1,1,0,0,0,2,0.18,0.1667,0.74,0.2985,1,49,50,50,1,Pagi
9149,2012-01-22,1,1,2,0,0,0,2,0.18,0.1667,0.74,0.2836,1,46,47,47,1,Pagi
9150,2012-01-22,1,1,3,0,0,0,2,0.18,0.1667,0.69,0.2836,1,20,21,21,1,Pagi
9151,2012-01-22,1,1,4,0,0,0,3,0.16,0.1364,0.8,0.2836,1,1,2,2,1,Pagi
9152,2012-01-22,1,1,5,0,0,0,3,0.16,0.1515,0.74,0.2239,1,2,3,3,1,Pagi
9153,2012-01-22,1,1,6,0,0,0,2,0.16,0.1515,0.74,0.2239,0,4,4,4,1,Pagi
9154,2012-01-22,1,1,7,0,0,0,2,0.16,0.1515,0.74,0.2239,2,11,13,13,1,Siang
9155,2012-01-22,1,1,8,0,0,0,2,0.16,0.1515,0.74,0.2239,3,29,32,32,1,Siang
9156,2012-01-22,1,1,9,0,0,0,2,0.16,0.1515,0.74,0.2239,9,54,63,63,1,Siang
9157,2012-01-22,1,1,10,0,0,0,2,0.16,0.1364,0.74,0.2836,9,120,129,129,1,Siang
9158,2012-01-22,1,1,11,0,0,0,3,0.16,0.1515,0.8,0.2537,18,115,133,133,1,Siang
9159,2012-01-22,1,1,12,0,0,0,2,0.16,0.1515,0.8,0.2239,24,161,185,185,1,Siang
9160,2012-01-22,1,1,13,0,0,0,2,0.16,0.1818,0.8,0.1343,24,175,199,199,1,Sore
9161,2012-01-22,1,1,14,0,0,0,2,0.16,0.1667,0.8,0.1642,19,163,182,182,1,Sore
9162,2012-01-22,1,1,15,0,0,0,2,0.16,0.1515,0.8,0.194,27,149,176,176,1,Sore
9163,2012-01-22,1,1,16,0,0,0,2,0.16,0.1515,0.8,0.194,12,143,155,155,1,Sore
9164,2012-01-22,1,1,17,0,0,0,2,0.16,0.1818,0.8,0.1045,8,100,108,108,1,Sore
9165,2012-01-22,1,1,18,0,0,0,3,0.16,0.1818,0.86,0.1045,11,110,121,121,1,Sore
9166,2012-01-22,1,1,19,0,0,0,3,0.16,0.1818,0.86,0.1045,9,80,89,89,1,Malam
9167,2012-01-22,1,1,20,0,0,0,3,0.16,0.1667,0.86,0.1642,5,69,74,74,1,Malam
9168,2012-01-22,1,1,21,0,0,0,3,0.16,0.1818,0.86,0.1045,8,36,44,44,1,Malam
9169,2012-01-22,1,1,22,0,0,0,2,0.16,0.197,0.93,0.0896,0,58,58,58,1,Malam
9170,2012-01-22,1,1,23,0,0,0,2,0.16,0.1818,0.93,0.1045,2,35,37,37,1,Malam
9171,2012-01-23,1,1,0,0,1,1,2,0.18,0.2424,0.86,0.0,2,17,19,19,1,
9172,2012-01-23,1,1,1,0,1,1,2,0.18,0.2121,0.86,0.1045,0,4,4,4,1,Pagi
9173,2012-01-23,1,1,2,0,1,1,2,0.18,0.2121,0.86,0.1045,0,2,2,2,1,Pagi
9174,2012-01-23,1,1,3,0,1,1,2,0.18,0.2424,0.86,0.0,0,1,1,1,1,Pagi
9175,2012-01-23,1,1,4,0,1,1,2,0.2,0.2576,0.8,0.0,0,1,1,1,1,Pagi
9176,2012-01-23,1,1,5,0,1,1,2,0.2,0.2576,0.86,0.0,0,19,19,19,1,Pagi
9177,2012-01-23,1,1,6,0,1,1,2,0.2,0.2576,0.86,0.0,6,36,42,42,1,Pagi
9178,2012-01-23,1,1,7,0,1,1,3,0.2,0.2576,0.86,0.0,8,114,122,122,1,Siang
9179,2012-01-23,1,1,8,0,1,1,3,0.2,0.2121,0.86,0.1343,5,267,272,272,1,Siang
9180,2012-01-23,1,1,9,0,1,1,2,0.2,0.2273,0.86,0.0896,13,198,211,211,1,Siang
9181,2012-01-23,1,1,10,0,1,1,2,0.2,0.2576,0.93,0.0,10,139,149,149,1,Siang
9182,2012-01-23,1,1,11,0,1,1,2,0.2,0.2273,0.93,0.0896,5,57,62,62,1,Siang
9183,2012-01-23,1,1,12,0,1,1,2,0.22,0.2727,0.93,0.0,10,52,62,62,1,Siang
9184,2012-01-23,1,1,13,0,1,1,3,0.22,0.2576,0.93,0.0896,5,32,37,37,1,Sore
9185,2012-01-23,1,1,14,0,1,1,3,0.22,0.2273,0.93,0.194,13,48,61,61,1,Sore
9186,2012-01-23,1,1,15,0,1,1,2,0.22,0.2121,1.0,0.2239,10,64,74,74,1,Sore
9187,2012-01-23,1,1,16,0,1,1,2,0.24,0.2424,0.93,0.1642,14,108,122,122,1,Sore
9188,2012-01-23,1,1,17,0,1,1,2,0.24,0.2576,0.96,0.1045,6,270,276,276,1,Sore
9189,2012-01-23,1,1,18,0,1,1,2,0.24,0.2424,0.93,0.1343,7,275,282,282,1,Sore
9190,2012-01-23,1,1,19,0,1,1,2,0.26,0.2576,0.93,0.1642,9,211,220,220,1,Malam
9191,2012-01-23,1,1,20,0,1,1,2,0.26,0.2576,1.0,0.1642,8,161,169,169,1,Malam
9192,2012-01-23,1,1,21,0,1,1,2,0.26,0.2424,1.0,0.2836,8,112,120,120,1,Malam
9193,2012-01-23,1,1,22,0,1,1,2,0.26,0.2424,1.0,0.2836,4,64,68,68,1,Malam
9194,2012-01-23,1,1,23,0,1,1,2,0.28,0.2576,0.93,0.3284,2,35,37,37,1,Malam
9195,2012-01-24,1,1,0,0,2,1,2,0.3,0.2879,1.0,0.2836,6,19,25,25,1,
9196,2012-01-24,1,1,1,0,2,1,2,0.32,0.303,0.93,0.2537,2,7,9,9,1,Pagi
9197,2012-01-24,1,1,2,0,2,1,2,0.32,0.303,0.93,0.2239,2,6,8,8,1,Pagi
9198,2012-01-24,1,1,3,0,2,1,2,0.32,0.3333,0.93,0.1343,0,3,3,3,1,Pagi
9199,2012-01-24,1,1,4,0,2,1,2,0.3,0.3182,1.0,0.0896,0,2,2,2,1,Pagi
9200,2012-01-24,1,1,5,0,2,1,2,0.3,0.3182,1.0,0.0896,0,26,26,26,1,Pagi
9201,2012-01-24,1,1,6,0,2,1,2,0.32,0.3182,0.93,0.194,1,88,89,89,1,Pagi
9202,2012-01-24,1,1,7,0,2,1,2,0.32,0.3333,0.93,0.1343,11,221,232,232,1,Siang
9203,2012-01-24,1,1,8,0,2,1,2,0.32,0.3333,0.93,0.1343,11,479,490,490,1,Siang
9204,2012-01-24,1,1,9,0,2,1,2,0.32,0.3333,0.87,0.0896,11,244,255,255,1,Siang
9205,2012-01-24,1,1,10,0,2,1,1,0.32,0.3333,0.93,0.0896,23,93,116,116,1,Siang
9206,2012-01-24,1,1,11,0,2,1,1,0.34,0.3333,0.87,0.1343,30,123,153,153,1,Siang
9207,2012-01-24,1,1,12,0,2,1,1,0.34,0.3333,0.87,0.1642,25,150,175,175,1,Siang
9208,2012-01-24,1,1,13,0,2,1,1,0.34,0.3333,0.87,0.1642,33,170,203,203,1,Sore
9209,2012-01-24,1,1,14,0,2,1,1,0.36,0.3485,0.81,0.2239,35,138,173,173,1,Sore
9210,2012-01-24,1,1,15,0,2,1,2,0.4,0.4091,0.71,0.1642,52,156,208,208,1,Sore
9211,2012-01-24,1,1,16,0,2,1,1,0.4,0.4091,0.71,0.1343,35,243,278,278,1,Sore
9212,2012-01-24,1,1,17,0,2,1,1,0.42,0.4242,0.67,0.0896,41,474,515,515,1,Sore
9213,2012-01-24,1,1,18,0,2,1,1,0.4,0.4091,0.62,0.0896,32,391,423,423,1,Sore
9214,2012-01-24,1,1,19,0,2,1,1,0.44,0.4394,0.51,0.0896,20,311,331,331,1,Malam
9215,2012-01-24,1,1,20,0,2,1,1,0.32,0.3485,0.76,0.0,18,211,229,229,1,Malam
9216,2012-01-24,1,1,21,0,2,1,1,0.36,0.3788,0.71,0.0,18,154,172,172,1,Malam
9217,2012-01-24,1,1,22,0,2,1,1,0.32,0.3485,0.81,0.0,14,111,125,125,1,Malam
9218,2012-01-24,1,1,23,0,2,1,1,0.32,0.3485,0.76,0.0,19,80,99,99,1,Malam
9219,2012-01-25,1,1,0,0,3,1,1,0.26,0.303,0.93,0.0,6,25,31,31,1,
9220,2012-01-25,1,1,1,0,3,1,1,0.3,0.2879,0.7,0.2239,4,9,13,13,1,Pagi
9221,2012-01-25,1,1,2,0,3,1,1,0.28,0.2727,0.7,0.194,3,3,6,6,1,Pagi
9222,2012-01-25,1,1,3,0,3,1,1,0.26,0.2576,0.75,0.194,0,1,1,1,1,Pagi
9223,2012-01-25,1,1,4,0,3,1,1,0.26,0.2424,0.7,0.2836,0,4,4,4,1,Pagi
9224,2012-01-25,1,1,5,0,3,1,1,0.26,0.2424,0.7,0.2836,0,33,33,33,1,Pagi
9225,2012-01-25,1,1,6,0,3,1,1,0.24,0.2273,0.73,0.2239,1,87,88,88,1,Pagi
9226,2012-01-25,1,1,7,0,3,1,1,0.24,0.2273,0.75,0.2239,14,243,257,257,1,Siang
9227,2012-01-25,1,1,8,0,3,1,1,0.24,0.2273,0.7,0.2537,18,495,513,513,1,Siang
9228,2012-01-25,1,1,9,0,3,1,1,0.24,0.2273,0.7,0.2537,18,218,236,236,1,Siang
9229,2012-01-25,1,1,10,0,3,1,2,0.26,0.2273,0.7,0.3284,30,111,141,141,1,Siang
9230,2012-01-25,1,1,11,0,3,1,2,0.3,0.2727,0.61,0.2985,52,105,157,157,1,Siang
9231,2012-01-25,1,1,12,0,3,1,1,0.32,0.3333,0.53,0.1343,46,147,193,193,1,Siang
9232,2012-01-25,1,1,13,0,3,1,1,0.34,0.3333,0.49,0.1343,63,149,212,212,1,Sore
9233,2012-01-25,1,1,14,0,3,1,1,0.34,0.3485,0.49,0.0896,53,107,160,160,1,Sore
9234,2012-01-25,1,1,15,0,3,1,1,0.36,0.3788,0.46,0.0,30,125,155,155,1,Sore
9235,2012-01-25,1,1,16,0,3,1,1,0.34,0.3333,0.53,0.1642,29,217,246,246,1,Sore
9236,2012-01-25,1,1,17,0,3,1,1,0.36,0.3485,0.53,0.1642,27,443,470,470,1,Sore
9237,2012-01-25,1,1,18,0,3,1,1,0.32,0.3333,0.66,0.1343,24,415,439,439,1,Sore
9238,2012-01-25,1,1,19,0,3,1,2,0.34,0.3636,0.53,0.0,5,311,316,316,1,Malam
9239,2012-01-25,1,1,20,0,3,1,1,0.32,0.3182,0.61,0.194,10,225,235,235,1,Malam
9240,2012-01-25,1,1,21,0,3,1,1,0.3,0.3333,0.65,0.0,19,166,185,185,1,Malam
9241,2012-01-25,1,1,22,0,3,1,1,0.3,0.3182,0.65,0.0896,12,101,113,113,1,Malam
9242,2012-01-25,1,1,23,0,3,1,2,0.28,0.3182,0.65,0.0,3,63,66,66,1,Malam
9243,2012-01-26,1,1,0,0,4,1,2,0.28,0.2879,0.75,0.1045,3,22,25,25,1,
9244,2012-01-26,1,1,1,0,4,1,2,0.28,0.3182,0.75,0.0,5,16,21,21,1,Pagi
9245,2012-01-26,1,1,2,0,4,1,2,0.28,0.2727,0.75,0.1642,1,6,7,7,1,Pagi
9246,2012-01-26,1,1,3,0,4,1,2,0.28,0.303,0.75,0.0896,1,5,6,6,1,Pagi
9247,2012-01-26,1,1,4,0,4,1,1,0.28,0.3182,0.75,0.0,0,3,3,3,1,Pagi
9248,2012-01-26,1,1,5,0,4,1,2,0.3,0.3182,0.75,0.1045,0,28,28,28,1,Pagi
9249,2012-01-26,1,1,6,0,4,1,2,0.28,0.3182,0.81,0.0,0,88,88,88,1,Pagi
9250,2012-01-26,1,1,7,0,4,1,2,0.28,0.303,0.81,0.0896,11,228,239,239,1,Siang
9251,2012-01-26,1,1,8,0,4,1,2,0.28,0.303,0.81,0.0896,16,514,530,530,1,Siang
9252,2012-01-26,1,1,9,0,4,1,2,0.3,0.3333,0.81,0.0,18,256,274,274,1,Siang
9253,2012-01-26,1,1,10,0,4,1,2,0.3,0.303,0.81,0.1343,16,92,108,108,1,Siang
9254,2012-01-26,1,1,11,0,4,1,2,0.3,0.3182,0.87,0.1045,11,100,111,111,1,Siang
9255,2012-01-26,1,1,12,0,4,1,2,0.34,0.3333,0.81,0.1343,29,136,165,165,1,Siang
9256,2012-01-26,1,1,13,0,4,1,2,0.38,0.3939,0.71,0.0,17,156,173,173,1,Sore
9257,2012-01-26,1,1,14,0,4,1,2,0.4,0.4091,0.71,0.1045,16,112,128,128,1,Sore
9258,2012-01-26,1,1,15,0,4,1,2,0.42,0.4242,0.71,0.1045,22,142,164,164,1,Sore
9259,2012-01-26,1,1,16,0,4,1,2,0.4,0.4091,0.71,0.0896,15,209,224,224,1,Sore
9260,2012-01-26,1,1,17,0,4,1,2,0.42,0.4242,0.71,0.0,16,397,413,413,1,Sore
9261,2012-01-26,1,1,18,0,4,1,2,0.42,0.4242,0.71,0.0,12,394,406,406,1,Sore
9262,2012-01-26,1,1,19,0,4,1,2,0.4,0.4091,0.76,0.1045,11,302,313,313,1,Malam
9263,2012-01-26,1,1,20,0,4,1,2,0.4,0.4091,0.82,0.1343,8,216,224,224,1,Malam
9264,2012-01-26,1,1,21,0,4,1,2,0.4,0.4091,0.76,0.1045,8,184,192,192,1,Malam
9265,2012-01-26,1,1,22,0,4,1,1,0.38,0.3939,0.82,0.1045,3,139,142,142,1,Malam
9266,2012-01-26,1,1,23,0,4,1,2,0.4,0.4091,0.82,0.0,5,86,91,91,1,Malam
9267,2012-01-27,1,1,0,0,5,1,2,0.4,0.4091,0.82,0.2537,6,32,38,38,1,
9268,2012-01-27,1,1,1,0,5,1,2,0.4,0.4091,0.87,0.2239,6,23,29,29,1,Pagi
9269,2012-01-27,1,1,2,0,5,1,1,0.42,0.4242,0.94,0.1343,2,11,13,13,1,Pagi
9270,2012-01-27,1,1,3,0,5,1,2,0.42,0.4242,0.94,0.2836,3,5,8,8,1,Pagi
9271,2012-01-27,1,1,4,0,5,1,2,0.4,0.4091,1.0,0.2985,1,3,4,4,1,Pagi
9272,2012-01-27,1,1,5,0,5,1,2,0.42,0.4242,0.94,0.3284,0,24,24,24,1,Pagi
9273,2012-01-27,1,1,6,0,5,1,2,0.42,0.4242,1.0,0.3284,0,72,72,72,1,Pagi
9274,2012-01-27,1,1,7,0,5,1,2,0.42,0.4242,1.0,0.2985,6,128,134,134,1,Siang
9275,2012-01-27,1,1,8,0,5,1,3,0.5,0.4848,0.88,0.2836,14,206,220,220,1,Siang
9276,2012-01-27,1,1,9,0,5,1,3,0.5,0.4848,0.88,0.2836,6,101,107,107,1,Siang
9277,2012-01-27,1,1,10,0,5,1,3,0.48,0.4697,1.0,0.1642,9,117,126,126,1,Siang
9278,2012-01-27,1,1,11,0,5,1,2,0.48,0.4697,0.94,0.1343,10,95,105,105,1,Siang
9279,2012-01-27,1,1,12,0,5,1,2,0.5,0.4848,0.88,0.1642,25,155,180,180,1,Siang
9280,2012-01-27,1,1,13,0,5,1,1,0.5,0.4848,0.59,0.4627,26,175,201,201,1,Sore
9281,2012-01-27,1,1,14,0,5,1,1,0.5,0.4848,0.55,0.5522,23,153,176,176,1,Sore
9282,2012-01-27,1,1,15,0,5,1,1,0.48,0.4697,0.51,0.3284,27,170,197,197,1,Sore
9283,2012-01-27,1,1,16,0,5,1,1,0.44,0.4394,0.51,0.5522,26,241,267,267,1,Sore
9284,2012-01-27,1,1,17,0,5,1,1,0.42,0.4242,0.5,0.5821,16,406,422,422,1,Sore
9285,2012-01-27,1,1,18,0,5,1,1,0.4,0.4091,0.5,0.4925,20,363,383,383,1,Sore
9286,2012-01-27,1,1,19,0,5,1,1,0.36,0.3333,0.5,0.3881,10,241,251,251,1,Malam
9287,2012-01-27,1,1,20,0,5,1,1,0.34,0.303,0.53,0.3582,6,153,159,159,1,Malam
9288,2012-01-27,1,1,21,0,5,1,1,0.34,0.2879,0.53,0.5224,8,127,135,135,1,Malam
9289,2012-01-27,1,1,22,0,5,1,1,0.34,0.303,0.49,0.3881,11,108,119,119,1,Malam
9290,2012-01-27,1,1,23,0,5,1,1,0.32,0.2879,0.49,0.4179,8,78,86,86,1,Malam
9291,2012-01-28,1,1,0,0,6,0,1,0.3,0.2879,0.52,0.2836,1,68,69,69,1,
9292,2012-01-28,1,1,1,0,6,0,1,0.3,0.303,0.52,0.1642,1,57,58,58,1,Pagi
9293,2012-01-28,1,1,2,0,6,0,1,0.26,0.303,0.6,0.0,3,38,41,41,1,Pagi
9294,2012-01-28,1,1,3,0,6,0,1,0.26,0.2879,0.6,0.0896,1,16,17,17,1,Pagi
9295,2012-01-28,1,1,4,0,6,0,1,0.26,0.2576,0.6,0.1642,0,8,8,8,1,Pagi
9296,2012-01-28,1,1,5,0,6,0,1,0.24,0.2576,0.75,0.0896,0,10,10,10,1,Pagi
9297,2012-01-28,1,1,6,0,6,0,1,0.24,0.2879,0.7,0.0,3,12,15,15,1,Pagi
9298,2012-01-28,1,1,7,0,6,0,1,0.22,0.2727,0.75,0.0,3,28,31,31,1,Siang
9299,2012-01-28,1,1,8,0,6,0,1,0.2,0.2273,0.8,0.0896,9,82,91,91,1,Siang
9300,2012-01-28,1,1,9,0,6,0,1,0.22,0.2727,0.8,0.0,13,145,158,158,1,Siang
9301,2012-01-28,1,1,10,0,6,0,1,0.26,0.2727,0.7,0.1343,27,164,191,191,1,Siang
9302,2012-01-28,1,1,11,0,6,0,1,0.3,0.303,0.56,0.1343,55,241,296,296,1,Siang
9303,2012-01-28,1,1,12,0,6,0,1,0.3,0.2879,0.61,0.2836,70,244,314,314,1,Siang
9304,2012-01-28,1,1,13,0,6,0,1,0.34,0.3182,0.57,0.2537,80,293,373,373,1,Sore
9305,2012-01-28,1,1,14,0,6,0,1,0.38,0.3939,0.5,0.3881,123,239,362,362,1,Sore
9306,2012-01-28,1,1,15,0,6,0,1,0.4,0.4091,0.47,0.3284,90,320,410,410,1,Sore
9307,2012-01-28,1,1,16,0,6,0,1,0.42,0.4242,0.44,0.3582,131,276,407,407,1,Sore
9308,2012-01-28,1,1,17,0,6,0,1,0.42,0.4242,0.44,0.3881,57,233,290,290,1,Sore
9309,2012-01-28,1,1,18,0,6,0,1,0.42,0.4242,0.41,0.2239,40,201,241,241,1,Sore
9310,2012-01-28,1,1,19,0,6,0,2,0.42,0.4242,0.41,0.5522,33,173,206,206,1,Malam
9311,2012-01-28,1,1,20,0,6,0,1,0.4,0.4091,0.35,0.3881,5,115,120,120,1,Malam
9312,2012-01-28,1,1,21,0,6,0,1,0.36,0.3333,0.29,0.3582,18,109,127,127,1,Malam
9313,2012-01-28,1,1,22,0,6,0,1,0.34,0.3333,0.34,0.194,6,97,103,103,1,Malam
9314,2012-01-28,1,1,23,0,6,0,1,0.32,0.3182,0.31,0.194,6,79,85,85,1,Malam
9315,2012-01-29,1,1,0,0,0,0,1,0.3,0.2879,0.33,0.2239,15,81,96,96,1,
9316,2012-01-29,1,1,1,0,0,0,1,0.3,0.2727,0.28,0.3582,5,68,73,73,1,Pagi
9317,2012-01-29,1,1,2,0,0,0,1,0.28,0.2576,0.26,0.3284,3,48,51,51,1,Pagi
9318,2012-01-29,1,1,3,0,0,0,1,0.26,0.2576,0.28,0.194,4,17,21,21,1,Pagi
9319,2012-01-29,1,1,4,0,0,0,1,0.24,0.2576,0.3,0.0,0,5,5,5,1,Pagi
9320,2012-01-29,1,1,5,0,0,0,1,0.2,0.2121,0.51,0.1343,1,6,7,7,1,Pagi
9321,2012-01-29,1,1,6,0,0,0,1,0.2,0.2273,0.4,0.1045,1,4,5,5,1,Pagi
9322,2012-01-29,1,1,7,0,0,0,1,0.2,0.2121,0.37,0.1343,0,12,12,12,1,Siang
9323,2012-01-29,1,1,8,0,0,0,1,0.18,0.197,0.4,0.1343,9,61,70,70,1,Siang
9324,2012-01-29,1,1,9,0,0,0,1,0.18,0.197,0.43,0.1343,13,98,111,111,1,Siang
9325,2012-01-29,1,1,10,0,0,0,1,0.24,0.2424,0.35,0.1343,38,153,191,191,1,Siang
9326,2012-01-29,1,1,11,0,0,0,1,0.28,0.2727,0.28,0.2239,57,198,255,255,1,Siang
9327,2012-01-29,1,1,12,0,0,0,1,0.32,0.303,0.26,0.2239,73,215,288,288,1,Siang
9328,2012-01-29,1,1,13,0,0,0,1,0.32,0.303,0.26,0.2239,78,238,316,316,1,Sore
9329,2012-01-29,1,1,14,0,0,0,1,0.32,0.303,0.26,0.2537,51,229,280,280,1,Sore
9330,2012-01-29,1,1,15,0,0,0,1,0.36,0.3333,0.25,0.2836,68,242,310,310,1,Sore
9331,2012-01-29,1,1,16,0,0,0,1,0.36,0.3333,0.21,0.4179,54,268,322,322,1,Sore
9332,2012-01-29,1,1,17,0,0,0,1,0.36,0.3333,0.21,0.4179,33,201,234,234,1,Sore
9333,2012-01-29,1,1,18,0,0,0,1,0.34,0.303,0.23,0.3582,17,151,168,168,1,Sore
9334,2012-01-29,1,1,19,0,0,0,1,0.32,0.303,0.29,0.2537,14,145,159,159,1,Malam
9335,2012-01-29,1,1,20,0,0,0,1,0.3,0.2879,0.39,0.2239,13,98,111,111,1,Malam
9336,2012-01-29,1,1,21,0,0,0,1,0.3,0.2879,0.33,0.2836,0,69,69,69,1,Malam
9337,2012-01-29,1,1,22,0,0,0,1,0.32,0.2879,0.26,0.3881,7,57,64,64,1,Malam
9338,2012-01-29,1,1,23,0,0,0,1,0.3,0.2727,0.33,0.3284,4,21,25,25,1,Malam
9339,2012-01-30,1,1,0,0,1,1,2,0.32,0.2879,0.26,0.4179,0,10,10,10,1,
9340,2012-01-30,1,1,1,0,1,1,1,0.26,0.2273,0.6,0.3582,0,9,9,9,1,Pagi
9341,2012-01-30,1,1,2,0,1,1,1,0.24,0.2121,0.48,0.3582,1,6,7,7,1,Pagi
9342,2012-01-30,1,1,3,0,1,1,1,0.24,0.2273,0.48,0.194,0,4,4,4,1,Pagi
9343,2012-01-30,1,1,4,0,1,1,1,0.2,0.2121,0.51,0.1343,0,5,5,5,1,Pagi
9344,2012-01-30,1,1,5,0,1,1,1,0.2,0.2121,0.51,0.1343,0,26,26,26,1,Pagi
9345,2012-01-30,1,1,6,0,1,1,1,0.22,0.2121,0.44,0.2537,0,80,80,80,1,Pagi
9346,2012-01-30,1,1,7,0,1,1,1,0.22,0.2121,0.44,0.2836,4,221,225,225,1,Siang
9347,2012-01-30,1,1,8,0,1,1,1,0.2,0.197,0.47,0.2239,12,481,493,493,1,Siang
9348,2012-01-30,1,1,9,0,1,1,1,0.2,0.197,0.47,0.2239,5,193,198,198,1,Siang
9349,2012-01-30,1,1,10,0,1,1,1,0.22,0.2121,0.41,0.2836,3,82,85,85,1,Siang
9350,2012-01-30,1,1,11,0,1,1,1,0.26,0.2576,0.38,0.0,6,93,99,99,1,Siang
9351,2012-01-30,1,1,12,0,1,1,1,0.26,0.2273,0.35,0.3881,5,129,134,134,1,Siang
9352,2012-01-30,1,1,13,0,1,1,1,0.3,0.2879,0.31,0.194,15,117,132,132,1,Sore
9353,2012-01-30,1,1,14,0,1,1,1,0.32,0.3333,0.24,0.1343,15,100,115,115,1,Sore
9354,2012-01-30,1,1,15,0,1,1,1,0.32,0.3182,0.24,0.194,7,131,138,138,1,Sore
9355,2012-01-30,1,1,16,0,1,1,1,0.34,0.3333,0.25,0.194,11,210,221,221,1,Sore
9356,2012-01-30,1,1,17,0,1,1,1,0.36,0.3485,0.21,0.194,16,422,438,438,1,Sore
9357,2012-01-30,1,1,18,0,1,1,1,0.34,0.3333,0.23,0.1642,11,399,410,410,1,Sore
9358,2012-01-30,1,1,19,0,1,1,1,0.3,0.3182,0.45,0.1045,8,298,306,306,1,Malam
9359,2012-01-30,1,1,20,0,1,1,1,0.3,0.303,0.39,0.1642,2,179,181,181,1,Malam
9360,2012-01-30,1,1,21,0,1,1,1,0.3,0.303,0.42,0.1642,3,159,162,162,1,Malam
9361,2012-01-30,1,1,22,0,1,1,1,0.28,0.2727,0.48,0.2239,2,92,94,94,1,Malam
9362,2012-01-30,1,1,23,0,1,1,1,0.26,0.2576,0.6,0.194,0,52,52,52,1,Malam
9363,2012-01-31,1,1,0,0,2,1,1,0.28,0.2727,0.52,0.2537,0,15,15,15,1,
9364,2012-01-31,1,1,1,0,2,1,1,0.3,0.2727,0.42,0.2985,1,7,8,8,1,Pagi
9365,2012-01-31,1,1,2,0,2,1,1,0.3,0.2879,0.42,0.2239,0,2,2,2,1,Pagi
9366,2012-01-31,1,1,3,0,2,1,1,0.3,0.2879,0.45,0.2239,0,2,2,2,1,Pagi
9367,2012-01-31,1,1,4,0,2,1,1,0.3,0.2879,0.49,0.194,0,1,1,1,1,Pagi
9368,2012-01-31,1,1,5,0,2,1,1,0.3,0.2879,0.49,0.194,0,22,22,22,1,Pagi
9369,2012-01-31,1,1,6,0,2,1,1,0.28,0.2727,0.52,0.1642,0,104,104,104,1,Pagi
9370,2012-01-31,1,1,7,0,2,1,1,0.26,0.2576,0.6,0.194,6,273,279,279,1,Siang
9371,2012-01-31,1,1,8,0,2,1,1,0.26,0.2727,0.6,0.1045,14,498,512,512,1,Siang
9372,2012-01-31,1,1,9,0,2,1,1,0.3,0.2879,0.52,0.194,30,231,261,261,1,Siang
9373,2012-01-31,1,1,10,0,2,1,2,0.32,0.3182,0.57,0.194,34,110,144,144,1,Siang
9374,2012-01-31,1,1,11,0,2,1,1,0.4,0.4091,0.37,0.2836,14,125,139,139,1,Siang
9375,2012-01-31,1,1,12,0,2,1,1,0.4,0.4091,0.43,0.2985,13,181,194,194,1,Siang
9376,2012-01-31,1,1,13,0,2,1,1,0.46,0.4545,0.36,0.2239,27,171,198,198,1,Sore
9377,2012-01-31,1,1,14,0,2,1,1,0.5,0.4848,0.29,0.3284,18,142,160,160,1,Sore
9378,2012-01-31,1,1,15,0,2,1,1,0.54,0.5152,0.26,0.4478,27,150,177,177,1,Sore
9379,2012-01-31,1,1,16,0,2,1,1,0.54,0.5152,0.26,0.4478,30,277,307,307,1,Sore
9380,2012-01-31,1,1,17,0,2,1,1,0.54,0.5152,0.26,0.4179,41,518,559,559,1,Sore
9381,2012-01-31,1,1,18,0,2,1,1,0.54,0.5152,0.24,0.3582,16,486,502,502,1,Sore
9382,2012-01-31,1,1,19,0,2,1,1,0.5,0.4848,0.29,0.2836,22,306,328,328,1,Malam
9383,2012-01-31,1,1,20,0,2,1,1,0.4,0.4091,0.58,0.1045,15,223,238,238,1,Malam
9384,2012-01-31,1,1,21,0,2,1,1,0.46,0.4545,0.33,0.2985,3,162,165,165,1,Malam
9385,2012-01-31,1,1,22,0,2,1,1,0.44,0.4394,0.35,0.2985,11,118,129,129,1,Malam
9386,2012-01-31,1,1,23,0,2,1,1,0.44,0.4394,0.38,0.2537,2,61,63,63,1,Malam
9387,2012-02-01,1,2,0,0,3,1,1,0.44,0.4394,0.38,0.2836,0,31,31,31,1,
9388,2012-02-01,1,2,1,0,3,1,1,0.44,0.4394,0.41,0.2836,0,4,4,4,1,Pagi
9389,2012-02-01,1,2,2,0,3,1,1,0.44,0.4394,0.44,0.2836,1,6,7,7,1,Pagi
9390,2012-02-01,1,2,3,0,3,1,1,0.44,0.4394,0.44,0.194,0,3,3,3,1,Pagi
9391,2012-02-01,1,2,4,0,3,1,1,0.4,0.4091,0.5,0.1642,0,1,1,1,1,Pagi
9392,2012-02-01,1,2,5,0,3,1,1,0.4,0.4091,0.5,0.1642,0,18,18,18,1,Pagi
9393,2012-02-01,1,2,6,0,3,1,3,0.4,0.4091,0.54,0.1642,0,67,67,67,1,Pagi
9394,2012-02-01,1,2,7,0,3,1,3,0.38,0.3939,0.62,0.0896,7,201,208,208,1,Siang
9395,2012-02-01,1,2,8,0,3,1,3,0.36,0.3636,0.73,0.1045,15,505,520,520,1,Siang
9396,2012-02-01,1,2,9,0,3,1,2,0.36,0.3485,0.71,0.194,9,267,276,276,1,Siang
9397,2012-02-01,1,2,10,0,3,1,1,0.4,0.4091,0.62,0.1343,9,124,133,133,1,Siang
9398,2012-02-01,1,2,11,0,3,1,1,0.4,0.4091,0.58,0.1642,27,116,143,143,1,Siang
9399,2012-02-01,1,2,12,0,3,1,1,0.44,0.4394,0.54,0.1045,26,153,179,179,1,Siang
9400,2012-02-01,1,2,13,0,3,1,1,0.46,0.4545,0.47,0.2239,12,174,186,186,1,Sore
9401,2012-02-01,1,2,14,0,3,1,1,0.62,0.6212,0.33,0.2239,33,159,192,192,1,Sore
9402,2012-02-01,1,2,15,0,3,1,1,0.6,0.6212,0.35,0.2836,25,169,194,194,1,Sore
9403,2012-02-01,1,2,16,0,3,1,1,0.6,0.6212,0.4,0.2239,22,261,283,283,1,Sore
9404,2012-02-01,1,2,17,0,3,1,1,0.58,0.5455,0.43,0.194,31,508,539,539,1,Sore
9405,2012-02-01,1,2,18,0,3,1,1,0.56,0.5303,0.46,0.1642,12,514,526,526,1,Sore
9406,2012-02-01,1,2,19,0,3,1,1,0.54,0.5152,0.52,0.2836,20,315,335,335,1,Malam
9407,2012-02-01,1,2,20,0,3,1,1,0.52,0.5,0.52,0.1642,10,254,264,264,1,Malam
9408,2012-02-01,1,2,21,0,3,1,1,0.52,0.5,0.52,0.1642,16,217,233,233,1,Malam
9409,2012-02-01,1,2,22,0,3,1,1,0.5,0.4848,0.55,0.194,7,133,140,140,1,Malam
9410,2012-02-01,1,2,23,0,3,1,1,0.46,0.4545,0.63,0.0896,22,75,97,97,1,Malam
9411,2012-02-02,1,2,0,0,4,1,1,0.46,0.4545,0.59,0.1343,7,24,31,31,1,
9412,2012-02-02,1,2,1,0,4,1,2,0.46,0.4545,0.55,0.0,3,14,17,17,1,Pagi
9413,2012-02-02,1,2,2,0,4,1,2,0.42,0.4242,0.67,0.1343,2,7,9,9,1,Pagi
9414,2012-02-02,1,2,3,0,4,1,2,0.42,0.4242,0.67,0.1343,0,2,2,2,1,Pagi
9415,2012-02-02,1,2,4,0,4,1,3,0.4,0.4091,0.82,0.0896,0,1,1,1,1,Pagi
9416,2012-02-02,1,2,5,0,4,1,3,0.4,0.4091,0.82,0.0,0,19,19,19,1,Pagi
9417,2012-02-02,1,2,6,0,4,1,3,0.36,0.3788,0.9,0.0,1,73,74,74,1,Pagi
9418,2012-02-02,1,2,7,0,4,1,3,0.36,0.3788,0.93,0.0,4,201,205,205,1,Siang
9419,2012-02-02,1,2,8,0,4,1,3,0.4,0.4091,0.87,0.0,9,436,445,445,1,Siang
9420,2012-02-02,1,2,9,0,4,1,3,0.38,0.3939,0.87,0.0,15,213,228,228,1,Siang
9421,2012-02-02,1,2,10,0,4,1,3,0.42,0.4242,0.77,0.1045,6,72,78,78,1,Siang
9422,2012-02-02,1,2,11,0,4,1,3,0.4,0.4091,0.82,0.2537,6,99,105,105,1,Siang
9423,2012-02-02,1,2,12,0,4,1,1,0.42,0.4242,0.82,0.0,8,140,148,148,1,Siang
9424,2012-02-02,1,2,13,0,4,1,2,0.42,0.4242,0.77,0.0,13,124,137,137,1,Sore
9425,2012-02-02,1,2,14,0,4,1,1,0.4,0.4091,0.76,0.1045,12,129,141,141,1,Sore
9426,2012-02-02,1,2,15,0,4,1,1,0.46,0.4545,0.67,0.1642,24,150,174,174,1,Sore
9427,2012-02-02,1,2,16,0,4,1,1,0.46,0.4545,0.55,0.2836,18,211,229,229,1,Sore
9428,2012-02-02,1,2,17,0,4,1,1,0.42,0.4242,0.54,0.4925,13,437,450,450,1,Sore
9429,2012-02-02,1,2,18,0,4,1,1,0.4,0.4091,0.43,0.4627,17,393,410,410,1,Sore
9430,2012-02-02,1,2,19,0,4,1,1,0.38,0.3939,0.43,0.5224,16,311,327,327,1,Malam
9431,2012-02-02,1,2,20,0,4,1,1,0.36,0.3182,0.46,0.5224,9,204,213,213,1,Malam
9432,2012-02-02,1,2,21,0,4,1,1,0.34,0.303,0.46,0.4179,4,144,148,148,1,Malam
9433,2012-02-02,1,2,22,0,4,1,1,0.32,0.2879,0.49,0.4179,3,106,109,109,1,Malam
9434,2012-02-02,1,2,23,0,4,1,1,0.32,0.303,0.49,0.2537,0,61,61,61,1,Malam
9435,2012-02-03,1,2,0,0,5,1,1,0.32,0.2879,0.53,0.3881,1,37,38,38,1,
9436,2012-02-03,1,2,1,0,5,1,1,0.3,0.2727,0.56,0.3284,3,19,22,22,1,Pagi
9437,2012-02-03,1,2,2,0,5,1,1,0.3,0.2879,0.52,0.2239,0,6,6,6,1,Pagi
9438,2012-02-03,1,2,3,0,5,1,1,0.28,0.2576,0.56,0.2985,0,4,4,4,1,Pagi
9439,2012-02-03,1,2,4,0,5,1,1,0.26,0.2576,0.6,0.2239,0,2,2,2,1,Pagi
9440,2012-02-03,1,2,5,0,5,1,1,0.26,0.2576,0.6,0.2239,0,17,17,17,1,Pagi
9441,2012-02-03,1,2,6,0,5,1,1,0.24,0.2424,0.65,0.1642,0,88,88,88,1,Pagi
9442,2012-02-03,1,2,7,0,5,1,1,0.24,0.2273,0.65,0.2239,10,216,226,226,1,Siang
9443,2012-02-03,1,2,8,0,5,1,1,0.24,0.2273,0.65,0.2239,12,429,441,441,1,Siang
9444,2012-02-03,1,2,9,0,5,1,1,0.24,0.2273,0.65,0.194,18,252,270,270,1,Siang
9445,2012-02-03,1,2,10,0,5,1,1,0.28,0.2576,0.56,0.2836,15,114,129,129,1,Siang
9446,2012-02-03,1,2,11,0,5,1,1,0.32,0.303,0.53,0.2985,15,149,164,164,1,Siang
9447,2012-02-03,1,2,12,0,5,1,1,0.34,0.3333,0.46,0.1343,25,191,216,216,1,Siang
9448,2012-02-03,1,2,13,0,5,1,1,0.36,0.3636,0.46,0.0,25,173,198,198,1,Sore
9449,2012-02-03,1,2,14,0,5,1,1,0.36,0.3485,0.46,0.2239,22,148,170,170,1,Sore
9450,2012-02-03,1,2,15,0,5,1,1,0.38,0.3939,0.4,0.0,48,168,216,216,1,Sore
9451,2012-02-03,1,2,16,0,5,1,1,0.4,0.4091,0.37,0.1045,36,275,311,311,1,Sore
9452,2012-02-03,1,2,17,0,5,1,1,0.4,0.4091,0.37,0.0896,30,458,488,488,1,Sore
9453,2012-02-03,1,2,18,0,5,1,1,0.38,0.3939,0.4,0.1343,17,368,385,385,1,Sore
9454,2012-02-03,1,2,19,0,5,1,1,0.34,0.3485,0.49,0.1045,11,256,267,267,1,Malam
9455,2012-02-03,1,2,20,0,5,1,1,0.34,0.3485,0.49,0.1045,8,155,163,163,1,Malam
9456,2012-02-03,1,2,21,0,5,1,1,0.34,0.3485,0.49,0.1045,8,126,134,134,1,Malam
9457,2012-02-03,1,2,22,0,5,1,1,0.34,0.3485,0.49,0.1045,3,116,119,119,1,Malam
9458,2012-02-03,1,2,23,0,5,1,1,0.26,0.2727,0.7,0.1045,3,74,77,77,1,Malam
9459,2012-02-04,1,2,0,0,6,0,1,0.26,0.2727,0.7,0.1045,10,76,86,86,1,
9460,2012-02-04,1,2,1,0,6,0,1,0.26,0.2727,0.7,0.1045,0,43,43,43,1,Pagi
9461,2012-02-04,1,2,2,0,6,0,1,0.24,0.2576,0.7,0.0896,6,38,44,44,1,Pagi
9462,2012-02-04,1,2,3,0,6,0,1,0.24,0.2879,0.75,0.0,1,17,18,18,1,Pagi
9463,2012-02-04,1,2,4,0,6,0,1,0.24,0.2576,0.81,0.0896,1,5,6,6,1,Pagi
9464,2012-02-04,1,2,5,0,6,0,1,0.24,0.2576,0.81,0.0896,1,3,4,4,1,Pagi
9465,2012-02-04,1,2,6,0,6,0,1,0.22,0.2273,0.87,0.1343,1,4,5,5,1,Pagi
9466,2012-02-04,1,2,7,0,6,0,2,0.24,0.2424,0.87,0.1343,1,27,28,28,1,Siang
9467,2012-02-04,1,2,8,0,6,0,1,0.24,0.2879,0.87,0.0,4,86,90,90,1,Siang
9468,2012-02-04,1,2,9,0,6,0,1,0.24,0.2424,0.81,0.1343,16,141,157,157,1,Siang
9469,2012-02-04,1,2,10,0,6,0,1,0.24,0.2576,0.87,0.1045,31,193,224,224,1,Siang
9470,2012-02-04,1,2,11,0,6,0,1,0.3,0.3333,0.7,0.0,46,224,270,270,1,Siang
9471,2012-02-04,1,2,12,0,6,0,2,0.3,0.3182,0.7,0.0896,40,260,300,300,1,Siang
9472,2012-02-04,1,2,13,0,6,0,2,0.3,0.2879,0.7,0.194,58,244,302,302,1,Sore
9473,2012-02-04,1,2,14,0,6,0,2,0.32,0.303,0.66,0.2239,47,229,276,276,1,Sore
9474,2012-02-04,1,2,15,0,6,0,2,0.32,0.303,0.66,0.2239,61,244,305,305,1,Sore
9475,2012-02-04,1,2,16,0,6,0,2,0.34,0.3333,0.61,0.1642,20,123,143,143,1,Sore
9476,2012-02-04,1,2,17,0,6,0,3,0.3,0.2879,0.7,0.194,13,54,67,67,1,Sore
9477,2012-02-04,1,2,18,0,6,0,3,0.28,0.2727,0.75,0.1642,6,58,64,64,1,Sore
9478,2012-02-04,1,2,19,0,6,0,3,0.26,0.2727,0.87,0.1343,5,75,80,80,1,Malam
9479,2012-02-04,1,2,20,0,6,0,3,0.24,0.2273,0.93,0.194,4,73,77,77,1,Malam
9480,2012-02-04,1,2,21,0,6,0,3,0.24,0.2424,0.93,0.1343,4,74,78,78,1,Malam
9481,2012-02-04,1,2,22,0,6,0,2,0.24,0.2576,0.87,0.0896,4,91,95,95,1,Malam
9482,2012-02-04,1,2,23,0,6,0,2,0.24,0.2424,0.87,0.1343,4,66,70,70,1,Malam
9483,2012-02-05,1,2,0,0,0,0,2,0.24,0.2424,0.87,0.1343,3,58,61,61,1,
9484,2012-02-05,1,2,1,0,0,0,2,0.24,0.2576,0.93,0.1045,5,46,51,51,1,Pagi
9485,2012-02-05,1,2,2,0,0,0,2,0.24,0.2576,0.93,0.1045,4,59,63,63,1,Pagi
9486,2012-02-05,1,2,3,0,0,0,3,0.24,0.2576,0.87,0.0896,4,13,17,17,1,Pagi
9487,2012-02-05,1,2,4,0,0,0,2,0.24,0.2424,0.87,0.1343,0,9,9,9,1,Pagi
9488,2012-02-05,1,2,5,0,0,0,3,0.26,0.2576,0.81,0.194,0,4,4,4,1,Pagi
9489,2012-02-05,1,2,6,0,0,0,2,0.26,0.2424,0.7,0.2537,0,4,4,4,1,Pagi
9490,2012-02-05,1,2,7,0,0,0,2,0.24,0.2424,0.75,0.1642,0,16,16,16,1,Siang
9491,2012-02-05,1,2,8,0,0,0,2,0.24,0.2424,0.75,0.1642,4,58,62,62,1,Siang
9492,2012-02-05,1,2,9,0,0,0,2,0.24,0.2273,0.7,0.2239,9,83,92,92,1,Siang
9493,2012-02-05,1,2,10,0,0,0,2,0.26,0.2424,0.65,0.2836,10,138,148,148,1,Siang
9494,2012-02-05,1,2,11,0,0,0,2,0.26,0.2576,0.7,0.194,22,160,182,182,1,Siang
9495,2012-02-05,1,2,12,0,0,0,2,0.26,0.2576,0.65,0.194,25,223,248,248,1,Siang
9496,2012-02-05,1,2,13,0,0,0,2,0.28,0.2727,0.61,0.1642,33,241,274,274,1,Sore
9497,2012-02-05,1,2,14,0,0,0,1,0.3,0.303,0.61,0.1642,40,203,243,243,1,Sore
9498,2012-02-05,1,2,15,0,0,0,2,0.3,0.2879,0.56,0.2537,55,217,272,272,1,Sore
9499,2012-02-05,1,2,16,0,0,0,1,0.3,0.2879,0.56,0.2239,35,261,296,296,1,Sore
9500,2012-02-05,1,2,17,0,0,0,1,0.32,0.3182,0.53,0.1642,31,275,306,306,1,Sore
9501,2012-02-05,1,2,18,0,0,0,1,0.3,0.2879,0.52,0.2537,10,171,181,181,1,Sore
9502,2012-02-05,1,2,19,0,0,0,1,0.3,0.2879,0.52,0.2239,6,63,69,69,1,Malam
9503,2012-02-05,1,2,20,0,0,0,1,0.28,0.2727,0.56,0.194,3,47,50,50,1,Malam
9504,2012-02-05,1,2,21,0,0,0,1,0.28,0.2879,0.56,0.1045,6,60,66,66,1,Malam
9505,2012-02-05,1,2,22,0,0,0,1,0.26,0.2727,0.6,0.1045,9,182,191,191,1,Malam
9506,2012-02-05,1,2,23,0,0,0,1,0.24,0.2424,0.7,0.1343,4,38,42,42,1,Malam
9507,2012-02-06,1,2,0,0,1,1,1,0.24,0.2424,0.65,0.1343,7,14,21,21,1,
9508,2012-02-06,1,2,1,0,1,1,1,0.22,0.2576,0.75,0.0896,0,6,6,6,1,Pagi
9509,2012-02-06,1,2,2,0,1,1,1,0.22,0.2727,0.75,0.0,0,3,3,3,1,Pagi
9510,2012-02-06,1,2,4,0,1,1,1,0.18,0.2121,0.8,0.1045,0,2,2,2,1,Pagi
9511,2012-02-06,1,2,5,0,1,1,1,0.18,0.2121,0.8,0.1045,0,17,17,17,1,Pagi
9512,2012-02-06,1,2,6,0,1,1,1,0.16,0.1818,0.86,0.1045,0,72,72,72,1,Pagi
9513,2012-02-06,1,2,7,0,1,1,1,0.16,0.1818,0.86,0.1045,5,229,234,234,1,Siang
9514,2012-02-06,1,2,8,0,1,1,1,0.16,0.1818,0.86,0.1343,10,434,444,444,1,Siang
9515,2012-02-06,1,2,9,0,1,1,1,0.18,0.2121,0.8,0.1045,8,269,277,277,1,Siang
9516,2012-02-06,1,2,10,0,1,1,1,0.22,0.2424,0.75,0.1045,20,96,116,116,1,Siang
9517,2012-02-06,1,2,11,0,1,1,1,0.26,0.2727,0.7,0.1343,12,104,116,116,1,Siang
9518,2012-02-06,1,2,12,0,1,1,1,0.32,0.3182,0.61,0.1642,19,131,150,150,1,Siang
9519,2012-02-06,1,2,13,0,1,1,1,0.38,0.3939,0.4,0.2239,17,124,141,141,1,Sore
9520,2012-02-06,1,2,14,0,1,1,1,0.4,0.4091,0.35,0.1642,14,126,140,140,1,Sore
9521,2012-02-06,1,2,15,0,1,1,1,0.42,0.4242,0.32,0.2836,25,146,171,171,1,Sore
9522,2012-02-06,1,2,16,0,1,1,1,0.4,0.4091,0.43,0.2537,13,215,228,228,1,Sore
9523,2012-02-06,1,2,17,0,1,1,1,0.4,0.4091,0.43,0.2537,13,417,430,430,1,Sore
9524,2012-02-06,1,2,18,0,1,1,1,0.38,0.3939,0.43,0.2239,11,426,437,437,1,Sore
9525,2012-02-06,1,2,19,0,1,1,1,0.36,0.3333,0.43,0.2537,7,284,291,291,1,Malam
9526,2012-02-06,1,2,20,0,1,1,1,0.34,0.3333,0.46,0.1642,7,194,201,201,1,Malam
9527,2012-02-06,1,2,21,0,1,1,1,0.32,0.3182,0.57,0.1642,11,143,154,154,1,Malam
9528,2012-02-06,1,2,22,0,1,1,1,0.3,0.303,0.65,0.1343,4,83,87,87,1,Malam
9529,2012-02-06,1,2,23,0,1,1,1,0.3,0.303,0.65,0.1343,3,43,46,46,1,Malam
9530,2012-02-07,1,2,0,0,2,1,1,0.3,0.2879,0.7,0.194,1,22,23,23,1,
9531,2012-02-07,1,2,1,0,2,1,1,0.28,0.2879,0.61,0.1343,8,6,14,14,1,Pagi
9532,2012-02-07,1,2,2,0,2,1,1,0.3,0.3333,0.61,0.0,0,4,4,4,1,Pagi
9533,2012-02-07,1,2,3,0,2,1,2,0.3,0.3333,0.7,0.0,1,1,2,2,1,Pagi
9534,2012-02-07,1,2,4,0,2,1,2,0.3,0.3333,0.7,0.0,0,3,3,3,1,Pagi
9535,2012-02-07,1,2,5,0,2,1,1,0.32,0.3333,0.49,0.0896,0,15,15,15,1,Pagi
9536,2012-02-07,1,2,6,0,2,1,1,0.32,0.303,0.45,0.2985,2,98,100,100,1,Pagi
9537,2012-02-07,1,2,7,0,2,1,1,0.32,0.3485,0.45,0.0,6,293,299,299,1,Siang
9538,2012-02-07,1,2,8,0,2,1,1,0.3,0.3182,0.49,0.0,7,522,529,529,1,Siang
9539,2012-02-07,1,2,9,0,2,1,1,0.32,0.3333,0.49,0.0,11,278,289,289,1,Siang
9540,2012-02-07,1,2,10,0,2,1,1,0.34,0.3333,0.46,0.1642,12,104,116,116,1,Siang
9541,2012-02-07,1,2,11,0,2,1,1,0.36,0.3485,0.46,0.194,9,120,129,129,1,Siang
9542,2012-02-07,1,2,12,0,2,1,1,0.4,0.4091,0.4,0.3284,9,163,172,172,1,Siang
9543,2012-02-07,1,2,13,0,2,1,1,0.44,0.4394,0.38,0.2537,15,169,184,184,1,Sore
9544,2012-02-07,1,2,14,0,2,1,1,0.44,0.4394,0.38,0.2537,11,127,138,138,1,Sore
9545,2012-02-07,1,2,15,0,2,1,1,0.44,0.4394,0.38,0.194,13,133,146,146,1,Sore
9546,2012-02-07,1,2,16,0,2,1,1,0.44,0.4394,0.35,0.2537,19,257,276,276,1,Sore
9547,2012-02-07,1,2,17,0,2,1,1,0.44,0.4394,0.35,0.194,15,494,509,509,1,Sore
9548,2012-02-07,1,2,18,0,2,1,1,0.42,0.4242,0.38,0.194,10,508,518,518,1,Sore
9549,2012-02-07,1,2,19,0,2,1,1,0.38,0.3939,0.43,0.2239,11,327,338,338,1,Malam
9550,2012-02-07,1,2,20,0,2,1,1,0.36,0.3485,0.5,0.1343,6,206,212,212,1,Malam
9551,2012-02-07,1,2,21,0,2,1,1,0.34,0.3485,0.61,0.1045,20,170,190,190,1,Malam
9552,2012-02-07,1,2,22,0,2,1,1,0.32,0.3182,0.57,0.194,11,107,118,118,1,Malam
9553,2012-02-07,1,2,23,0,2,1,1,0.32,0.3333,0.57,0.1343,2,49,51,51,1,Malam
9554,2012-02-08,1,2,0,0,3,1,1,0.3,0.2879,0.56,0.2239,2,21,23,23,1,
9555,2012-02-08,1,2,1,0,3,1,1,0.28,0.2727,0.61,0.1642,1,9,10,10,1,Pagi
9556,2012-02-08,1,2,2,0,3,1,1,0.26,0.303,0.65,0.0,0,1,1,1,1,Pagi
9557,2012-02-08,1,2,3,0,3,1,1,0.26,0.303,0.65,0.0,0,1,1,1,1,Pagi
9558,2012-02-08,1,2,4,0,3,1,1,0.24,0.2576,0.7,0.0896,0,1,1,1,1,Pagi
9559,2012-02-08,1,2,5,0,3,1,1,0.24,0.2576,0.7,0.0896,0,20,20,20,1,Pagi
9560,2012-02-08,1,2,6,0,3,1,2,0.24,0.2879,0.7,0.0,3,95,98,98,1,Pagi
9561,2012-02-08,1,2,7,0,3,1,2,0.24,0.2576,0.7,0.1045,5,276,281,281,1,Siang
9562,2012-02-08,1,2,8,0,3,1,2,0.24,0.2273,0.7,0.2239,13,495,508,508,1,Siang
9563,2012-02-08,1,2,9,0,3,1,2,0.24,0.2576,0.7,0.1642,8,245,253,253,1,Siang
9564,2012-02-08,1,2,10,0,3,1,2,0.26,0.2576,0.7,0.2239,1,107,108,108,1,Siang
9565,2012-02-08,1,2,11,0,3,1,2,0.26,0.2576,0.65,0.2239,5,97,102,102,1,Siang
9566,2012-02-08,1,2,12,0,3,1,2,0.28,0.2576,0.65,0.2836,14,124,138,138,1,Siang
9567,2012-02-08,1,2,13,0,3,1,2,0.28,0.2879,0.61,0.1045,15,111,126,126,1,Sore
9568,2012-02-08,1,2,14,0,3,1,2,0.3,0.303,0.56,0.1642,8,100,108,108,1,Sore
9569,2012-02-08,1,2,15,0,3,1,3,0.3,0.3182,0.61,0.1045,5,49,54,54,1,Sore
9570,2012-02-08,1,2,16,0,3,1,3,0.26,0.2727,0.81,0.1045,2,73,75,75,1,Sore
9571,2012-02-08,1,2,17,0,3,1,3,0.24,0.2576,0.87,0.1045,8,147,155,155,1,Sore
9572,2012-02-08,1,2,18,0,3,1,3,0.24,0.2576,0.87,0.1045,4,163,167,167,1,Sore
9573,2012-02-08,1,2,19,0,3,1,3,0.24,0.2576,0.87,0.1045,3,158,161,161,1,Malam
9574,2012-02-08,1,2,20,0,3,1,3,0.24,0.2424,0.87,0.1343,3,122,125,125,1,Malam
9575,2012-02-08,1,2,21,0,3,1,3,0.24,0.2273,0.87,0.194,3,126,129,129,1,Malam
9576,2012-02-08,1,2,22,0,3,1,2,0.24,0.2424,0.87,0.1343,3,95,98,98,1,Malam
9577,2012-02-08,1,2,23,0,3,1,2,0.24,0.2424,0.87,0.1642,3,57,60,60,1,Malam
9578,2012-02-09,1,2,0,0,4,1,2,0.24,0.2424,0.87,0.1642,3,23,26,26,1,
9579,2012-02-09,1,2,1,0,4,1,2,0.24,0.2424,0.87,0.1343,2,10,12,12,1,Pagi
9580,2012-02-09,1,2,2,0,4,1,1,0.22,0.2273,0.8,0.1343,0,2,2,2,1,Pagi
9581,2012-02-09,1,2,3,0,4,1,1,0.22,0.2121,0.8,0.2836,0,4,4,4,1,Pagi
9582,2012-02-09,1,2,4,0,4,1,2,0.22,0.197,0.75,0.4478,0,1,1,1,1,Pagi
9583,2012-02-09,1,2,5,0,4,1,1,0.2,0.1818,0.75,0.2836,0,18,18,18,1,Pagi
9584,2012-02-09,1,2,6,0,4,1,1,0.2,0.1818,0.75,0.2836,1,75,76,76,1,Pagi
9585,2012-02-09,1,2,7,0,4,1,1,0.2,0.197,0.69,0.2537,4,263,267,267,1,Siang
9586,2012-02-09,1,2,8,0,4,1,1,0.2,0.197,0.64,0.2537,11,473,484,484,1,Siang
9587,2012-02-09,1,2,9,0,4,1,1,0.2,0.197,0.59,0.2239,9,229,238,238,1,Siang
9588,2012-02-09,1,2,10,0,4,1,1,0.22,0.2121,0.51,0.2239,7,90,97,97,1,Siang
9589,2012-02-09,1,2,11,0,4,1,1,0.24,0.2273,0.52,0.2239,4,95,99,99,1,Siang
9590,2012-02-09,1,2,12,0,4,1,1,0.26,0.2273,0.48,0.3284,10,148,158,158,1,Siang
9591,2012-02-09,1,2,13,0,4,1,1,0.3,0.2727,0.42,0.3284,10,144,154,154,1,Sore
9592,2012-02-09,1,2,14,0,4,1,1,0.32,0.303,0.39,0.2985,18,126,144,144,1,Sore
9593,2012-02-09,1,2,15,0,4,1,1,0.32,0.303,0.36,0.2985,14,120,134,134,1,Sore
9594,2012-02-09,1,2,16,0,4,1,1,0.34,0.3333,0.36,0.0,15,223,238,238,1,Sore
9595,2012-02-09,1,2,17,0,4,1,1,0.34,0.3333,0.34,0.1343,12,387,399,399,1,Sore
9596,2012-02-09,1,2,18,0,4,1,1,0.34,0.3333,0.31,0.1642,13,404,417,417,1,Sore
9597,2012-02-09,1,2,19,0,4,1,1,0.32,0.3333,0.33,0.1045,8,287,295,295,1,Malam
9598,2012-02-09,1,2,20,0,4,1,1,0.32,0.3485,0.36,0.0,2,197,199,199,1,Malam
9599,2012-02-09,1,2,21,0,4,1,1,0.3,0.3182,0.52,0.0896,8,169,177,177,1,Malam
9600,2012-02-09,1,2,22,0,4,1,2,0.3,0.3333,0.56,0.0,3,104,107,107,1,Malam
9601,2012-02-09,1,2,23,0,4,1,2,0.3,0.3333,0.52,0.0,9,75,84,84,1,Malam
9602,2012-02-10,1,2,0,0,5,1,2,0.28,0.303,0.65,0.0896,4,39,43,43,1,
9603,2012-02-10,1,2,1,0,5,1,2,0.28,0.303,0.61,0.0896,2,11,13,13,1,Pagi
9604,2012-02-10,1,2,2,0,5,1,1,0.26,0.2879,0.52,0.0896,7,9,16,16,1,Pagi
9605,2012-02-10,1,2,3,0,5,1,1,0.26,0.2879,0.56,0.0896,0,5,5,5,1,Pagi
9606,2012-02-10,1,2,4,0,5,1,1,0.26,0.2879,0.56,0.0896,0,2,2,2,1,Pagi
9607,2012-02-10,1,2,5,0,5,1,1,0.24,0.2273,0.52,0.2239,0,17,17,17,1,Pagi
9608,2012-02-10,1,2,6,0,5,1,1,0.2,0.197,0.59,0.194,3,61,64,64,1,Pagi
9609,2012-02-10,1,2,7,0,5,1,1,0.2,0.2121,0.59,0.1642,5,225,230,230,1,Siang
9610,2012-02-10,1,2,8,0,5,1,1,0.2,0.2121,0.59,0.1642,1,447,448,448,1,Siang
9611,2012-02-10,1,2,9,0,5,1,1,0.22,0.2273,0.55,0.1642,10,265,275,275,1,Siang
9612,2012-02-10,1,2,10,0,5,1,2,0.26,0.2727,0.48,0.1343,5,119,124,124,1,Siang
9613,2012-02-10,1,2,11,0,5,1,2,0.28,0.2879,0.45,0.1045,19,134,153,153,1,Siang
9614,2012-02-10,1,2,12,0,5,1,2,0.3,0.303,0.42,0.1343,8,168,176,176,1,Siang
9615,2012-02-10,1,2,13,0,5,1,2,0.3,0.3182,0.42,0.0896,22,170,192,192,1,Sore
9616,2012-02-10,1,2,14,0,5,1,2,0.32,0.3333,0.39,0.0896,8,138,146,146,1,Sore
9617,2012-02-10,1,2,15,0,5,1,2,0.32,0.3333,0.45,0.1343,27,164,191,191,1,Sore
9618,2012-02-10,1,2,16,0,5,1,2,0.34,0.3182,0.42,0.2537,28,240,268,268,1,Sore
9619,2012-02-10,1,2,17,0,5,1,2,0.34,0.3333,0.42,0.194,15,381,396,396,1,Sore
9620,2012-02-10,1,2,18,0,5,1,3,0.3,0.303,0.61,0.1343,14,345,359,359,1,Sore
9621,2012-02-10,1,2,19,0,5,1,2,0.32,0.3485,0.57,0.0,16,246,262,262,1,Malam
9622,2012-02-10,1,2,20,0,5,1,2,0.32,0.3485,0.57,0.0,7,144,151,151,1,Malam
9623,2012-02-10,1,2,21,0,5,1,2,0.32,0.3333,0.66,0.0896,14,108,122,122,1,Malam
9624,2012-02-10,1,2,22,0,5,1,2,0.32,0.3485,0.66,0.0,11,102,113,113,1,Malam
9625,2012-02-10,1,2,23,0,5,1,2,0.3,0.3182,0.7,0.0896,1,64,65,65,1,Malam
9626,2012-02-11,1,2,0,0,6,0,2,0.3,0.303,0.7,0.1343,3,50,53,53,1,
9627,2012-02-11,1,2,1,0,6,0,3,0.28,0.2879,0.81,0.1343,2,43,45,45,1,Pagi
9628,2012-02-11,1,2,2,0,6,0,3,0.26,0.2576,0.81,0.194,2,24,26,26,1,Pagi
9629,2012-02-11,1,2,3,0,6,0,3,0.24,0.2273,0.87,0.2239,0,9,9,9,1,Pagi
9630,2012-02-11,1,2,4,0,6,0,3,0.24,0.2273,0.87,0.2239,0,4,4,4,1,Pagi
9631,2012-02-11,1,2,5,0,6,0,3,0.22,0.2273,0.93,0.1642,0,2,2,2,1,Pagi
9632,2012-02-11,1,2,6,0,6,0,3,0.22,0.2273,0.93,0.1343,1,8,9,9,1,Pagi
9633,2012-02-11,1,2,7,0,6,0,3,0.22,0.2273,0.93,0.1343,0,19,19,19,1,Siang
9634,2012-02-11,1,2,8,0,6,0,3,0.22,0.2273,0.93,0.1343,1,77,78,78,1,Siang
9635,2012-02-11,1,2,9,0,6,0,3,0.22,0.2424,0.93,0.1045,5,85,90,90,1,Siang
9636,2012-02-11,1,2,10,0,6,0,3,0.22,0.2424,0.93,0.1045,23,143,166,166,1,Siang
9637,2012-02-11,1,2,11,0,6,0,2,0.24,0.2576,0.81,0.1045,26,157,183,183,1,Siang
9638,2012-02-11,1,2,12,0,6,0,2,0.26,0.2576,0.81,0.1642,25,196,221,221,1,Siang
9639,2012-02-11,1,2,13,0,6,0,2,0.26,0.2424,0.81,0.2836,18,217,235,235,1,Sore
9640,2012-02-11,1,2,14,0,6,0,2,0.26,0.2424,0.81,0.2537,38,205,243,243,1,Sore
9641,2012-02-11,1,2,15,0,6,0,2,0.3,0.2727,0.61,0.2985,12,112,124,124,1,Sore
9642,2012-02-11,1,2,16,0,6,0,3,0.22,0.197,0.75,0.4179,12,134,146,146,1,Sore
9643,2012-02-11,1,2,17,0,6,0,3,0.22,0.1818,0.69,0.4627,13,131,144,144,1,Sore
9644,2012-02-11,1,2,18,0,6,0,2,0.22,0.1818,0.47,0.6567,3,105,108,108,1,Sore
9645,2012-02-11,1,2,19,0,6,0,2,0.2,0.1515,0.4,0.5522,2,85,87,87,1,Malam
9646,2012-02-11,1,2,20,0,6,0,2,0.16,0.1212,0.43,0.5522,1,62,63,63,1,Malam
9647,2012-02-11,1,2,21,0,6,0,1,0.14,0.0758,0.43,0.6418,5,43,48,48,1,Malam
9648,2012-02-11,1,2,22,0,6,0,2,0.14,0.1061,0.39,0.3881,0,46,46,46,1,Malam
9649,2012-02-11,1,2,23,0,6,0,3,0.12,0.0758,0.5,0.4925,0,20,20,20,1,Malam
9650,2012-02-12,1,2,0,0,0,0,3,0.1,0.0758,0.68,0.3881,0,21,21,21,1,
9651,2012-02-12,1,2,1,0,0,0,3,0.08,0.0455,0.79,0.4627,0,24,24,24,1,Pagi
9652,2012-02-12,1,2,2,0,0,0,2,0.1,0.0606,0.58,0.5821,1,26,27,27,1,Pagi
9653,2012-02-12,1,2,3,0,0,0,2,0.1,0.0455,0.46,0.6866,0,14,14,14,1,Pagi
9654,2012-02-12,1,2,4,0,0,0,2,0.1,0.0455,0.46,0.7164,0,1,1,1,1,Pagi
9655,2012-02-12,1,2,5,0,0,0,1,0.1,0.0758,0.49,0.3881,0,3,3,3,1,Pagi
9656,2012-02-12,1,2,6,0,0,0,1,0.1,0.0758,0.49,0.3881,0,2,2,2,1,Pagi
9657,2012-02-12,1,2,7,0,0,0,1,0.08,0.0909,0.53,0.194,0,18,18,18,1,Siang
9658,2012-02-12,1,2,8,0,0,0,1,0.08,0.0758,0.53,0.2537,0,26,26,26,1,Siang
9659,2012-02-12,1,2,9,0,0,0,1,0.1,0.0909,0.49,0.2985,3,60,63,63,1,Siang
9660,2012-02-12,1,2,10,0,0,0,1,0.12,0.1061,0.42,0.3582,8,83,91,91,1,Siang
9661,2012-02-12,1,2,11,0,0,0,1,0.12,0.1061,0.42,0.2985,3,121,124,124,1,Siang
9662,2012-02-12,1,2,12,0,0,0,1,0.14,0.0758,0.39,0.6418,7,133,140,140,1,Siang
9663,2012-02-12,1,2,13,0,0,0,1,0.16,0.1212,0.4,0.4478,10,128,138,138,1,Sore
9664,2012-02-12,1,2,14,0,0,0,1,0.16,0.1212,0.4,0.5224,9,102,111,111,1,Sore
9665,2012-02-12,1,2,15,0,0,0,1,0.16,0.1212,0.4,0.5522,5,150,155,155,1,Sore
9666,2012-02-12,1,2,16,0,0,0,1,0.2,0.1667,0.34,0.4627,16,148,164,164,1,Sore
9667,2012-02-12,1,2,17,0,0,0,1,0.18,0.1515,0.37,0.4179,4,83,87,87,1,Sore
9668,2012-02-12,1,2,18,0,0,0,1,0.16,0.1212,0.4,0.4627,4,92,96,96,1,Sore
9669,2012-02-12,1,2,19,0,0,0,1,0.16,0.1364,0.4,0.2836,2,78,80,80,1,Malam
9670,2012-02-12,1,2,20,0,0,0,1,0.14,0.1212,0.42,0.3284,1,56,57,57,1,Malam
9671,2012-02-12,1,2,21,0,0,0,1,0.14,0.1212,0.43,0.2985,0,36,36,36,1,Malam
9672,2012-02-12,1,2,22,0,0,0,1,0.14,0.1515,0.43,0.1642,0,28,28,28,1,Malam
9673,2012-02-12,1,2,23,0,0,0,1,0.14,0.1364,0.43,0.2239,0,23,23,23,1,Malam
9674,2012-02-13,1,2,0,0,1,1,1,0.14,0.1364,0.46,0.2239,0,9,9,9,1,
9675,2012-02-13,1,2,1,0,1,1,1,0.12,0.1212,0.5,0.2239,0,6,6,6,1,Pagi
9676,2012-02-13,1,2,2,0,1,1,1,0.14,0.1364,0.46,0.194,0,4,4,4,1,Pagi
9677,2012-02-13,1,2,3,0,1,1,1,0.12,0.1515,0.54,0.1045,0,1,1,1,1,Pagi
9678,2012-02-13,1,2,4,0,1,1,1,0.12,0.1667,0.54,0.0896,0,2,2,2,1,Pagi
9679,2012-02-13,1,2,5,0,1,1,1,0.1,0.1212,0.58,0.1343,0,17,17,17,1,Pagi
9680,2012-02-13,1,2,6,0,1,1,1,0.1,0.1061,0.54,0.2239,1,71,72,72,1,Pagi
9681,2012-02-13,1,2,7,0,1,1,1,0.1,0.1061,0.54,0.194,1,194,195,195,1,Siang
9682,2012-02-13,1,2,8,0,1,1,1,0.1,0.1212,0.54,0.1343,4,413,417,417,1,Siang
9683,2012-02-13,1,2,9,0,1,1,1,0.12,0.1364,0.5,0.194,7,198,205,205,1,Siang
9684,2012-02-13,1,2,10,0,1,1,1,0.14,0.1515,0.5,0.1343,1,70,71,71,1,Siang
9685,2012-02-13,1,2,11,0,1,1,1,0.22,0.2273,0.37,0.194,5,85,90,90,1,Siang
9686,2012-02-13,1,2,12,0,1,1,1,0.28,0.2576,0.28,0.3284,7,111,118,118,1,Siang
9687,2012-02-13,1,2,13,0,1,1,1,0.32,0.303,0.22,0.2239,11,129,140,140,1,Sore
9688,2012-02-13,1,2,14,0,1,1,1,0.34,0.3485,0.23,0.1045,10,125,135,135,1,Sore
9689,2012-02-13,1,2,15,0,1,1,1,0.36,0.3485,0.27,0.1343,10,145,155,155,1,Sore
9690,2012-02-13,1,2,16,0,1,1,1,0.36,0.3485,0.23,0.194,5,206,211,211,1,Sore
9691,2012-02-13,1,2,17,0,1,1,1,0.36,0.3485,0.23,0.194,8,399,407,407,1,Sore
9692,2012-02-13,1,2,18,0,1,1,1,0.34,0.3182,0.25,0.2537,6,399,405,405,1,Sore
9693,2012-02-13,1,2,19,0,1,1,1,0.34,0.3333,0.25,0.1343,7,256,263,263,1,Malam
9694,2012-02-13,1,2,20,0,1,1,1,0.3,0.303,0.42,0.1642,4,210,214,214,1,Malam
9695,2012-02-13,1,2,21,0,1,1,1,0.28,0.2879,0.45,0.1343,2,145,147,147,1,Malam
9696,2012-02-13,1,2,22,0,1,1,1,0.26,0.2727,0.56,0.1045,3,99,102,102,1,Malam
9697,2012-02-13,1,2,23,0,1,1,1,0.28,0.3182,0.41,0.0,2,34,36,36,1,Malam
9698,2012-02-14,1,2,0,0,2,1,2,0.26,0.303,0.6,0.0,0,14,14,14,1,
9699,2012-02-14,1,2,1,0,2,1,2,0.26,0.303,0.56,0.0,0,6,6,6,1,Pagi
9700,2012-02-14,1,2,2,0,2,1,2,0.28,0.3182,0.41,0.0,0,3,3,3,1,Pagi
9701,2012-02-14,1,2,3,0,2,1,2,0.26,0.303,0.52,0.0,0,3,3,3,1,Pagi
9702,2012-02-14,1,2,4,0,2,1,2,0.26,0.2727,0.65,0.1045,0,2,2,2,1,Pagi
9703,2012-02-14,1,2,5,0,2,1,2,0.26,0.2727,0.65,0.1045,2,20,22,22,1,Pagi
9704,2012-02-14,1,2,6,0,2,1,2,0.26,0.303,0.56,0.0,1,89,90,90,1,Pagi
9705,2012-02-14,1,2,7,0,2,1,2,0.24,0.2576,0.6,0.0896,4,276,280,280,1,Siang
9706,2012-02-14,1,2,8,0,2,1,2,0.24,0.2879,0.7,0.0,3,510,513,513,1,Siang
9707,2012-02-14,1,2,9,0,2,1,2,0.26,0.2879,0.56,0.0896,6,256,262,262,1,Siang
9708,2012-02-14,1,2,10,0,2,1,2,0.26,0.2727,0.6,0.1343,8,90,98,98,1,Siang
9709,2012-02-14,1,2,11,0,2,1,2,0.3,0.303,0.45,0.1642,5,107,112,112,1,Siang
9710,2012-02-14,1,2,12,0,2,1,2,0.3,0.2879,0.52,0.2239,10,162,172,172,1,Siang
9711,2012-02-14,1,2,13,0,2,1,2,0.36,0.3333,0.4,0.2537,6,167,173,173,1,Sore
9712,2012-02-14,1,2,14,0,2,1,1,0.4,0.4091,0.4,0.2239,13,111,124,124,1,Sore
9713,2012-02-14,1,2,15,0,2,1,2,0.42,0.4242,0.38,0.4478,7,138,145,145,1,Sore
9714,2012-02-14,1,2,16,0,2,1,1,0.42,0.4242,0.35,0.2985,15,251,266,266,1,Sore
9715,2012-02-14,1,2,17,0,2,1,1,0.42,0.4242,0.38,0.3582,19,504,523,523,1,Sore
9716,2012-02-14,1,2,18,0,2,1,2,0.38,0.3939,0.46,0.2985,8,398,406,406,1,Sore
9717,2012-02-14,1,2,19,0,2,1,2,0.36,0.3485,0.5,0.1642,11,270,281,281,1,Malam
9718,2012-02-14,1,2,20,0,2,1,2,0.38,0.3939,0.46,0.1343,6,178,184,184,1,Malam
9719,2012-02-14,1,2,21,0,2,1,2,0.36,0.3636,0.5,0.1045,4,105,109,109,1,Malam
9720,2012-02-14,1,2,22,0,2,1,2,0.36,0.3636,0.5,0.1045,5,72,77,77,1,Malam
9721,2012-02-14,1,2,23,0,2,1,2,0.36,0.3636,0.5,0.0896,2,55,57,57,1,Malam
9722,2012-02-15,1,2,0,0,3,1,1,0.32,0.3485,0.57,0.0,0,22,22,22,1,
9723,2012-02-15,1,2,1,0,3,1,1,0.34,0.3636,0.53,0.0,0,5,5,5,1,Pagi
9724,2012-02-15,1,2,2,0,3,1,1,0.3,0.3333,0.61,0.0,0,4,4,4,1,Pagi
9725,2012-02-15,1,2,3,0,3,1,1,0.28,0.3182,0.75,0.0,0,3,3,3,1,Pagi
9726,2012-02-15,1,2,4,0,3,1,1,0.28,0.2879,0.7,0.1045,0,1,1,1,1,Pagi
9727,2012-02-15,1,2,5,0,3,1,1,0.28,0.2879,0.7,0.1045,0,25,25,25,1,Pagi
9728,2012-02-15,1,2,6,0,3,1,1,0.3,0.303,0.61,0.1343,3,92,95,95,1,Pagi
9729,2012-02-15,1,2,7,0,3,1,2,0.3,0.2879,0.65,0.194,3,318,321,321,1,Siang
9730,2012-02-15,1,2,8,0,3,1,1,0.32,0.2879,0.61,0.3582,7,508,515,515,1,Siang
9731,2012-02-15,1,2,9,0,3,1,1,0.32,0.303,0.61,0.3284,5,226,231,231,1,Siang
9732,2012-02-15,1,2,10,0,3,1,1,0.34,0.303,0.57,0.2985,12,108,120,120,1,Siang
9733,2012-02-15,1,2,11,0,3,1,1,0.36,0.3333,0.53,0.2836,13,125,138,138,1,Siang
9734,2012-02-15,1,2,12,0,3,1,1,0.38,0.3939,0.46,0.3881,11,152,163,163,1,Siang
9735,2012-02-15,1,2,13,0,3,1,1,0.4,0.4091,0.43,0.2836,11,159,170,170,1,Sore
9736,2012-02-15,1,2,14,0,3,1,1,0.42,0.4242,0.41,0.3582,6,128,134,134,1,Sore
9737,2012-02-15,1,2,15,0,3,1,1,0.42,0.4242,0.41,0.2239,7,164,171,171,1,Sore
9738,2012-02-15,1,2,16,0,3,1,1,0.42,0.4242,0.38,0.194,9,222,231,231,1,Sore
9739,2012-02-15,1,2,17,0,3,1,1,0.42,0.4242,0.38,0.194,17,470,487,487,1,Sore
9740,2012-02-15,1,2,18,0,3,1,1,0.4,0.4091,0.4,0.2239,9,459,468,468,1,Sore
9741,2012-02-15,1,2,19,0,3,1,1,0.38,0.3939,0.43,0.1642,9,302,311,311,1,Malam
9742,2012-02-15,1,2,20,0,3,1,1,0.36,0.3485,0.46,0.1642,4,207,211,211,1,Malam
9743,2012-02-15,1,2,21,0,3,1,1,0.34,0.3333,0.53,0.1642,8,170,178,178,1,Malam
9744,2012-02-15,1,2,22,0,3,1,1,0.34,0.3485,0.49,0.1045,3,104,107,107,1,Malam
9745,2012-02-15,1,2,23,0,3,1,1,0.34,0.3485,0.53,0.0896,4,54,58,58,1,Malam
9746,2012-02-16,1,2,0,0,4,1,2,0.3,0.303,0.7,0.1343,1,22,23,23,1,
9747,2012-02-16,1,2,1,0,4,1,2,0.3,0.3333,0.7,0.0,0,5,5,5,1,Pagi
9748,2012-02-16,1,2,2,0,4,1,2,0.3,0.3182,0.7,0.0896,1,6,7,7,1,Pagi
9749,2012-02-16,1,2,3,0,4,1,2,0.3,0.3333,0.61,0.0,0,1,1,1,1,Pagi
9750,2012-02-16,1,2,4,0,4,1,3,0.3,0.3182,0.7,0.0896,0,3,3,3,1,Pagi
9751,2012-02-16,1,2,5,0,4,1,2,0.3,0.3333,0.7,0.0,0,20,20,20,1,Pagi
9752,2012-02-16,1,2,6,0,4,1,2,0.3,0.3182,0.7,0.0896,4,83,87,87,1,Pagi
9753,2012-02-16,1,2,7,0,4,1,2,0.3,0.303,0.7,0.1343,3,285,288,288,1,Siang
9754,2012-02-16,1,2,8,0,4,1,2,0.3,0.3182,0.7,0.0896,9,489,498,498,1,Siang
9755,2012-02-16,1,2,9,0,4,1,2,0.3,0.303,0.7,0.1642,3,199,202,202,1,Siang
9756,2012-02-16,1,2,10,0,4,1,3,0.32,0.3333,0.7,0.1343,2,42,44,44,1,Siang
9757,2012-02-16,1,2,11,0,4,1,3,0.32,0.3333,0.7,0.1045,2,69,71,71,1,Siang
9758,2012-02-16,1,2,12,0,4,1,3,0.32,0.3333,0.76,0.0896,1,44,45,45,1,Siang
9759,2012-02-16,1,2,13,0,4,1,3,0.34,0.3182,0.71,0.2537,2,62,64,64,1,Sore
9760,2012-02-16,1,2,14,0,4,1,3,0.32,0.3182,0.81,0.194,1,30,31,31,1,Sore
9761,2012-02-16,1,2,15,0,4,1,3,0.34,0.3636,0.76,0.0,3,50,53,53,1,Sore
9762,2012-02-16,1,2,16,0,4,1,3,0.34,0.3636,0.81,0.0,8,110,118,118,1,Sore
9763,2012-02-16,1,2,17,0,4,1,3,0.34,0.3636,0.87,0.0,8,281,289,289,1,Sore
9764,2012-02-16,1,2,18,0,4,1,3,0.34,0.3333,0.87,0.1343,8,345,353,353,1,Sore
9765,2012-02-16,1,2,19,0,4,1,2,0.32,0.3182,0.87,0.1642,4,254,258,258,1,Malam
9766,2012-02-16,1,2,20,0,4,1,2,0.32,0.3333,0.87,0.1343,5,211,216,216,1,Malam
9767,2012-02-16,1,2,21,0,4,1,2,0.34,0.3485,0.81,0.1045,3,142,145,145,1,Malam
9768,2012-02-16,1,2,22,0,4,1,2,0.32,0.3485,0.81,0.0,3,108,111,111,1,Malam
9769,2012-02-16,1,2,23,0,4,1,1,0.32,0.3333,0.81,0.0896,3,70,73,73,1,Malam
9770,2012-02-17,1,2,0,0,5,1,2,0.3,0.3333,0.87,0.0,2,32,34,34,1,
9771,2012-02-17,1,2,1,0,5,1,2,0.3,0.3333,0.93,0.0,2,16,18,18,1,Pagi
9772,2012-02-17,1,2,2,0,5,1,2,0.3,0.3182,0.93,0.1045,1,11,12,12,1,Pagi
9773,2012-02-17,1,2,3,0,5,1,2,0.28,0.2879,0.93,0.1045,0,1,1,1,1,Pagi
9774,2012-02-17,1,2,4,0,5,1,2,0.28,0.2727,0.93,0.194,0,1,1,1,1,Pagi
9775,2012-02-17,1,2,5,0,5,1,2,0.28,0.2727,0.93,0.1642,0,16,16,16,1,Pagi
9776,2012-02-17,1,2,6,0,5,1,2,0.28,0.2879,0.96,0.1343,1,70,71,71,1,Pagi
9777,2012-02-17,1,2,7,0,5,1,2,0.28,0.2879,0.93,0.1045,4,222,226,226,1,Siang
9778,2012-02-17,1,2,8,0,5,1,2,0.26,0.303,1.0,0.0,4,516,520,520,1,Siang
9779,2012-02-17,1,2,9,0,5,1,2,0.26,0.303,1.0,0.0,8,275,283,283,1,Siang
9780,2012-02-17,1,2,10,0,5,1,1,0.34,0.3182,0.71,0.2836,13,103,116,116,1,Siang
9781,2012-02-17,1,2,11,0,5,1,1,0.36,0.3333,0.62,0.4179,9,133,142,142,1,Siang
9782,2012-02-17,1,2,12,0,5,1,1,0.38,0.3939,0.46,0.3881,21,177,198,198,1,Siang
9783,2012-02-17,1,2,13,0,5,1,1,0.4,0.4091,0.43,0.3582,34,171,205,205,1,Sore
9784,2012-02-17,1,2,14,0,5,1,1,0.4,0.4091,0.37,0.3582,33,137,170,170,1,Sore
9785,2012-02-17,1,2,15,0,5,1,1,0.42,0.4242,0.35,0.4179,41,180,221,221,1,Sore
9786,2012-02-17,1,2,16,0,5,1,1,0.42,0.4242,0.32,0.2985,56,251,307,307,1,Sore
9787,2012-02-17,1,2,17,0,5,1,1,0.42,0.4242,0.32,0.3284,36,429,465,465,1,Sore
9788,2012-02-17,1,2,18,0,5,1,1,0.4,0.4091,0.35,0.2537,15,362,377,377,1,Sore
9789,2012-02-17,1,2,19,0,5,1,1,0.38,0.3939,0.37,0.2239,16,266,282,282,1,Malam
9790,2012-02-17,1,2,20,0,5,1,1,0.4,0.4091,0.35,0.194,13,158,171,171,1,Malam
9791,2012-02-17,1,2,21,0,5,1,1,0.38,0.3939,0.37,0.194,15,114,129,129,1,Malam
9792,2012-02-17,1,2,22,0,5,1,1,0.36,0.3485,0.4,0.2239,15,92,107,107,1,Malam
9793,2012-02-17,1,2,23,0,5,1,1,0.36,0.3485,0.4,0.194,10,72,82,82,1,Malam
9794,2012-02-18,1,2,0,0,6,0,1,0.34,0.3333,0.42,0.1642,5,81,86,86,1,
9795,2012-02-18,1,2,1,0,6,0,1,0.32,0.3182,0.49,0.1642,7,38,45,45,1,Pagi
9796,2012-02-18,1,2,2,0,6,0,1,0.3,0.2879,0.61,0.2537,6,39,45,45,1,Pagi
9797,2012-02-18,1,2,3,0,6,0,1,0.28,0.2879,0.65,0.1045,3,15,18,18,1,Pagi
9798,2012-02-18,1,2,4,0,6,0,1,0.26,0.303,0.7,0.0,3,4,7,7,1,Pagi
9799,2012-02-18,1,2,5,0,6,0,1,0.24,0.2576,0.7,0.0896,0,1,1,1,1,Pagi
9800,2012-02-18,1,2,6,0,6,0,1,0.24,0.2879,0.7,0.0,1,8,9,9,1,Pagi
9801,2012-02-18,1,2,7,0,6,0,1,0.24,0.2879,0.7,0.0,8,33,41,41,1,Siang
9802,2012-02-18,1,2,8,0,6,0,1,0.22,0.2727,0.87,0.0,10,92,102,102,1,Siang
9803,2012-02-18,1,2,9,0,6,0,1,0.22,0.2424,0.8,0.1045,22,116,138,138,1,Siang
9804,2012-02-18,1,2,10,0,6,0,1,0.26,0.2727,0.81,0.1045,48,157,205,205,1,Siang
9805,2012-02-18,1,2,11,0,6,0,1,0.32,0.3333,0.57,0.1343,102,184,286,286,1,Siang
9806,2012-02-18,1,2,12,0,6,0,1,0.36,0.3485,0.43,0.194,128,241,369,369,1,Siang
9807,2012-02-18,1,2,13,0,6,0,1,0.4,0.4091,0.43,0.2836,165,219,384,384,1,Sore
9808,2012-02-18,1,2,14,0,6,0,1,0.44,0.4394,0.35,0.3582,183,244,427,427,1,Sore
9809,2012-02-18,1,2,15,0,6,0,1,0.42,0.4242,0.41,0.2537,229,270,499,499,1,Sore
9810,2012-02-18,1,2,16,0,6,0,1,0.44,0.4394,0.44,0.3284,186,218,404,404,1,Sore
9811,2012-02-18,1,2,17,0,6,0,1,0.48,0.4697,0.36,0.2836,142,222,364,364,1,Sore
9812,2012-02-18,1,2,18,0,6,0,1,0.46,0.4545,0.38,0.2985,70,176,246,246,1,Sore
9813,2012-02-18,1,2,19,0,6,0,1,0.44,0.4394,0.44,0.1642,38,150,188,188,1,Malam
9814,2012-02-18,1,2,20,0,6,0,1,0.44,0.4394,0.44,0.1642,25,123,148,148,1,Malam
9815,2012-02-18,1,2,21,0,6,0,1,0.44,0.4394,0.33,0.2985,25,89,114,114,1,Malam
9816,2012-02-18,1,2,22,0,6,0,1,0.4,0.4091,0.4,0.4478,17,101,118,118,1,Malam
9817,2012-02-18,1,2,23,0,6,0,2,0.36,0.3333,0.4,0.3881,12,62,74,74,1,Malam
9818,2012-02-19,1,2,0,0,0,0,2,0.34,0.303,0.39,0.3582,9,65,74,74,1,
9819,2012-02-19,1,2,1,0,0,0,2,0.32,0.303,0.39,0.2537,10,62,72,72,1,Pagi
9820,2012-02-19,1,2,2,0,0,0,2,0.3,0.2879,0.36,0.2836,3,45,48,48,1,Pagi
9821,2012-02-19,1,2,3,0,0,0,2,0.3,0.2879,0.36,0.2239,3,12,15,15,1,Pagi
9822,2012-02-19,1,2,4,0,0,0,2,0.28,0.2576,0.41,0.3881,0,3,3,3,1,Pagi
9823,2012-02-19,1,2,5,0,0,0,2,0.26,0.2273,0.48,0.2985,1,1,2,2,1,Pagi
9824,2012-02-19,1,2,6,0,0,0,1,0.24,0.2121,0.52,0.3284,0,5,5,5,1,Pagi
9825,2012-02-19,1,2,7,0,0,0,2,0.24,0.2121,0.52,0.2836,2,12,14,14,1,Siang
9826,2012-02-19,1,2,8,0,0,0,2,0.24,0.2273,0.56,0.194,8,48,56,56,1,Siang
9827,2012-02-19,1,2,9,0,0,0,2,0.24,0.2273,0.56,0.2537,20,73,93,93,1,Siang
9828,2012-02-19,1,2,10,0,0,0,2,0.26,0.2424,0.52,0.2537,49,142,191,191,1,Siang
9829,2012-02-19,1,2,11,0,0,0,2,0.26,0.2273,0.56,0.3284,82,144,226,226,1,Siang
9830,2012-02-19,1,2,12,0,0,0,2,0.28,0.2727,0.52,0.2537,71,184,255,255,1,Siang
9831,2012-02-19,1,2,13,0,0,0,1,0.3,0.303,0.49,0.1642,64,197,261,261,1,Sore
9832,2012-02-19,1,2,14,0,0,0,2,0.32,0.3182,0.45,0.194,48,189,237,237,1,Sore
9833,2012-02-19,1,2,15,0,0,0,2,0.3,0.2879,0.49,0.194,85,168,253,253,1,Sore
9834,2012-02-19,1,2,16,0,0,0,2,0.32,0.303,0.45,0.2836,62,150,212,212,1,Sore
9835,2012-02-19,1,2,17,0,0,0,2,0.3,0.2879,0.49,0.2537,22,135,157,157,1,Sore
9836,2012-02-19,1,2,18,0,0,0,2,0.3,0.2727,0.49,0.3284,23,144,167,167,1,Sore
9837,2012-02-19,1,2,19,0,0,0,2,0.3,0.2879,0.52,0.2537,18,101,119,119,1,Malam
9838,2012-02-19,1,2,20,0,0,0,2,0.3,0.2879,0.52,0.2836,22,81,103,103,1,Malam
9839,2012-02-19,1,2,21,0,0,0,3,0.26,0.2576,0.65,0.1642,3,33,36,36,1,Malam
9840,2012-02-19,1,2,22,0,0,0,3,0.24,0.2576,0.75,0.0896,8,47,55,55,1,Malam
9841,2012-02-19,1,2,23,0,0,0,2,0.22,0.2273,0.93,0.1642,5,30,35,35,1,Malam
9842,2012-02-20,1,2,0,1,1,0,2,0.24,0.2576,0.87,0.0896,5,36,41,41,1,
9843,2012-02-20,1,2,1,1,1,0,2,0.24,0.2576,0.87,0.0896,3,12,15,15,1,Pagi
9844,2012-02-20,1,2,2,1,1,0,2,0.24,0.2576,0.87,0.0896,1,19,20,20,1,Pagi
9845,2012-02-20,1,2,3,1,1,0,2,0.24,0.2273,0.81,0.194,0,8,8,8,1,Pagi
9846,2012-02-20,1,2,5,1,1,0,2,0.24,0.2121,0.6,0.3582,0,6,6,6,1,Pagi
9847,2012-02-20,1,2,6,1,1,0,1,0.24,0.197,0.52,0.4179,1,9,10,10,1,Pagi
9848,2012-02-20,1,2,7,1,1,0,2,0.22,0.197,0.55,0.3284,2,42,44,44,1,Siang
9849,2012-02-20,1,2,8,1,1,0,1,0.2,0.1818,0.59,0.3582,9,111,120,120,1,Siang
9850,2012-02-20,1,2,9,1,1,0,1,0.2,0.1818,0.59,0.3582,12,98,110,110,1,Siang
9851,2012-02-20,1,2,10,1,1,0,1,0.22,0.197,0.55,0.4478,30,113,143,143,1,Siang
9852,2012-02-20,1,2,11,1,1,0,1,0.26,0.2273,0.48,0.3582,45,163,208,208,1,Siang
9853,2012-02-20,1,2,12,1,1,0,1,0.28,0.2727,0.45,0.2239,65,216,281,281,1,Siang
9854,2012-02-20,1,2,13,1,1,0,1,0.3,0.2879,0.42,0.2836,66,246,312,312,1,Sore
9855,2012-02-20,1,2,14,1,1,0,1,0.32,0.3182,0.36,0.194,57,206,263,263,1,Sore
9856,2012-02-20,1,2,15,1,1,0,1,0.34,0.3182,0.34,0.2239,54,235,289,289,1,Sore
9857,2012-02-20,1,2,16,1,1,0,1,0.36,0.3788,0.29,0.1045,64,216,280,280,1,Sore
9858,2012-02-20,1,2,17,1,1,0,1,0.38,0.3939,0.27,0.2537,27,226,253,253,1,Sore
9859,2012-02-20,1,2,18,1,1,0,1,0.34,0.3182,0.34,0.2239,27,215,242,242,1,Sore
9860,2012-02-20,1,2,19,1,1,0,1,0.34,0.3182,0.34,0.2239,8,164,172,172,1,Malam
9861,2012-02-20,1,2,20,1,1,0,1,0.34,0.3333,0.34,0.194,9,117,126,126,1,Malam
9862,2012-02-20,1,2,21,1,1,0,1,0.3,0.303,0.39,0.1642,8,90,98,98,1,Malam
9863,2012-02-20,1,2,22,1,1,0,1,0.3,0.3182,0.45,0.0896,9,53,62,62,1,Malam
9864,2012-02-20,1,2,23,1,1,0,1,0.3,0.3333,0.39,0.0,0,26,26,26,1,Malam
9865,2012-02-21,1,2,0,0,2,1,1,0.26,0.303,0.65,0.0,1,11,12,12,1,
9866,2012-02-21,1,2,1,0,2,1,1,0.26,0.303,0.56,0.0,0,7,7,7,1,Pagi
9867,2012-02-21,1,2,2,0,2,1,1,0.24,0.2879,0.6,0.0,0,3,3,3,1,Pagi
9868,2012-02-21,1,2,4,0,2,1,1,0.22,0.2727,0.64,0.0,0,2,2,2,1,Pagi
9869,2012-02-21,1,2,5,0,2,1,1,0.2,0.2576,0.69,0.0,0,15,15,15,1,Pagi
9870,2012-02-21,1,2,6,0,2,1,1,0.2,0.2576,0.75,0.0,3,83,86,86,1,Pagi
9871,2012-02-21,1,2,7,0,2,1,1,0.22,0.2727,0.64,0.0,6,273,279,279,1,Siang
9872,2012-02-21,1,2,8,0,2,1,1,0.2,0.2273,0.69,0.0896,5,459,464,464,1,Siang
9873,2012-02-21,1,2,9,0,2,1,1,0.2,0.2273,0.75,0.1045,6,211,217,217,1,Siang
9874,2012-02-21,1,2,10,0,2,1,1,0.24,0.2273,0.7,0.194,8,77,85,85,1,Siang
9875,2012-02-21,1,2,11,0,2,1,2,0.26,0.2424,0.7,0.2836,5,81,86,86,1,Siang
9876,2012-02-21,1,2,12,0,2,1,2,0.3,0.2727,0.56,0.3881,16,147,163,163,1,Siang
9877,2012-02-21,1,2,13,0,2,1,1,0.34,0.303,0.49,0.4179,8,123,131,131,1,Sore
9878,2012-02-21,1,2,14,0,2,1,2,0.32,0.2879,0.53,0.3881,16,108,124,124,1,Sore
9879,2012-02-21,1,2,15,0,2,1,1,0.34,0.303,0.49,0.4179,23,137,160,160,1,Sore
9880,2012-02-21,1,2,16,0,2,1,1,0.36,0.3333,0.46,0.4179,14,240,254,254,1,Sore
9881,2012-02-21,1,2,17,0,2,1,1,0.38,0.3939,0.4,0.4478,21,411,432,432,1,Sore
9882,2012-02-21,1,2,18,0,2,1,1,0.38,0.3939,0.4,0.4478,11,414,425,425,1,Sore
9883,2012-02-21,1,2,19,0,2,1,1,0.36,0.3333,0.46,0.2985,5,299,304,304,1,Malam
9884,2012-02-21,1,2,20,0,2,1,1,0.34,0.3182,0.53,0.2537,4,223,227,227,1,Malam
9885,2012-02-21,1,2,21,0,2,1,1,0.34,0.3333,0.61,0.1642,7,147,154,154,1,Malam
9886,2012-02-21,1,2,22,0,2,1,2,0.34,0.3333,0.71,0.194,3,97,100,100,1,Malam
9887,2012-02-21,1,2,23,0,2,1,1,0.32,0.303,0.66,0.2239,1,46,47,47,1,Malam
9888,2012-02-22,1,2,0,0,3,1,1,0.32,0.303,0.66,0.2239,5,19,24,24,1,
9889,2012-02-22,1,2,1,0,3,1,1,0.32,0.3333,0.7,0.1343,3,4,7,7,1,Pagi
9890,2012-02-22,1,2,2,0,3,1,1,0.34,0.3182,0.66,0.2836,1,5,6,6,1,Pagi
9891,2012-02-22,1,2,3,0,3,1,2,0.34,0.3182,0.71,0.2239,1,3,4,4,1,Pagi
9892,2012-02-22,1,2,4,0,3,1,1,0.34,0.3333,0.71,0.1642,0,2,2,2,1,Pagi
9893,2012-02-22,1,2,5,0,3,1,1,0.32,0.3333,0.7,0.1045,1,29,30,30,1,Pagi
9894,2012-02-22,1,2,6,0,3,1,1,0.32,0.3182,0.76,0.1642,5,85,90,90,1,Pagi
9895,2012-02-22,1,2,7,0,3,1,1,0.32,0.3333,0.76,0.0896,10,292,302,302,1,Siang
9896,2012-02-22,1,2,8,0,3,1,1,0.3,0.3182,0.75,0.0896,9,567,576,576,1,Siang
9897,2012-02-22,1,2,9,0,3,1,1,0.32,0.3333,0.7,0.0896,11,241,252,252,1,Siang
9898,2012-02-22,1,2,10,0,3,1,1,0.34,0.3485,0.71,0.0896,17,122,139,139,1,Siang
9899,2012-02-22,1,2,11,0,3,1,1,0.36,0.3485,0.66,0.1642,22,149,171,171,1,Siang
9900,2012-02-22,1,2,12,0,3,1,1,0.4,0.4091,0.62,0.2836,21,186,207,207,1,Siang
9901,2012-02-22,1,2,13,0,3,1,1,0.42,0.4242,0.54,0.2985,15,175,190,190,1,Sore
9902,2012-02-22,1,2,14,0,3,1,1,0.44,0.4394,0.54,0.3284,35,142,177,177,1,Sore
9903,2012-02-22,1,2,15,0,3,1,1,0.5,0.4848,0.31,0.4179,34,161,195,195,1,Sore
9904,2012-02-22,1,2,16,0,3,1,1,0.52,0.5,0.29,0.4627,30,268,298,298,1,Sore
9905,2012-02-22,1,2,17,0,3,1,1,0.52,0.5,0.32,0.3881,43,486,529,529,1,Sore
9906,2012-02-22,1,2,18,0,3,1,2,0.48,0.4697,0.41,0.3284,42,483,525,525,1,Sore
9907,2012-02-22,1,2,19,0,3,1,2,0.46,0.4545,0.44,0.2836,22,305,327,327,1,Malam
9908,2012-02-22,1,2,20,0,3,1,2,0.44,0.4394,0.47,0.194,25,249,274,274,1,Malam
9909,2012-02-22,1,2,21,0,3,1,2,0.48,0.4697,0.33,0.2836,19,220,239,239,1,Malam
9910,2012-02-22,1,2,22,0,3,1,2,0.44,0.4394,0.47,0.2537,18,129,147,147,1,Malam
9911,2012-02-22,1,2,23,0,3,1,2,0.46,0.4545,0.41,0.2836,5,57,62,62,1,Malam
9912,2012-02-23,1,2,0,0,4,1,2,0.44,0.4394,0.47,0.2537,12,30,42,42,1,
9913,2012-02-23,1,2,1,0,4,1,2,0.44,0.4394,0.58,0.2836,3,12,15,15,1,Pagi
9914,2012-02-23,1,2,2,0,4,1,2,0.44,0.4394,0.62,0.2239,5,4,9,9,1,Pagi
9915,2012-02-23,1,2,3,0,4,1,3,0.44,0.4394,0.67,0.194,2,4,6,6,1,Pagi
9916,2012-02-23,1,2,4,0,4,1,1,0.4,0.4091,0.76,0.2239,0,1,1,1,1,Pagi
9917,2012-02-23,1,2,5,0,4,1,1,0.4,0.4091,0.76,0.2239,2,30,32,32,1,Pagi
9918,2012-02-23,1,2,6,0,4,1,1,0.36,0.3485,0.87,0.194,3,88,91,91,1,Pagi
9919,2012-02-23,1,2,7,0,4,1,1,0.36,0.3485,0.81,0.2239,9,317,326,326,1,Siang
9920,2012-02-23,1,2,8,0,4,1,1,0.34,0.3333,0.87,0.194,11,549,560,560,1,Siang
9921,2012-02-23,1,2,9,0,4,1,1,0.36,0.3333,0.81,0.2537,14,228,242,242,1,Siang
9922,2012-02-23,1,2,10,0,4,1,1,0.42,0.4242,0.67,0.194,41,107,148,148,1,Siang
9923,2012-02-23,1,2,11,0,4,1,1,0.48,0.4697,0.48,0.2836,54,128,182,182,1,Siang
9924,2012-02-23,1,2,12,0,4,1,1,0.5,0.4848,0.42,0.2537,25,199,224,224,1,Siang
9925,2012-02-23,1,2,13,0,4,1,1,0.52,0.5,0.39,0.194,30,188,218,218,1,Sore
9926,2012-02-23,1,2,14,0,4,1,1,0.54,0.5152,0.37,0.2537,36,156,192,192,1,Sore
9927,2012-02-23,1,2,15,0,4,1,1,0.54,0.5152,0.33,0.1343,46,171,217,217,1,Sore
9928,2012-02-23,1,2,16,0,4,1,1,0.56,0.5303,0.32,0.0,45,298,343,343,1,Sore
9929,2012-02-23,1,2,17,0,4,1,1,0.54,0.5152,0.32,0.1642,49,561,610,610,1,Sore
9930,2012-02-23,1,2,18,0,4,1,1,0.54,0.5152,0.37,0.1343,36,486,522,522,1,Sore
9931,2012-02-23,1,2,19,0,4,1,1,0.5,0.4848,0.39,0.0896,20,349,369,369,1,Malam
9932,2012-02-23,1,2,20,0,4,1,1,0.46,0.4545,0.44,0.1343,23,246,269,269,1,Malam
9933,2012-02-23,1,2,21,0,4,1,1,0.44,0.4394,0.51,0.2239,17,205,222,222,1,Malam
9934,2012-02-23,1,2,22,0,4,1,1,0.44,0.4394,0.54,0.2537,19,118,137,137,1,Malam
9935,2012-02-23,1,2,23,0,4,1,1,0.44,0.4394,0.54,0.0,14,71,85,85,1,Malam
9936,2012-02-24,1,2,0,0,5,1,2,0.44,0.4394,0.58,0.0896,12,34,46,46,1,
9937,2012-02-24,1,2,1,0,5,1,1,0.44,0.4394,0.62,0.194,3,15,18,18,1,Pagi
9938,2012-02-24,1,2,2,0,5,1,3,0.42,0.4242,0.77,0.2836,1,4,5,5,1,Pagi
9939,2012-02-24,1,2,3,0,5,1,1,0.42,0.4242,0.82,0.1343,0,5,5,5,1,Pagi
9940,2012-02-24,1,2,4,0,5,1,1,0.4,0.4091,0.87,0.1343,0,2,2,2,1,Pagi
9941,2012-02-24,1,2,5,0,5,1,2,0.4,0.4091,0.87,0.194,1,25,26,26,1,Pagi
9942,2012-02-24,1,2,6,0,5,1,2,0.4,0.4091,0.87,0.1642,2,80,82,82,1,Pagi
9943,2012-02-24,1,2,7,0,5,1,2,0.4,0.4091,0.76,0.2239,7,265,272,272,1,Siang
9944,2012-02-24,1,2,8,0,5,1,2,0.38,0.3939,0.76,0.3284,17,452,469,469,1,Siang
9945,2012-02-24,1,2,9,0,5,1,3,0.36,0.3333,0.81,0.2537,15,229,244,244,1,Siang
9946,2012-02-24,1,2,10,0,5,1,3,0.36,0.3485,0.81,0.1642,22,119,141,141,1,Siang
9947,2012-02-24,1,2,11,0,5,1,2,0.36,0.3636,0.81,0.1045,27,136,163,163,1,Siang
9948,2012-02-24,1,2,12,0,5,1,2,0.4,0.4091,0.76,0.1343,27,201,228,228,1,Siang
9949,2012-02-24,1,2,13,0,5,1,2,0.42,0.4242,0.71,0.1045,30,153,183,183,1,Sore
9950,2012-02-24,1,2,14,0,5,1,2,0.46,0.4545,0.67,0.1045,5,26,31,31,1,Sore
9951,2012-02-24,1,2,15,0,5,1,3,0.4,0.4091,0.87,0.194,11,83,94,94,1,Sore
9952,2012-02-24,1,2,16,0,5,1,3,0.4,0.4091,0.87,0.194,12,166,178,178,1,Sore
9953,2012-02-24,1,2,17,0,5,1,3,0.42,0.4242,0.94,0.1045,14,242,256,256,1,Sore
9954,2012-02-24,1,2,18,0,5,1,2,0.42,0.4242,0.94,0.0,11,289,300,300,1,Sore
9955,2012-02-24,1,2,19,0,5,1,2,0.44,0.4394,0.88,0.1045,6,227,233,233,1,Malam
9956,2012-02-24,1,2,20,0,5,1,1,0.44,0.4394,0.62,0.4179,8,159,167,167,1,Malam
9957,2012-02-24,1,2,21,0,5,1,1,0.42,0.4242,0.35,0.806,1,151,152,152,1,Malam
9958,2012-02-24,1,2,22,0,5,1,1,0.4,0.4091,0.37,0.5821,4,102,106,106,1,Malam
9959,2012-02-24,1,2,23,0,5,1,1,0.38,0.3939,0.37,0.6866,10,76,86,86,1,Malam
9960,2012-02-25,1,2,0,0,6,0,1,0.36,0.3333,0.43,0.3881,5,56,61,61,1,
9961,2012-02-25,1,2,1,0,6,0,1,0.34,0.303,0.42,0.3582,4,42,46,46,1,Pagi
9962,2012-02-25,1,2,2,0,6,0,1,0.32,0.303,0.45,0.2537,1,37,38,38,1,Pagi
9963,2012-02-25,1,2,3,0,6,0,1,0.3,0.2727,0.45,0.2985,0,7,7,7,1,Pagi
9964,2012-02-25,1,2,4,0,6,0,1,0.3,0.2727,0.42,0.3284,0,2,2,2,1,Pagi
9965,2012-02-25,1,2,5,0,6,0,2,0.3,0.2727,0.42,0.2985,0,3,3,3,1,Pagi
9966,2012-02-25,1,2,6,0,6,0,2,0.3,0.2727,0.42,0.2985,1,12,13,13,1,Pagi
9967,2012-02-25,1,2,7,0,6,0,1,0.28,0.2424,0.45,0.4478,3,20,23,23,1,Siang
9968,2012-02-25,1,2,8,0,6,0,1,0.26,0.2273,0.48,0.2985,3,90,93,93,1,Siang
9969,2012-02-25,1,2,9,0,6,0,3,0.22,0.197,0.75,0.3284,15,107,122,122,1,Siang
9970,2012-02-25,1,2,10,0,6,0,1,0.26,0.2273,0.6,0.3582,24,159,183,183,1,Siang
9971,2012-02-25,1,2,11,0,6,0,1,0.3,0.2576,0.39,0.6119,23,187,210,210,1,Siang
9972,2012-02-25,1,2,12,0,6,0,1,0.32,0.2727,0.29,0.6567,41,217,258,258,1,Siang
9973,2012-02-25,1,2,13,0,6,0,1,0.32,0.2879,0.31,0.4925,48,178,226,226,1,Sore
9974,2012-02-25,1,2,14,0,6,0,1,0.32,0.2727,0.29,0.5522,35,181,216,216,1,Sore
9975,2012-02-25,1,2,15,0,6,0,1,0.32,0.2879,0.29,0.4179,21,211,232,232,1,Sore
9976,2012-02-25,1,2,16,0,6,0,1,0.32,0.2727,0.26,0.5821,32,163,195,195,1,Sore
9977,2012-02-25,1,2,17,0,6,0,1,0.3,0.2727,0.33,0.3582,16,143,159,159,1,Sore
9978,2012-02-25,1,2,18,0,6,0,1,0.3,0.2576,0.28,0.5821,7,126,133,133,1,Sore
9979,2012-02-25,1,2,19,0,6,0,1,0.26,0.2121,0.33,0.4478,12,137,149,149,1,Malam
9980,2012-02-25,1,2,20,0,6,0,1,0.26,0.2121,0.3,0.5522,10,95,105,105,1,Malam
9981,2012-02-25,1,2,21,0,6,0,1,0.24,0.2121,0.35,0.3284,5,80,85,85,1,Malam
9982,2012-02-25,1,2,22,0,6,0,1,0.24,0.197,0.38,0.4627,4,78,82,82,1,Malam
9983,2012-02-25,1,2,23,0,6,0,1,0.24,0.197,0.41,0.4179,7,84,91,91,1,Malam
9984,2012-02-26,1,2,0,0,0,0,1,0.24,0.2121,0.41,0.3582,7,63,70,70,1,
9985,2012-02-26,1,2,1,0,0,0,1,0.24,0.2121,0.44,0.3284,5,50,55,55,1,Pagi
9986,2012-02-26,1,2,2,0,0,0,1,0.24,0.2121,0.44,0.3284,5,37,42,42,1,Pagi
9987,2012-02-26,1,2,3,0,0,0,1,0.24,0.2273,0.41,0.194,0,21,21,21,1,Pagi
9988,2012-02-26,1,2,4,0,0,0,1,0.24,0.2273,0.41,0.194,1,5,6,6,1,Pagi
9989,2012-02-26,1,2,5,0,0,0,1,0.22,0.2121,0.44,0.2239,0,5,5,5,1,Pagi
9990,2012-02-26,1,2,6,0,0,0,1,0.22,0.197,0.44,0.3284,0,2,2,2,1,Pagi
9991,2012-02-26,1,2,7,0,0,0,1,0.2,0.1818,0.51,0.2985,2,20,22,22,1,Siang
9992,2012-02-26,1,2,8,0,0,0,1,0.2,0.197,0.51,0.2537,2,57,59,59,1,Siang
9993,2012-02-26,1,2,9,0,0,0,1,0.22,0.2121,0.47,0.2239,11,76,87,87,1,Siang
9994,2012-02-26,1,2,10,0,0,0,1,0.26,0.2576,0.41,0.1642,27,161,188,188,1,Siang
9995,2012-02-26,1,2,11,0,0,0,1,0.28,0.2576,0.41,0.2836,43,184,227,227,1,Siang
9996,2012-02-26,1,2,12,0,0,0,1,0.3,0.303,0.39,0.1343,49,256,305,305,1,Siang
9997,2012-02-26,1,2,13,0,0,0,1,0.32,0.3333,0.36,0.0,58,267,325,325,1,Sore
9998,2012-02-26,1,2,14,0,0,0,1,0.34,0.3485,0.31,0.0,68,263,331,331,1,Sore
9999,2012-02-26,1,2,15,0,0,0,1,0.36,0.3485,0.29,0.0,72,281,353,353,1,Sore
10000,2012-02-26,1,2,16,0,0,0,1,0.36,0.3333,0.32,0.2537,64,275,339,339,1,Sore
10001,2012-02-26,1,2,17,0,0,0,1,0.36,0.3485,0.32,0.2239,46,241,287,287,1,Sore
10002,2012-02-26,1,2,18,0,0,0,1,0.34,0.3182,0.36,0.2836,17,199,216,216,1,Sore
10003,2012-02-26,1,2,19,0,0,0,1,0.34,0.3333,0.34,0.1642,13,130,143,143,1,Malam
10004,2012-02-26,1,2,20,0,0,0,1,0.32,0.3182,0.42,0.1642,9,79,88,88,1,Malam
10005,2012-02-26,1,2,21,0,0,0,1,0.3,0.303,0.45,0.1343,8,75,83,83,1,Malam
10006,2012-02-26,1,2,22,0,0,0,1,0.3,0.2879,0.42,0.2239,3,68,71,71,1,Malam
10007,2012-02-26,1,2,23,0,0,0,1,0.26,0.2576,0.56,0.1642,5,59,64,64,1,Malam
10008,2012-02-27,1,2,0,0,1,1,1,0.26,0.2424,0.6,0.2537,2,27,29,29,1,
10009,2012-02-27,1,2,1,0,1,1,1,0.26,0.2576,0.65,0.2239,0,6,6,6,1,Pagi
10010,2012-02-27,1,2,2,0,1,1,1,0.26,0.2273,0.7,0.2985,0,4,4,4,1,Pagi
10011,2012-02-27,1,2,3,0,1,1,1,0.24,0.2424,0.75,0.1642,0,2,2,2,1,Pagi
10012,2012-02-27,1,2,4,0,1,1,1,0.22,0.2273,0.8,0.1343,0,1,1,1,1,Pagi
10013,2012-02-27,1,2,5,0,1,1,1,0.22,0.2273,0.8,0.1343,0,16,16,16,1,Pagi
10014,2012-02-27,1,2,6,0,1,1,1,0.24,0.2273,0.7,0.2537,1,89,90,90,1,Pagi
10015,2012-02-27,1,2,7,0,1,1,1,0.24,0.2273,0.6,0.2239,2,278,280,280,1,Siang
10016,2012-02-27,1,2,8,0,1,1,1,0.24,0.2424,0.6,0.0,14,514,528,528,1,Siang
10017,2012-02-27,1,2,9,0,1,1,1,0.26,0.2576,0.6,0.194,11,219,230,230,1,Siang
10018,2012-02-27,1,2,10,0,1,1,1,0.32,0.303,0.45,0.2537,16,88,104,104,1,Siang
10019,2012-02-27,1,2,11,0,1,1,1,0.36,0.3333,0.43,0.2537,11,92,103,103,1,Siang
10020,2012-02-27,1,2,12,0,1,1,1,0.4,0.4091,0.37,0.2985,13,164,177,177,1,Siang
10021,2012-02-27,1,2,13,0,1,1,1,0.4,0.4091,0.43,0.2836,23,159,182,182,1,Sore
10022,2012-02-27,1,2,14,0,1,1,1,0.46,0.4545,0.36,0.2836,24,134,158,158,1,Sore
10023,2012-02-27,1,2,15,0,1,1,1,0.52,0.5,0.25,0.4179,24,150,174,174,1,Sore
10024,2012-02-27,1,2,16,0,1,1,1,0.54,0.5152,0.26,0.4478,20,266,286,286,1,Sore
10025,2012-02-27,1,2,17,0,1,1,1,0.54,0.5152,0.24,0.4478,26,503,529,529,1,Sore
10026,2012-02-27,1,2,18,0,1,1,1,0.52,0.5,0.27,0.4179,10,517,527,527,1,Sore
10027,2012-02-27,1,2,19,0,1,1,1,0.5,0.4848,0.29,0.3881,16,318,334,334,1,Malam
10028,2012-02-27,1,2,20,0,1,1,1,0.48,0.4697,0.33,0.3582,11,208,219,219,1,Malam
10029,2012-02-27,1,2,21,0,1,1,1,0.46,0.4545,0.36,0.2836,14,181,195,195,1,Malam
10030,2012-02-27,1,2,22,0,1,1,1,0.44,0.4394,0.44,0.2537,9,83,92,92,1,Malam
10031,2012-02-27,1,2,23,0,1,1,1,0.42,0.4242,0.5,0.1642,6,50,56,56,1,Malam
10032,2012-02-28,1,2,0,0,2,1,1,0.42,0.4242,0.54,0.1343,0,10,10,10,1,
10033,2012-02-28,1,2,1,0,2,1,1,0.38,0.3939,0.62,0.1642,0,6,6,6,1,Pagi
10034,2012-02-28,1,2,2,0,2,1,1,0.4,0.4091,0.54,0.1045,1,2,3,3,1,Pagi
10035,2012-02-28,1,2,3,0,2,1,1,0.4,0.4091,0.32,0.3582,0,6,6,6,1,Pagi
10036,2012-02-28,1,2,4,0,2,1,1,0.32,0.2879,0.42,0.3582,0,2,2,2,1,Pagi
10037,2012-02-28,1,2,5,0,2,1,1,0.32,0.2879,0.42,0.3582,1,20,21,21,1,Pagi
10038,2012-02-28,1,2,6,0,2,1,1,0.3,0.2727,0.45,0.3284,1,100,101,101,1,Pagi
10039,2012-02-28,1,2,7,0,2,1,1,0.28,0.2576,0.45,0.2985,12,313,325,325,1,Siang
10040,2012-02-28,1,2,8,0,2,1,1,0.26,0.2424,0.48,0.2836,16,543,559,559,1,Siang
10041,2012-02-28,1,2,9,0,2,1,1,0.28,0.2576,0.45,0.3582,7,225,232,232,1,Siang
10042,2012-02-28,1,2,10,0,2,1,1,0.3,0.2727,0.42,0.2985,14,118,132,132,1,Siang
10043,2012-02-28,1,2,11,0,2,1,1,0.34,0.3182,0.36,0.2537,8,155,163,163,1,Siang
10044,2012-02-28,1,2,12,0,2,1,1,0.36,0.3485,0.34,0.1343,19,164,183,183,1,Siang
10045,2012-02-28,1,2,13,0,2,1,1,0.36,0.3636,0.32,0.1045,16,174,190,190,1,Sore
10046,2012-02-28,1,2,14,0,2,1,1,0.4,0.4091,0.28,0.1045,13,121,134,134,1,Sore
10047,2012-02-28,1,2,15,0,2,1,1,0.42,0.4242,0.26,0.0896,17,149,166,166,1,Sore
10048,2012-02-28,1,2,16,0,2,1,1,0.42,0.4242,0.28,0.0896,17,270,287,287,1,Sore
10049,2012-02-28,1,2,17,0,2,1,1,0.42,0.4242,0.26,0.0896,33,497,530,530,1,Sore
10050,2012-02-28,1,2,18,0,2,1,1,0.42,0.4242,0.28,0.1642,17,432,449,449,1,Sore
10051,2012-02-28,1,2,19,0,2,1,1,0.42,0.4242,0.26,0.0,15,291,306,306,1,Malam
10052,2012-02-28,1,2,20,0,2,1,1,0.4,0.4091,0.3,0.1343,2,202,204,204,1,Malam
10053,2012-02-28,1,2,21,0,2,1,1,0.34,0.3485,0.46,0.1045,10,178,188,188,1,Malam
10054,2012-02-28,1,2,22,0,2,1,1,0.34,0.3485,0.46,0.1045,6,95,101,101,1,Malam
10055,2012-02-28,1,2,23,0,2,1,1,0.32,0.303,0.53,0.2239,4,61,65,65,1,Malam
10056,2012-02-29,1,2,0,0,3,1,1,0.32,0.3333,0.53,0.1045,2,30,32,32,1,
10057,2012-02-29,1,2,1,0,3,1,1,0.32,0.3333,0.49,0.1045,0,6,6,6,1,Pagi
10058,2012-02-29,1,2,2,0,3,1,1,0.3,0.2879,0.56,0.2239,0,4,4,4,1,Pagi
10059,2012-02-29,1,2,3,0,3,1,1,0.28,0.303,0.7,0.0896,0,2,2,2,1,Pagi
10060,2012-02-29,1,2,5,0,3,1,1,0.26,0.2879,0.75,0.0896,0,29,29,29,1,Pagi
10061,2012-02-29,1,2,6,0,3,1,2,0.28,0.303,0.75,0.0896,4,100,104,104,1,Pagi
10062,2012-02-29,1,2,7,0,3,1,2,0.26,0.2727,0.81,0.1343,11,242,253,253,1,Siang
10063,2012-02-29,1,2,8,0,3,1,2,0.28,0.2879,0.75,0.1045,2,114,116,116,1,Siang
10064,2012-02-29,1,2,9,0,3,1,3,0.3,0.303,0.81,0.1642,5,33,38,38,1,Siang
10065,2012-02-29,1,2,10,0,3,1,3,0.3,0.303,0.81,0.1642,0,10,10,10,1,Siang
10066,2012-02-29,1,2,11,0,3,1,3,0.3,0.2879,0.87,0.194,1,9,10,10,1,Siang
10067,2012-02-29,1,2,12,0,3,1,3,0.32,0.303,0.93,0.3284,1,69,70,70,1,Siang
10068,2012-02-29,1,2,13,0,3,1,2,0.36,0.3333,0.93,0.3582,4,72,76,76,1,Sore
10069,2012-02-29,1,2,14,0,3,1,2,0.36,0.3333,0.93,0.3582,2,54,56,56,1,Sore
10070,2012-02-29,1,2,15,0,3,1,2,0.4,0.4091,0.82,0.2836,3,87,90,90,1,Sore
10071,2012-02-29,1,2,16,0,3,1,3,0.4,0.4091,0.82,0.2239,5,162,167,167,1,Sore
10072,2012-02-29,1,2,17,0,3,1,2,0.4,0.4091,0.87,0.1642,7,246,253,253,1,Sore
10073,2012-02-29,1,2,18,0,3,1,3,0.4,0.4091,0.87,0.0,11,181,192,192,1,Sore
10074,2012-02-29,1,2,19,0,3,1,2,0.4,0.4091,0.87,0.1045,0,102,102,102,1,Malam
10075,2012-02-29,1,2,20,0,3,1,3,0.42,0.4242,0.88,0.1642,2,95,97,97,1,Malam
10076,2012-02-29,1,2,21,0,3,1,3,0.42,0.4242,0.88,0.1642,0,39,39,39,1,Malam
10077,2012-02-29,1,2,22,0,3,1,3,0.42,0.4242,0.94,0.2537,2,53,55,55,1,Malam
10078,2012-02-29,1,2,23,0,3,1,3,0.42,0.4242,0.94,0.2537,3,30,33,33,1,Malam
10079,2012-03-01,1,3,0,0,4,1,2,0.42,0.4242,0.94,0.0,1,10,11,11,1,
10080,2012-03-01,1,3,1,0,4,1,3,0.46,0.4545,0.94,0.1045,0,12,12,12,1,Pagi
10081,2012-03-01,1,3,2,0,4,1,2,0.46,0.4545,0.94,0.2836,0,6,6,6,1,Pagi
10082,2012-03-01,1,3,3,0,4,1,1,0.46,0.4545,0.94,0.2239,0,3,3,3,1,Pagi
10083,2012-03-01,1,3,4,0,4,1,1,0.48,0.4697,0.88,0.194,0,5,5,5,1,Pagi
10084,2012-03-01,1,3,5,0,4,1,1,0.48,0.4697,0.88,0.1642,0,18,18,18,1,Pagi
10085,2012-03-01,1,3,6,0,4,1,2,0.42,0.4242,0.94,0.0,2,107,109,109,1,Pagi
10086,2012-03-01,1,3,7,0,4,1,2,0.44,0.4394,0.94,0.1343,8,296,304,304,1,Siang
10087,2012-03-01,1,3,8,0,4,1,1,0.42,0.4242,0.94,0.1343,15,579,594,594,1,Siang
10088,2012-03-01,1,3,9,0,4,1,1,0.46,0.4545,0.77,0.2537,5,281,286,286,1,Siang
10089,2012-03-01,1,3,10,0,4,1,1,0.52,0.5,0.55,0.1642,11,122,133,133,1,Siang
10090,2012-03-01,1,3,11,0,4,1,1,0.56,0.5303,0.43,0.194,19,149,168,168,1,Siang
10091,2012-03-01,1,3,12,0,4,1,1,0.56,0.5303,0.37,0.2239,16,204,220,220,1,Siang
10092,2012-03-01,1,3,13,0,4,1,1,0.58,0.5455,0.32,0.2537,24,187,211,211,1,Sore
10093,2012-03-01,1,3,14,0,4,1,1,0.58,0.5455,0.35,0.2239,37,174,211,211,1,Sore
10094,2012-03-01,1,3,15,0,4,1,1,0.6,0.6212,0.31,0.2537,31,192,223,223,1,Sore
10095,2012-03-01,1,3,16,0,4,1,1,0.58,0.5455,0.32,0.2985,38,323,361,361,1,Sore
10096,2012-03-01,1,3,17,0,4,1,1,0.56,0.5303,0.35,0.2985,49,551,600,600,1,Sore
10097,2012-03-01,1,3,18,0,4,1,1,0.54,0.5152,0.34,0.3582,27,498,525,525,1,Sore
10098,2012-03-01,1,3,19,0,4,1,1,0.48,0.4697,0.41,0.3284,11,317,328,328,1,Malam
10099,2012-03-01,1,3,20,0,4,1,1,0.44,0.4394,0.44,0.4179,12,242,254,254,1,Malam
10100,2012-03-01,1,3,21,0,4,1,1,0.42,0.4242,0.47,0.4627,7,190,197,197,1,Malam
10101,2012-03-01,1,3,22,0,4,1,1,0.38,0.3939,0.5,0.2537,3,123,126,126,1,Malam
10102,2012-03-01,1,3,23,0,4,1,1,0.36,0.3485,0.5,0.2239,9,76,85,85,1,Malam
10103,2012-03-02,1,3,0,0,5,1,1,0.34,0.3333,0.53,0.1642,1,45,46,46,1,
10104,2012-03-02,1,3,1,0,5,1,1,0.34,0.3182,0.49,0.2239,2,18,20,20,1,Pagi
10105,2012-03-02,1,3,2,0,5,1,1,0.34,0.3182,0.53,0.2836,2,4,6,6,1,Pagi
10106,2012-03-02,1,3,3,0,5,1,1,0.32,0.3182,0.57,0.194,0,3,3,3,1,Pagi
10107,2012-03-02,1,3,4,0,5,1,1,0.32,0.3485,0.61,0.0,0,2,2,2,1,Pagi
10108,2012-03-02,1,3,5,0,5,1,1,0.3,0.3333,0.7,0.0,0,24,24,24,1,Pagi
10109,2012-03-02,1,3,6,0,5,1,1,0.3,0.3333,0.7,0.0,4,88,92,92,1,Pagi
10110,2012-03-02,1,3,7,0,5,1,1,0.3,0.3333,0.7,0.0,4,258,262,262,1,Siang
10111,2012-03-02,1,3,8,0,5,1,1,0.28,0.303,0.75,0.0896,16,533,549,549,1,Siang
10112,2012-03-02,1,3,9,0,5,1,1,0.3,0.3333,0.81,0.0,15,299,314,314,1,Siang
10113,2012-03-02,1,3,10,0,5,1,1,0.36,0.3485,0.5,0.1642,14,118,132,132,1,Siang
10114,2012-03-02,1,3,11,0,5,1,1,0.38,0.3939,0.46,0.194,40,154,194,194,1,Siang
10115,2012-03-02,1,3,12,0,5,1,1,0.4,0.4091,0.43,0.1642,40,194,234,234,1,Siang
10116,2012-03-02,1,3,13,0,5,1,1,0.42,0.4242,0.44,0.2239,31,191,222,222,1,Sore
10117,2012-03-02,1,3,14,0,5,1,2,0.44,0.4394,0.44,0.2836,29,176,205,205,1,Sore
10118,2012-03-02,1,3,15,0,5,1,2,0.42,0.4242,0.5,0.2985,5,73,78,78,1,Sore
10119,2012-03-02,1,3,16,0,5,1,3,0.4,0.4091,0.58,0.2985,1,49,50,50,1,Sore
10120,2012-03-02,1,3,17,0,5,1,3,0.36,0.3485,0.81,0.2239,5,123,128,128,1,Sore
10121,2012-03-02,1,3,18,0,5,1,3,0.36,0.3485,0.87,0.194,6,154,160,160,1,Sore
10122,2012-03-02,1,3,19,0,5,1,3,0.36,0.3485,0.87,0.194,12,162,174,174,1,Malam
10123,2012-03-02,1,3,20,0,5,1,2,0.36,0.3485,0.87,0.194,7,93,100,100,1,Malam
10124,2012-03-02,1,3,21,0,5,1,3,0.36,0.3636,0.87,0.0896,2,99,101,101,1,Malam
10125,2012-03-02,1,3,22,0,5,1,2,0.36,0.3788,0.87,0.0,6,69,75,75,1,Malam
10126,2012-03-02,1,3,23,0,5,1,2,0.36,0.3788,0.87,0.0,4,19,23,23,1,Malam
10127,2012-03-03,1,3,0,0,6,0,3,0.36,0.3636,0.93,0.0896,1,21,22,22,1,
10128,2012-03-03,1,3,1,0,6,0,3,0.36,0.3788,0.93,0.0,0,44,44,44,1,Pagi
10129,2012-03-03,1,3,2,0,6,0,3,0.36,0.3636,0.93,0.0896,4,34,38,38,1,Pagi
10130,2012-03-03,1,3,3,0,6,0,2,0.36,0.3485,0.93,0.1642,1,20,21,21,1,Pagi
10131,2012-03-03,1,3,4,0,6,0,2,0.36,0.3485,0.93,0.194,0,2,2,2,1,Pagi
10132,2012-03-03,1,3,5,0,6,0,2,0.36,0.3636,0.93,0.0896,1,1,2,2,1,Pagi
10133,2012-03-03,1,3,6,0,6,0,2,0.36,0.3636,0.93,0.0896,1,6,7,7,1,Pagi
10134,2012-03-03,1,3,7,0,6,0,2,0.36,0.3485,0.93,0.1343,2,14,16,16,1,Siang
10135,2012-03-03,1,3,8,0,6,0,3,0.36,0.3788,0.93,0.0,2,46,48,48,1,Siang
10136,2012-03-03,1,3,9,0,6,0,3,0.38,0.3939,0.87,0.0896,7,87,94,94,1,Siang
10137,2012-03-03,1,3,10,0,6,0,2,0.4,0.4091,0.87,0.0,31,137,168,168,1,Siang
10138,2012-03-03,1,3,11,0,6,0,2,0.4,0.4091,0.87,0.0896,33,181,214,214,1,Siang
10139,2012-03-03,1,3,12,0,6,0,2,0.42,0.4242,0.67,0.2537,47,252,299,299,1,Siang
10140,2012-03-03,1,3,13,0,6,0,1,0.44,0.4394,0.51,0.2836,87,252,339,339,1,Sore
10141,2012-03-03,1,3,14,0,6,0,2,0.46,0.4545,0.44,0.3582,151,279,430,430,1,Sore
10142,2012-03-03,1,3,15,0,6,0,1,0.48,0.4697,0.29,0.2985,145,254,399,399,1,Sore
10143,2012-03-03,1,3,16,0,6,0,1,0.5,0.4848,0.27,0.2985,167,300,467,467,1,Sore
10144,2012-03-03,1,3,17,0,6,0,1,0.5,0.4848,0.23,0.3284,106,279,385,385,1,Sore
10145,2012-03-03,1,3,18,0,6,0,1,0.5,0.4848,0.25,0.2537,53,250,303,303,1,Sore
10146,2012-03-03,1,3,19,0,6,0,1,0.46,0.4545,0.33,0.1642,34,191,225,225,1,Malam
10147,2012-03-03,1,3,20,0,6,0,1,0.44,0.4394,0.3,0.1343,28,121,149,149,1,Malam
10148,2012-03-03,1,3,21,0,6,0,1,0.46,0.4545,0.19,0.3284,24,130,154,154,1,Malam
10149,2012-03-03,1,3,22,0,6,0,1,0.44,0.4394,0.21,0.1343,19,115,134,134,1,Malam
10150,2012-03-03,1,3,23,0,6,0,1,0.42,0.4242,0.24,0.0,12,94,106,106,1,Malam
10151,2012-03-04,1,3,0,0,0,0,2,0.4,0.4091,0.3,0.3582,5,67,72,72,1,
10152,2012-03-04,1,3,1,0,0,0,2,0.38,0.3939,0.34,0.194,16,60,76,76,1,Pagi
10153,2012-03-04,1,3,2,0,0,0,2,0.36,0.3485,0.4,0.1642,14,66,80,80,1,Pagi
10154,2012-03-04,1,3,3,0,0,0,2,0.36,0.3485,0.43,0.1343,5,21,26,26,1,Pagi
10155,2012-03-04,1,3,4,0,0,0,2,0.34,0.3333,0.46,0.194,3,11,14,14,1,Pagi
10156,2012-03-04,1,3,5,0,0,0,2,0.34,0.3182,0.46,0.2239,0,5,5,5,1,Pagi
10157,2012-03-04,1,3,6,0,0,0,2,0.3,0.2727,0.52,0.2985,0,5,5,5,1,Pagi
10158,2012-03-04,1,3,7,0,0,0,2,0.3,0.2727,0.52,0.2985,2,21,23,23,1,Siang
10159,2012-03-04,1,3,8,0,0,0,1,0.3,0.2727,0.52,0.3284,12,54,66,66,1,Siang
10160,2012-03-04,1,3,9,0,0,0,1,0.3,0.2727,0.49,0.4478,14,104,118,118,1,Siang
10161,2012-03-04,1,3,10,0,0,0,1,0.3,0.2727,0.49,0.3284,31,161,192,192,1,Siang
10162,2012-03-04,1,3,11,0,0,0,1,0.32,0.2879,0.45,0.3881,64,192,256,256,1,Siang
10163,2012-03-04,1,3,12,0,0,0,1,0.34,0.303,0.42,0.3582,71,256,327,327,1,Siang
10164,2012-03-04,1,3,13,0,0,0,1,0.36,0.3333,0.37,0.3582,108,256,364,364,1,Sore
10165,2012-03-04,1,3,14,0,0,0,1,0.36,0.3333,0.34,0.3582,106,226,332,332,1,Sore
10166,2012-03-04,1,3,15,0,0,0,1,0.36,0.3182,0.32,0.5224,82,252,334,334,1,Sore
10167,2012-03-04,1,3,16,0,0,0,1,0.36,0.3182,0.29,0.4925,68,231,299,299,1,Sore
10168,2012-03-04,1,3,17,0,0,0,1,0.34,0.2879,0.31,0.5522,49,214,263,263,1,Sore
10169,2012-03-04,1,3,18,0,0,0,1,0.32,0.2727,0.33,0.6119,20,164,184,184,1,Sore
10170,2012-03-04,1,3,19,0,0,0,1,0.3,0.2576,0.36,0.4925,12,120,132,132,1,Malam
10171,2012-03-04,1,3,20,0,0,0,1,0.28,0.2727,0.38,0.2537,8,80,88,88,1,Malam
10172,2012-03-04,1,3,21,0,0,0,1,0.28,0.2727,0.36,0.2239,9,70,79,79,1,Malam
10173,2012-03-04,1,3,22,0,0,0,1,0.26,0.2424,0.41,0.2537,9,53,62,62,1,Malam
10174,2012-03-04,1,3,23,0,0,0,1,0.26,0.2576,0.41,0.194,2,24,26,26,1,Malam
10175,2012-03-05,1,3,0,0,1,1,1,0.24,0.2273,0.44,0.194,2,15,17,17,1,
10176,2012-03-05,1,3,1,0,1,1,1,0.24,0.2424,0.48,0.1343,3,3,6,6,1,Pagi
10177,2012-03-05,1,3,2,0,1,1,1,0.24,0.2424,0.48,0.1343,1,3,4,4,1,Pagi
10178,2012-03-05,1,3,3,0,1,1,1,0.22,0.2273,0.51,0.1642,0,1,1,1,1,Pagi
10179,2012-03-05,1,3,4,0,1,1,1,0.2,0.2273,0.55,0.0896,0,1,1,1,1,Pagi
10180,2012-03-05,1,3,5,0,1,1,1,0.2,0.2273,0.55,0.0896,1,17,18,18,1,Pagi
10181,2012-03-05,1,3,6,0,1,1,1,0.18,0.197,0.59,0.1343,2,89,91,91,1,Pagi
10182,2012-03-05,1,3,7,0,1,1,1,0.18,0.197,0.59,0.1343,7,253,260,260,1,Siang
10183,2012-03-05,1,3,8,0,1,1,1,0.2,0.2273,0.59,0.1045,13,415,428,428,1,Siang
10184,2012-03-05,1,3,9,0,1,1,2,0.22,0.2576,0.6,0.0896,11,186,197,197,1,Siang
10185,2012-03-05,1,3,10,0,1,1,2,0.24,0.2576,0.6,0.0,12,74,86,86,1,Siang
10186,2012-03-05,1,3,11,0,1,1,2,0.26,0.2727,0.56,0.1343,17,86,103,103,1,Siang
10187,2012-03-05,1,3,12,0,1,1,2,0.26,0.303,0.52,0.0,15,122,137,137,1,Siang
10188,2012-03-05,1,3,13,0,1,1,2,0.26,0.2576,0.55,0.2985,11,109,120,120,1,Sore
10189,2012-03-05,1,3,14,0,1,1,2,0.28,0.2576,0.57,0.3582,13,115,128,128,1,Sore
10190,2012-03-05,1,3,15,0,1,1,2,0.3,0.2879,0.53,0.194,20,110,130,130,1,Sore
10191,2012-03-05,1,3,16,0,1,1,1,0.3,0.2727,0.45,0.2985,30,180,210,210,1,Sore
10192,2012-03-05,1,3,17,0,1,1,3,0.3,0.2727,0.45,0.2985,11,376,387,387,1,Sore
10193,2012-03-05,1,3,18,0,1,1,3,0.28,0.2273,0.55,0.6567,12,363,375,375,1,Sore
10194,2012-03-05,1,3,19,0,1,1,1,0.26,0.2576,0.53,0.2239,6,220,226,226,1,Malam
10195,2012-03-05,1,3,20,0,1,1,1,0.26,0.2273,0.37,0.4627,8,171,179,179,1,Malam
10196,2012-03-05,1,3,21,0,1,1,1,0.26,0.2273,0.37,0.3881,4,116,120,120,1,Malam
10197,2012-03-05,1,3,22,0,1,1,1,0.24,0.2121,0.35,0.3284,2,76,78,78,1,Malam
10198,2012-03-05,1,3,23,0,1,1,1,0.22,0.1818,0.37,0.5821,2,29,31,31,1,Malam
10199,2012-03-06,1,3,0,0,2,1,1,0.22,0.2121,0.37,0.2985,0,8,8,8,1,
10200,2012-03-06,1,3,1,0,2,1,1,0.2,0.197,0.44,0.2537,0,6,6,6,1,Pagi
10201,2012-03-06,1,3,2,0,2,1,1,0.2,0.197,0.44,0.2239,0,4,4,4,1,Pagi
10202,2012-03-06,1,3,3,0,2,1,1,0.18,0.1667,0.51,0.2836,0,1,1,1,1,Pagi
10203,2012-03-06,1,3,4,0,2,1,1,0.18,0.1667,0.51,0.2985,0,3,3,3,1,Pagi
10204,2012-03-06,1,3,5,0,2,1,1,0.18,0.1818,0.51,0.2239,0,25,25,25,1,Pagi
10205,2012-03-06,1,3,6,0,2,1,1,0.18,0.2121,0.51,0.1045,3,99,102,102,1,Pagi
10206,2012-03-06,1,3,7,0,2,1,1,0.16,0.1818,0.55,0.1343,5,270,275,275,1,Siang
10207,2012-03-06,1,3,8,0,2,1,1,0.16,0.1818,0.59,0.1045,14,487,501,501,1,Siang
10208,2012-03-06,1,3,9,0,2,1,1,0.22,0.2727,0.47,0.0,11,222,233,233,1,Siang
10209,2012-03-06,1,3,10,0,2,1,1,0.24,0.2576,0.44,0.0,16,113,129,129,1,Siang
10210,2012-03-06,1,3,11,0,2,1,1,0.26,0.2576,0.41,0.1642,20,110,130,130,1,Siang
10211,2012-03-06,1,3,12,0,2,1,1,0.26,0.2727,0.41,0.1045,9,129,138,138,1,Siang
10212,2012-03-06,1,3,13,0,2,1,1,0.3,0.303,0.39,0.1343,16,148,164,164,1,Sore
10213,2012-03-06,1,3,14,0,2,1,1,0.32,0.303,0.36,0.2239,20,116,136,136,1,Sore
10214,2012-03-06,1,3,15,0,2,1,1,0.34,0.303,0.36,0.2985,24,142,166,166,1,Sore
10215,2012-03-06,1,3,16,0,2,1,1,0.36,0.3333,0.32,0.2836,22,228,250,250,1,Sore
10216,2012-03-06,1,3,17,0,2,1,1,0.36,0.3333,0.34,0.2836,21,425,446,446,1,Sore
10217,2012-03-06,1,3,18,0,2,1,1,0.34,0.303,0.42,0.3284,15,442,457,457,1,Sore
10218,2012-03-06,1,3,19,0,2,1,1,0.34,0.303,0.46,0.2985,9,278,287,287,1,Malam
10219,2012-03-06,1,3,20,0,2,1,1,0.32,0.3182,0.49,0.194,3,184,187,187,1,Malam
10220,2012-03-06,1,3,21,0,2,1,1,0.32,0.3182,0.49,0.194,5,143,148,148,1,Malam
10221,2012-03-06,1,3,22,0,2,1,1,0.28,0.2727,0.56,0.1642,5,101,106,106,1,Malam
10222,2012-03-06,1,3,23,0,2,1,1,0.28,0.2727,0.61,0.2239,3,51,54,54,1,Malam
10223,2012-03-07,1,3,0,0,3,1,1,0.28,0.2576,0.65,0.2836,3,12,15,15,1,
10224,2012-03-07,1,3,1,0,3,1,1,0.3,0.2727,0.61,0.2985,1,4,5,5,1,Pagi
10225,2012-03-07,1,3,2,0,3,1,1,0.3,0.2879,0.56,0.2836,0,4,4,4,1,Pagi
10226,2012-03-07,1,3,3,0,3,1,1,0.3,0.2727,0.56,0.3582,1,2,3,3,1,Pagi
10227,2012-03-07,1,3,4,0,3,1,1,0.28,0.2576,0.61,0.3284,0,3,3,3,1,Pagi
10228,2012-03-07,1,3,5,0,3,1,1,0.28,0.2576,0.56,0.2985,0,18,18,18,1,Pagi
10229,2012-03-07,1,3,6,0,3,1,1,0.28,0.2576,0.61,0.3881,4,104,108,108,1,Pagi
10230,2012-03-07,1,3,7,0,3,1,1,0.26,0.2273,0.65,0.3881,12,332,344,344,1,Siang
10231,2012-03-07,1,3,8,0,3,1,1,0.28,0.2576,0.61,0.2985,12,554,566,566,1,Siang
10232,2012-03-07,1,3,9,0,3,1,1,0.3,0.2727,0.61,0.3284,12,252,264,264,1,Siang
10233,2012-03-07,1,3,10,0,3,1,1,0.36,0.3333,0.5,0.2985,20,127,147,147,1,Siang
10234,2012-03-07,1,3,11,0,3,1,1,0.42,0.4242,0.38,0.2985,33,128,161,161,1,Siang
10235,2012-03-07,1,3,12,0,3,1,1,0.44,0.4394,0.38,0.3881,40,175,215,215,1,Siang
10236,2012-03-07,1,3,13,0,3,1,1,0.5,0.4848,0.34,0.4179,26,179,205,205,1,Sore
10237,2012-03-07,1,3,14,0,3,1,1,0.52,0.5,0.36,0.3284,38,137,175,175,1,Sore
10238,2012-03-07,1,3,15,0,3,1,1,0.54,0.5152,0.37,0.4478,44,165,209,209,1,Sore
10239,2012-03-07,1,3,16,0,3,1,1,0.56,0.5303,0.37,0.4179,34,254,288,288,1,Sore
10240,2012-03-07,1,3,17,0,3,1,1,0.56,0.5303,0.43,0.4925,58,554,612,612,1,Sore
10241,2012-03-07,1,3,18,0,3,1,1,0.56,0.5303,0.4,0.4627,35,509,544,544,1,Sore
10242,2012-03-07,1,3,19,0,3,1,1,0.54,0.5152,0.42,0.3582,16,345,361,361,1,Malam
10243,2012-03-07,1,3,20,0,3,1,1,0.5,0.4848,0.51,0.2537,18,242,260,260,1,Malam
10244,2012-03-07,1,3,21,0,3,1,1,0.44,0.4394,0.62,0.2537,11,177,188,188,1,Malam
10245,2012-03-07,1,3,22,0,3,1,1,0.46,0.4545,0.59,0.2985,10,149,159,159,1,Malam
10246,2012-03-07,1,3,23,0,3,1,1,0.44,0.4394,0.62,0.3284,4,58,62,62,1,Malam
10247,2012-03-08,1,3,0,0,4,1,1,0.44,0.4394,0.62,0.3284,11,35,46,46,1,
10248,2012-03-08,1,3,1,0,4,1,1,0.46,0.4545,0.63,0.3284,4,17,21,21,1,Pagi
10249,2012-03-08,1,3,2,0,4,1,1,0.46,0.4545,0.63,0.3881,6,5,11,11,1,Pagi
10250,2012-03-08,1,3,3,0,4,1,1,0.46,0.4545,0.63,0.3881,0,3,3,3,1,Pagi
10251,2012-03-08,1,3,4,0,4,1,1,0.44,0.4394,0.72,0.2836,0,2,2,2,1,Pagi
10252,2012-03-08,1,3,5,0,4,1,1,0.42,0.4242,0.77,0.2239,1,28,29,29,1,Pagi
10253,2012-03-08,1,3,6,0,4,1,1,0.42,0.4242,0.77,0.2537,4,105,109,109,1,Pagi
10254,2012-03-08,1,3,7,0,4,1,1,0.42,0.4242,0.77,0.3582,8,326,334,334,1,Siang
10255,2012-03-08,1,3,8,0,4,1,1,0.44,0.4394,0.77,0.3881,12,573,585,585,1,Siang
10256,2012-03-08,1,3,9,0,4,1,1,0.46,0.4545,0.72,0.4627,19,282,301,301,1,Siang
10257,2012-03-08,1,3,10,0,4,1,1,0.5,0.4848,0.68,0.4627,19,119,138,138,1,Siang
10258,2012-03-08,1,3,11,0,4,1,2,0.54,0.5152,0.6,0.4627,48,156,204,204,1,Siang
10259,2012-03-08,1,3,12,0,4,1,2,0.56,0.5303,0.6,0.4478,27,224,251,251,1,Siang
10260,2012-03-08,1,3,13,0,4,1,2,0.6,0.6212,0.49,0.6418,35,198,233,233,1,Sore
10261,2012-03-08,1,3,14,0,4,1,2,0.62,0.6212,0.43,0.6418,48,155,203,203,1,Sore
10262,2012-03-08,1,3,15,0,4,1,1,0.64,0.6212,0.38,0.6866,24,161,185,185,1,Sore
10263,2012-03-08,1,3,16,0,4,1,2,0.62,0.6212,0.41,0.6418,37,305,342,342,1,Sore
10264,2012-03-08,1,3,17,0,4,1,1,0.62,0.6212,0.38,0.6567,52,545,597,597,1,Sore
10265,2012-03-08,1,3,18,0,4,1,2,0.62,0.6212,0.38,0.5522,45,545,590,590,1,Sore
10266,2012-03-08,1,3,19,0,4,1,2,0.6,0.6212,0.4,0.4478,21,395,416,416,1,Malam
10267,2012-03-08,1,3,20,0,4,1,2,0.6,0.6212,0.43,0.3881,20,282,302,302,1,Malam
10268,2012-03-08,1,3,21,0,4,1,1,0.6,0.6212,0.43,0.3881,27,206,233,233,1,Malam
10269,2012-03-08,1,3,22,0,4,1,1,0.56,0.5303,0.49,0.3284,12,141,153,153,1,Malam
10270,2012-03-08,1,3,23,0,4,1,2,0.56,0.5303,0.49,0.4478,6,88,94,94,1,Malam
10271,2012-03-09,1,3,0,0,5,1,2,0.58,0.5455,0.49,0.4627,3,51,54,54,1,
10272,2012-03-09,1,3,1,0,5,1,3,0.56,0.5303,0.52,0.4925,4,22,26,26,1,Pagi
10273,2012-03-09,1,3,2,0,5,1,3,0.48,0.4697,0.77,0.4179,2,9,11,11,1,Pagi
10274,2012-03-09,1,3,3,0,5,1,1,0.46,0.4545,0.77,0.5224,0,7,7,7,1,Pagi
10275,2012-03-09,1,3,4,0,5,1,3,0.4,0.4091,0.66,0.2836,0,1,1,1,1,Pagi
10276,2012-03-09,1,3,5,0,5,1,3,0.4,0.4091,0.66,0.2836,2,27,29,29,1,Pagi
10277,2012-03-09,1,3,6,0,5,1,2,0.4,0.4091,0.5,0.3582,2,83,85,85,1,Pagi
10278,2012-03-09,1,3,7,0,5,1,2,0.38,0.3939,0.4,0.2985,6,262,268,268,1,Siang
10279,2012-03-09,1,3,8,0,5,1,2,0.34,0.2879,0.42,0.5224,17,484,501,501,1,Siang
10280,2012-03-09,1,3,9,0,5,1,2,0.34,0.2879,0.42,0.5224,17,267,284,284,1,Siang
10281,2012-03-09,1,3,10,0,5,1,2,0.34,0.2879,0.36,0.4925,14,145,159,159,1,Siang
10282,2012-03-09,1,3,11,0,5,1,2,0.36,0.3333,0.34,0.3582,17,170,187,187,1,Siang
10283,2012-03-09,1,3,12,0,5,1,1,0.36,0.3333,0.34,0.4179,27,174,201,201,1,Siang
10284,2012-03-09,1,3,13,0,5,1,2,0.38,0.3939,0.29,0.3881,49,175,224,224,1,Sore
10285,2012-03-09,1,3,14,0,5,1,1,0.42,0.4242,0.28,0.4627,49,129,178,178,1,Sore
10286,2012-03-09,1,3,15,0,5,1,1,0.46,0.4545,0.24,0.2537,50,188,238,238,1,Sore
10287,2012-03-09,1,3,16,0,5,1,1,0.48,0.4697,0.23,0.4179,51,292,343,343,1,Sore
10288,2012-03-09,1,3,17,0,5,1,1,0.46,0.4545,0.24,0.3881,68,498,566,566,1,Sore
10289,2012-03-09,1,3,18,0,5,1,1,0.44,0.4394,0.26,0.5224,30,440,470,470,1,Sore
10290,2012-03-09,1,3,19,0,5,1,1,0.42,0.4242,0.28,0.6119,12,232,244,244,1,Malam
10291,2012-03-09,1,3,20,0,5,1,1,0.38,0.3939,0.32,0.3582,3,156,159,159,1,Malam
10292,2012-03-09,1,3,21,0,5,1,1,0.36,0.3333,0.34,0.3284,8,133,141,141,1,Malam
10293,2012-03-09,1,3,22,0,5,1,1,0.34,0.2879,0.31,0.4925,7,100,107,107,1,Malam
10294,2012-03-09,1,3,23,0,5,1,1,0.32,0.303,0.33,0.2985,9,77,86,86,1,Malam
10295,2012-03-10,1,3,0,0,6,0,1,0.3,0.2727,0.36,0.3582,9,68,77,77,1,
10296,2012-03-10,1,3,1,0,6,0,1,0.3,0.2879,0.36,0.2537,1,50,51,51,1,Pagi
10297,2012-03-10,1,3,2,0,6,0,1,0.26,0.2424,0.41,0.2537,12,30,42,42,1,Pagi
10298,2012-03-10,1,3,3,0,6,0,1,0.26,0.2273,0.41,0.2985,0,16,16,16,1,Pagi
10299,2012-03-10,1,3,4,0,6,0,1,0.24,0.2121,0.41,0.3582,1,3,4,4,1,Pagi
10300,2012-03-10,1,3,5,0,6,0,1,0.22,0.2121,0.42,0.2836,3,7,10,10,1,Pagi
10301,2012-03-10,1,3,6,0,6,0,1,0.22,0.2121,0.44,0.2836,1,11,12,12,1,Pagi
10302,2012-03-10,1,3,7,0,6,0,1,0.22,0.2121,0.44,0.2537,4,36,40,40,1,Siang
10303,2012-03-10,1,3,8,0,6,0,1,0.22,0.2121,0.44,0.2985,15,96,111,111,1,Siang
10304,2012-03-10,1,3,9,0,6,0,1,0.24,0.2121,0.41,0.3284,21,127,148,148,1,Siang
10305,2012-03-10,1,3,10,0,6,0,1,0.26,0.2273,0.35,0.4179,47,176,223,223,1,Siang
10306,2012-03-10,1,3,11,0,6,0,1,0.3,0.2727,0.33,0.3284,56,218,274,274,1,Siang
10307,2012-03-10,1,3,12,0,6,0,1,0.3,0.2727,0.33,0.3284,88,241,329,329,1,Siang
10308,2012-03-10,1,3,13,0,6,0,1,0.32,0.303,0.29,0.2836,89,268,357,357,1,Sore
10309,2012-03-10,1,3,14,0,6,0,1,0.34,0.3182,0.27,0.2836,117,262,379,379,1,Sore
10310,2012-03-10,1,3,15,0,6,0,1,0.34,0.3636,0.25,0.0,132,274,406,406,1,Sore
10311,2012-03-10,1,3,16,0,6,0,1,0.36,0.3636,0.23,0.0,115,275,390,390,1,Sore
10312,2012-03-10,1,3,17,0,6,0,1,0.36,0.3788,0.23,0.0,104,250,354,354,1,Sore
10313,2012-03-10,1,3,18,0,6,0,1,0.36,0.3636,0.21,0.0896,67,230,297,297,1,Sore
10314,2012-03-10,1,3,19,0,6,0,1,0.34,0.3636,0.25,0.0,25,159,184,184,1,Malam
10315,2012-03-10,1,3,20,0,6,0,1,0.32,0.3333,0.33,0.1343,20,101,121,121,1,Malam
10316,2012-03-10,1,3,21,0,6,0,1,0.3,0.2879,0.39,0.2239,16,94,110,110,1,Malam
10317,2012-03-10,1,3,22,0,6,0,1,0.26,0.2576,0.44,0.1642,19,81,100,100,1,Malam
10318,2012-03-10,1,3,23,0,6,0,1,0.26,0.2576,0.41,0.194,6,77,83,83,1,Malam
10319,2012-03-11,1,3,0,0,0,0,1,0.26,0.2879,0.44,0.0896,7,62,69,69,1,
10320,2012-03-11,1,3,1,0,0,0,1,0.24,0.2424,0.52,0.1642,4,57,61,61,1,Pagi
10321,2012-03-11,1,3,3,0,0,0,1,0.24,0.2424,0.6,0.1343,15,51,66,66,1,Pagi
10322,2012-03-11,1,3,4,0,0,0,1,0.24,0.2424,0.6,0.1343,7,15,22,22,1,Pagi
10323,2012-03-11,1,3,5,0,0,0,1,0.24,0.2424,0.6,0.1642,2,5,7,7,1,Pagi
10324,2012-03-11,1,3,6,0,0,0,1,0.24,0.2424,0.7,0.1642,2,8,10,10,1,Pagi
10325,2012-03-11,1,3,7,0,0,0,1,0.22,0.2273,0.69,0.1343,2,15,17,17,1,Siang
10326,2012-03-11,1,3,8,0,0,0,1,0.22,0.2273,0.69,0.1343,4,68,72,72,1,Siang
10327,2012-03-11,1,3,9,0,0,0,1,0.26,0.2576,0.6,0.2239,20,70,90,90,1,Siang
10328,2012-03-11,1,3,10,0,0,0,1,0.32,0.303,0.49,0.2836,71,147,218,218,1,Siang
10329,2012-03-11,1,3,11,0,0,0,1,0.36,0.3333,0.43,0.2836,90,209,299,299,1,Siang
10330,2012-03-11,1,3,12,0,0,0,1,0.4,0.4091,0.37,0.2985,146,264,410,410,1,Siang
10331,2012-03-11,1,3,13,0,0,0,1,0.42,0.4242,0.41,0.2985,176,288,464,464,1,Sore
10332,2012-03-11,1,3,14,0,0,0,1,0.46,0.4545,0.31,0.2836,212,289,501,501,1,Sore
10333,2012-03-11,1,3,15,0,0,0,1,0.5,0.4848,0.29,0.2985,201,286,487,487,1,Sore
10334,2012-03-11,1,3,16,0,0,0,1,0.5,0.4848,0.31,0.3582,208,301,509,509,1,Sore
10335,2012-03-11,1,3,17,0,0,0,1,0.52,0.5,0.27,0.2985,199,299,498,498,1,Sore
10336,2012-03-11,1,3,18,0,0,0,1,0.52,0.5,0.29,0.2836,133,256,389,389,1,Sore
10337,2012-03-11,1,3,19,0,0,0,1,0.5,0.4848,0.31,0.2836,55,203,258,258,1,Malam
10338,2012-03-11,1,3,20,0,0,0,1,0.44,0.4394,0.47,0.2239,42,129,171,171,1,Malam
10339,2012-03-11,1,3,21,0,0,0,1,0.42,0.4242,0.54,0.2239,37,110,147,147,1,Malam
10340,2012-03-11,1,3,22,0,0,0,1,0.4,0.4091,0.54,0.194,13,81,94,94,1,Malam
10341,2012-03-11,1,3,23,0,0,0,1,0.4,0.4091,0.5,0.1642,12,40,52,52,1,Malam
10342,2012-03-12,1,3,0,0,1,1,1,0.38,0.3939,0.54,0.194,4,20,24,24,1,
10343,2012-03-12,1,3,1,0,1,1,1,0.38,0.3939,0.5,0.1343,1,9,10,10,1,Pagi
10344,2012-03-12,1,3,2,0,1,1,1,0.38,0.3939,0.54,0.1045,4,5,9,9,1,Pagi
10345,2012-03-12,1,3,3,0,1,1,1,0.36,0.3485,0.5,0.1343,0,2,2,2,1,Pagi
10346,2012-03-12,1,3,4,0,1,1,1,0.34,0.3333,0.61,0.194,0,3,3,3,1,Pagi
10347,2012-03-12,1,3,5,0,1,1,1,0.34,0.3333,0.61,0.194,1,15,16,16,1,Pagi
10348,2012-03-12,1,3,6,0,1,1,1,0.34,0.3485,0.57,0.1045,2,86,88,88,1,Pagi
10349,2012-03-12,1,3,7,0,1,1,1,0.34,0.3485,0.53,0.1045,9,259,268,268,1,Siang
10350,2012-03-12,1,3,8,0,1,1,1,0.34,0.3333,0.61,0.1343,17,547,564,564,1,Siang
10351,2012-03-12,1,3,9,0,1,1,1,0.38,0.3939,0.54,0.1642,21,260,281,281,1,Siang
10352,2012-03-12,1,3,10,0,1,1,1,0.4,0.4091,0.5,0.2239,39,98,137,137,1,Siang
10353,2012-03-12,1,3,11,0,1,1,1,0.44,0.4394,0.44,0.2239,39,111,150,150,1,Siang
10354,2012-03-12,1,3,12,0,1,1,1,0.48,0.4697,0.39,0.2239,59,162,221,221,1,Siang
10355,2012-03-12,1,3,13,0,1,1,2,0.54,0.5152,0.32,0.2537,74,176,250,250,1,Sore
10356,2012-03-12,1,3,14,0,1,1,2,0.58,0.5455,0.32,0.2836,76,145,221,221,1,Sore
10357,2012-03-12,1,3,15,0,1,1,1,0.56,0.5303,0.4,0.1343,74,159,233,233,1,Sore
10358,2012-03-12,1,3,16,0,1,1,1,0.62,0.6212,0.35,0.4478,77,255,332,332,1,Sore
10359,2012-03-12,1,3,17,0,1,1,2,0.62,0.6212,0.38,0.4179,87,557,644,644,1,Sore
10360,2012-03-12,1,3,18,0,1,1,2,0.6,0.6212,0.43,0.194,89,623,712,712,1,Sore
10361,2012-03-12,1,3,19,0,1,1,2,0.56,0.5303,0.49,0.2239,67,379,446,446,1,Malam
10362,2012-03-12,1,3,20,0,1,1,2,0.56,0.5303,0.49,0.2239,49,237,286,286,1,Malam
10363,2012-03-12,1,3,21,0,1,1,2,0.54,0.5152,0.56,0.2239,22,183,205,205,1,Malam
10364,2012-03-12,1,3,22,0,1,1,2,0.56,0.5303,0.56,0.2239,17,116,133,133,1,Malam
10365,2012-03-12,1,3,23,0,1,1,1,0.56,0.5303,0.56,0.2239,10,53,63,63,1,Malam
10366,2012-03-13,1,3,0,0,2,1,2,0.56,0.5303,0.52,0.194,5,21,26,26,1,
10367,2012-03-13,1,3,1,0,2,1,2,0.52,0.5,0.59,0.2239,2,14,16,16,1,Pagi
10368,2012-03-13,1,3,2,0,2,1,3,0.52,0.5,0.72,0.2985,0,1,1,1,1,Pagi
10369,2012-03-13,1,3,3,0,2,1,3,0.52,0.5,0.72,0.2985,0,2,2,2,1,Pagi
10370,2012-03-13,1,3,4,0,2,1,2,0.46,0.4545,0.82,0.194,0,1,1,1,1,Pagi
10371,2012-03-13,1,3,5,0,2,1,2,0.46,0.4545,0.82,0.194,0,24,24,24,1,Pagi
10372,2012-03-13,1,3,6,0,2,1,3,0.46,0.4545,0.82,0.194,5,108,113,113,1,Pagi
10373,2012-03-13,1,3,7,0,2,1,2,0.46,0.4545,0.82,0.2836,16,292,308,308,1,Siang
10374,2012-03-13,1,3,8,0,2,1,1,0.46,0.4545,0.82,0.2836,22,571,593,593,1,Siang
10375,2012-03-13,1,3,9,0,2,1,1,0.48,0.4697,0.82,0.2836,18,324,342,342,1,Siang
10376,2012-03-13,1,3,10,0,2,1,1,0.52,0.5,0.77,0.2239,28,115,143,143,1,Siang
10377,2012-03-13,1,3,11,0,2,1,1,0.54,0.5152,0.73,0.2836,64,155,219,219,1,Siang
10378,2012-03-13,1,3,12,0,2,1,1,0.6,0.6061,0.6,0.2836,47,197,244,244,1,Siang
10379,2012-03-13,1,3,13,0,2,1,1,0.6,0.6061,0.6,0.3881,53,180,233,233,1,Sore
10380,2012-03-13,1,3,14,0,2,1,1,0.64,0.6212,0.53,0.3284,52,160,212,212,1,Sore
10381,2012-03-13,1,3,15,0,2,1,1,0.7,0.6364,0.39,0.2239,68,196,264,264,1,Sore
10382,2012-03-13,1,3,16,0,2,1,1,0.72,0.6515,0.34,0.3881,53,312,365,365,1,Sore
10383,2012-03-13,1,3,17,0,2,1,1,0.7,0.6364,0.37,0.1045,62,614,676,676,1,Sore
10384,2012-03-13,1,3,18,0,2,1,1,0.7,0.6364,0.34,0.2985,96,638,734,734,1,Sore
10385,2012-03-13,1,3,19,0,2,1,1,0.64,0.6212,0.47,0.2239,50,429,479,479,1,Malam
10386,2012-03-13,1,3,20,0,2,1,1,0.6,0.6212,0.49,0.1642,45,306,351,351,1,Malam
10387,2012-03-13,1,3,21,0,2,1,1,0.58,0.5455,0.56,0.1045,44,200,244,244,1,Malam
10388,2012-03-13,1,3,22,0,2,1,1,0.56,0.5303,0.6,0.0896,24,146,170,170,1,Malam
10389,2012-03-13,1,3,23,0,2,1,1,0.56,0.5303,0.56,0.1343,8,79,87,87,1,Malam
10390,2012-03-14,1,3,0,0,3,1,1,0.54,0.5152,0.6,0.1045,5,34,39,39,1,
10391,2012-03-14,1,3,1,0,3,1,1,0.52,0.5,0.63,0.0896,2,25,27,27,1,Pagi
10392,2012-03-14,1,3,2,0,3,1,1,0.5,0.4848,0.68,0.194,0,2,2,2,1,Pagi
10393,2012-03-14,1,3,3,0,3,1,1,0.48,0.4697,0.72,0.194,1,3,4,4,1,Pagi
10394,2012-03-14,1,3,4,0,3,1,1,0.48,0.4697,0.67,0.0896,1,4,5,5,1,Pagi
10395,2012-03-14,1,3,5,0,3,1,1,0.44,0.4394,0.82,0.1343,2,25,27,27,1,Pagi
10396,2012-03-14,1,3,6,0,3,1,1,0.44,0.4394,0.82,0.0896,1,120,121,121,1,Pagi
10397,2012-03-14,1,3,7,0,3,1,1,0.44,0.4394,0.82,0.1045,20,348,368,368,1,Siang
10398,2012-03-14,1,3,8,0,3,1,1,0.44,0.4394,0.82,0.0,34,628,662,662,1,Siang
10399,2012-03-14,1,3,9,0,3,1,1,0.52,0.5,0.68,0.0,26,325,351,351,1,Siang
10400,2012-03-14,1,3,10,0,3,1,1,0.56,0.5303,0.56,0.1045,38,150,188,188,1,Siang
10401,2012-03-14,1,3,11,0,3,1,2,0.62,0.6212,0.41,0.1642,65,155,220,220,1,Siang
10402,2012-03-14,1,3,12,0,3,1,2,0.64,0.6212,0.29,0.0,55,212,267,267,1,Siang
10403,2012-03-14,1,3,13,0,3,1,1,0.66,0.6212,0.27,0.2239,57,197,254,254,1,Sore
10404,2012-03-14,1,3,14,0,3,1,1,0.7,0.6364,0.23,0.3284,61,163,224,224,1,Sore
10405,2012-03-14,1,3,15,0,3,1,1,0.7,0.6364,0.24,0.0,86,197,283,283,1,Sore
10406,2012-03-14,1,3,16,0,3,1,1,0.72,0.6364,0.25,0.194,78,278,356,356,1,Sore
10407,2012-03-14,1,3,17,0,3,1,1,0.7,0.6364,0.28,0.0896,140,642,782,782,1,Sore
10408,2012-03-14,1,3,18,0,3,1,1,0.7,0.6364,0.32,0.0,102,647,749,749,1,Sore
10409,2012-03-14,1,3,19,0,3,1,1,0.64,0.6212,0.33,0.1642,70,402,472,472,1,Malam
10410,2012-03-14,1,3,20,0,3,1,1,0.62,0.6212,0.35,0.1045,44,286,330,330,1,Malam
10411,2012-03-14,1,3,21,0,3,1,1,0.6,0.6212,0.4,0.0896,47,241,288,288,1,Malam
10412,2012-03-14,1,3,22,0,3,1,1,0.52,0.5,0.55,0.1343,43,159,202,202,1,Malam
10413,2012-03-14,1,3,23,0,3,1,1,0.56,0.5303,0.43,0.1642,19,72,91,91,1,Malam
10414,2012-03-15,1,3,0,0,4,1,1,0.54,0.5152,0.49,0.1343,14,46,60,60,1,
10415,2012-03-15,1,3,1,0,4,1,1,0.5,0.4848,0.59,0.1045,15,8,23,23,1,Pagi
10416,2012-03-15,1,3,2,0,4,1,1,0.5,0.4848,0.59,0.0,14,5,19,19,1,Pagi
10417,2012-03-15,1,3,3,0,4,1,1,0.5,0.4848,0.63,0.0,0,7,7,7,1,Pagi
10418,2012-03-15,1,3,4,0,4,1,1,0.44,0.4394,0.77,0.1045,11,3,14,14,1,Pagi
10419,2012-03-15,1,3,5,0,4,1,1,0.46,0.4545,0.67,0.0,2,24,26,26,1,Pagi
10420,2012-03-15,1,3,6,0,4,1,1,0.44,0.4394,0.72,0.0896,4,113,117,117,1,Pagi
10421,2012-03-15,1,3,7,0,4,1,1,0.44,0.4394,0.72,0.0896,14,367,381,381,1,Siang
10422,2012-03-15,1,3,8,0,4,1,1,0.44,0.4394,0.77,0.1045,21,602,623,623,1,Siang
10423,2012-03-15,1,3,9,0,4,1,1,0.48,0.4697,0.77,0.0896,30,285,315,315,1,Siang
10424,2012-03-15,1,3,10,0,4,1,1,0.52,0.5,0.68,0.1045,34,130,164,164,1,Siang
10425,2012-03-15,1,3,11,0,4,1,1,0.56,0.5303,0.6,0.1343,60,151,211,211,1,Siang
10426,2012-03-15,1,3,12,0,4,1,2,0.62,0.6212,0.5,0.1343,59,206,265,265,1,Siang
10427,2012-03-15,1,3,13,0,4,1,2,0.66,0.6212,0.41,0.0896,62,211,273,273,1,Sore
10428,2012-03-15,1,3,14,0,4,1,2,0.72,0.6515,0.3,0.1045,81,177,258,258,1,Sore
10429,2012-03-15,1,3,15,0,4,1,1,0.72,0.6515,0.32,0.2239,100,187,287,287,1,Sore
10430,2012-03-15,1,3,16,0,4,1,1,0.72,0.6515,0.37,0.3881,95,331,426,426,1,Sore
10431,2012-03-15,1,3,17,0,4,1,1,0.7,0.6364,0.39,0.2537,79,634,713,713,1,Sore
10432,2012-03-15,1,3,18,0,4,1,1,0.66,0.6212,0.44,0.2836,98,648,746,746,1,Sore
10433,2012-03-15,1,3,19,0,4,1,2,0.64,0.6212,0.5,0.194,72,353,425,425,1,Malam
10434,2012-03-15,1,3,20,0,4,1,2,0.58,0.5455,0.6,0.3582,60,270,330,330,1,Malam
10435,2012-03-15,1,3,21,0,4,1,1,0.54,0.5152,0.68,0.2836,36,207,243,243,1,Malam
10436,2012-03-15,1,3,22,0,4,1,1,0.52,0.5,0.68,0.1343,32,137,169,169,1,Malam
10437,2012-03-15,1,3,23,0,4,1,1,0.48,0.4697,0.72,0.194,12,85,97,97,1,Malam
10438,2012-03-16,1,3,0,0,5,1,1,0.44,0.4394,0.77,0.2537,8,49,57,57,1,
10439,2012-03-16,1,3,1,0,5,1,2,0.42,0.4242,0.82,0.3284,4,22,26,26,1,Pagi
10440,2012-03-16,1,3,2,0,5,1,2,0.42,0.4242,0.82,0.194,0,4,4,4,1,Pagi
10441,2012-03-16,1,3,3,0,5,1,2,0.4,0.4091,0.87,0.2836,0,3,3,3,1,Pagi
10442,2012-03-16,1,3,4,0,5,1,2,0.4,0.4091,0.87,0.2537,0,3,3,3,1,Pagi
10443,2012-03-16,1,3,5,0,5,1,2,0.4,0.4091,0.87,0.2239,2,30,32,32,1,Pagi
10444,2012-03-16,1,3,6,0,5,1,2,0.4,0.4091,0.87,0.1642,3,96,99,99,1,Pagi
10445,2012-03-16,1,3,7,0,5,1,2,0.4,0.4091,0.87,0.194,13,265,278,278,1,Siang
10446,2012-03-16,1,3,8,0,5,1,2,0.4,0.4091,0.87,0.2239,28,534,562,562,1,Siang
10447,2012-03-16,1,3,9,0,5,1,2,0.42,0.4242,0.82,0.0,35,277,312,312,1,Siang
10448,2012-03-16,1,3,10,0,5,1,2,0.4,0.4091,0.87,0.0896,44,136,180,180,1,Siang
10449,2012-03-16,1,3,11,0,5,1,2,0.44,0.4394,0.77,0.0,40,167,207,207,1,Siang
10450,2012-03-16,1,3,12,0,5,1,2,0.44,0.4394,0.82,0.1343,72,222,294,294,1,Siang
10451,2012-03-16,1,3,13,0,5,1,2,0.46,0.4545,0.77,0.0896,52,208,260,260,1,Sore
10452,2012-03-16,1,3,14,0,5,1,2,0.48,0.4697,0.72,0.0,56,146,202,202,1,Sore
10453,2012-03-16,1,3,15,0,5,1,3,0.46,0.4545,0.82,0.1045,19,88,107,107,1,Sore
10454,2012-03-16,1,3,16,0,5,1,3,0.48,0.4697,0.77,0.0,18,111,129,129,1,Sore
10455,2012-03-16,1,3,17,0,5,1,3,0.48,0.4697,0.82,0.0896,23,235,258,258,1,Sore
10456,2012-03-16,1,3,18,0,5,1,3,0.48,0.4697,0.82,0.0896,31,377,408,408,1,Sore
10457,2012-03-16,1,3,19,0,5,1,2,0.46,0.4545,0.88,0.0,23,273,296,296,1,Malam
10458,2012-03-16,1,3,20,0,5,1,1,0.46,0.4545,0.88,0.0,31,204,235,235,1,Malam
10459,2012-03-16,1,3,21,0,5,1,2,0.44,0.4394,0.94,0.0,8,144,152,152,1,Malam
10460,2012-03-16,1,3,22,0,5,1,2,0.44,0.4394,0.94,0.0,16,132,148,148,1,Malam
10461,2012-03-16,1,3,23,0,5,1,2,0.44,0.4394,0.94,0.0,22,104,126,126,1,Malam
10462,2012-03-17,1,3,0,0,6,0,2,0.44,0.4394,0.94,0.0896,13,87,100,100,1,
10463,2012-03-17,1,3,1,0,6,0,2,0.44,0.4394,0.94,0.0,12,57,69,69,1,Pagi
10464,2012-03-17,1,3,2,0,6,0,2,0.44,0.4394,0.88,0.0,10,32,42,42,1,Pagi
10465,2012-03-17,1,3,3,0,6,0,2,0.44,0.4394,0.88,0.0,2,24,26,26,1,Pagi
10466,2012-03-17,1,3,4,0,6,0,2,0.42,0.4242,0.94,0.0,0,2,2,2,1,Pagi
10467,2012-03-17,1,3,5,0,6,0,2,0.42,0.4242,0.94,0.0896,5,3,8,8,1,Pagi
10468,2012-03-17,1,3,6,0,6,0,2,0.42,0.4242,0.94,0.194,1,29,30,30,1,Pagi
10469,2012-03-17,1,3,7,0,6,0,2,0.4,0.4091,1.0,0.1343,29,57,86,86,1,Siang
10470,2012-03-17,1,3,8,0,6,0,2,0.42,0.4242,0.94,0.1045,63,155,218,218,1,Siang
10471,2012-03-17,1,3,9,0,6,0,2,0.44,0.4394,0.88,0.0896,104,217,321,321,1,Siang
10472,2012-03-17,1,3,10,0,6,0,2,0.5,0.4848,0.77,0.0896,140,303,443,443,1,Siang
10473,2012-03-17,1,3,11,0,6,0,2,0.52,0.5,0.77,0.1343,226,359,585,585,1,Siang
10474,2012-03-17,1,3,12,0,6,0,1,0.56,0.5303,0.68,0.1642,286,365,651,651,1,Siang
10475,2012-03-17,1,3,13,0,6,0,1,0.6,0.6061,0.6,0.1045,286,400,686,686,1,Sore
10476,2012-03-17,1,3,14,0,6,0,1,0.62,0.6212,0.53,0.0896,352,338,690,690,1,Sore
10477,2012-03-17,1,3,15,0,6,0,1,0.64,0.6212,0.53,0.1343,357,322,679,679,1,Sore
10478,2012-03-17,1,3,16,0,6,0,1,0.64,0.6212,0.5,0.0,367,318,685,685,1,Sore
10479,2012-03-17,1,3,17,0,6,0,1,0.64,0.6212,0.5,0.1343,291,357,648,648,1,Sore
10480,2012-03-17,1,3,18,0,6,0,1,0.62,0.6212,0.57,0.2985,221,339,560,560,1,Sore
10481,2012-03-17,1,3,19,0,6,0,1,0.58,0.5455,0.64,0.2836,155,262,417,417,1,Malam
10482,2012-03-17,1,3,20,0,6,0,1,0.56,0.5303,0.64,0.194,89,182,271,271,1,Malam
10483,2012-03-17,1,3,21,0,6,0,1,0.54,0.5152,0.68,0.1642,54,169,223,223,1,Malam
10484,2012-03-17,1,3,22,0,6,0,1,0.54,0.5152,0.68,0.0,58,153,211,211,1,Malam
10485,2012-03-17,1,3,23,0,6,0,1,0.5,0.4848,0.77,0.1642,34,151,185,185,1,Malam
10486,2012-03-18,1,3,0,0,0,0,1,0.46,0.4545,0.88,0.194,27,80,107,107,1,
10487,2012-03-18,1,3,1,0,0,0,1,0.46,0.4545,0.82,0.1343,25,88,113,113,1,Pagi
10488,2012-03-18,1,3,2,0,0,0,2,0.46,0.4545,0.82,0.1045,15,41,56,56,1,Pagi
10489,2012-03-18,1,3,3,0,0,0,2,0.44,0.4394,0.88,0.1343,3,15,18,18,1,Pagi
10490,2012-03-18,1,3,4,0,0,0,2,0.42,0.4242,0.94,0.1642,6,8,14,14,1,Pagi
10491,2012-03-18,1,3,5,0,0,0,2,0.4,0.4091,0.94,0.1045,0,6,6,6,1,Pagi
10492,2012-03-18,1,3,6,0,0,0,2,0.4,0.4091,0.94,0.1045,2,9,11,11,1,Pagi
10493,2012-03-18,1,3,7,0,0,0,3,0.42,0.4242,0.88,0.1642,17,25,42,42,1,Siang
10494,2012-03-18,1,3,8,0,0,0,2,0.42,0.4242,0.88,0.1045,25,71,96,96,1,Siang
10495,2012-03-18,1,3,9,0,0,0,2,0.42,0.4242,0.88,0.0896,65,113,178,178,1,Siang
10496,2012-03-18,1,3,10,0,0,0,2,0.42,0.4242,0.88,0.1045,139,212,351,351,1,Siang
10497,2012-03-18,1,3,11,0,0,0,2,0.44,0.4394,0.82,0.1642,129,239,368,368,1,Siang
10498,2012-03-18,1,3,12,0,0,0,2,0.44,0.4394,0.88,0.1343,222,281,503,503,1,Siang
10499,2012-03-18,1,3,13,0,0,0,2,0.46,0.4545,0.82,0.1642,198,346,544,544,1,Sore
10500,2012-03-18,1,3,14,0,0,0,2,0.5,0.4848,0.77,0.0896,218,303,521,521,1,Sore
10501,2012-03-18,1,3,15,0,0,0,1,0.54,0.5152,0.68,0.0896,240,314,554,554,1,Sore
10502,2012-03-18,1,3,16,0,0,0,1,0.54,0.5152,0.73,0.0896,229,312,541,541,1,Sore
10503,2012-03-18,1,3,17,0,0,0,1,0.56,0.5303,0.64,0.0896,233,308,541,541,1,Sore
10504,2012-03-18,1,3,18,0,0,0,1,0.56,0.5303,0.64,0.1642,165,294,459,459,1,Sore
10505,2012-03-18,1,3,19,0,0,0,1,0.56,0.5303,0.64,0.1642,118,234,352,352,1,Malam
10506,2012-03-18,1,3,20,0,0,0,1,0.52,0.5,0.77,0.1343,59,139,198,198,1,Malam
10507,2012-03-18,1,3,21,0,0,0,1,0.52,0.5,0.72,0.0896,44,129,173,173,1,Malam
10508,2012-03-18,1,3,22,0,0,0,1,0.5,0.4848,0.77,0.1045,21,79,100,100,1,Malam
10509,2012-03-18,1,3,23,0,0,0,1,0.48,0.4697,0.82,0.1642,7,39,46,46,1,Malam
10510,2012-03-19,1,3,0,0,1,1,1,0.48,0.4697,0.82,0.1045,4,19,23,23,1,
10511,2012-03-19,1,3,1,0,1,1,1,0.46,0.4545,0.88,0.1045,0,15,15,15,1,Pagi
10512,2012-03-19,1,3,2,0,1,1,1,0.46,0.4545,0.88,0.1642,1,7,8,8,1,Pagi
10513,2012-03-19,1,3,3,0,1,1,1,0.46,0.4545,0.88,0.0896,0,2,2,2,1,Pagi
10514,2012-03-19,1,3,4,0,1,1,1,0.44,0.4394,0.94,0.0,0,3,3,3,1,Pagi
10515,2012-03-19,1,3,5,0,1,1,1,0.44,0.4394,0.94,0.0,0,31,31,31,1,Pagi
10516,2012-03-19,1,3,6,0,1,1,1,0.46,0.4545,0.88,0.1343,2,118,120,120,1,Pagi
10517,2012-03-19,1,3,7,0,1,1,1,0.46,0.4545,0.88,0.194,25,329,354,354,1,Siang
10518,2012-03-19,1,3,8,0,1,1,1,0.46,0.4545,0.88,0.1045,16,563,579,579,1,Siang
10519,2012-03-19,1,3,9,0,1,1,1,0.5,0.4848,0.72,0.1642,55,276,331,331,1,Siang
10520,2012-03-19,1,3,10,0,1,1,1,0.52,0.5,0.72,0.1343,56,128,184,184,1,Siang
10521,2012-03-19,1,3,11,0,1,1,1,0.56,0.5303,0.68,0.1642,56,145,201,201,1,Siang
10522,2012-03-19,1,3,12,0,1,1,1,0.6,0.6061,0.64,0.2537,71,211,282,282,1,Siang
10523,2012-03-19,1,3,13,0,1,1,1,0.62,0.6061,0.61,0.2537,69,194,263,263,1,Sore
10524,2012-03-19,1,3,14,0,1,1,2,0.64,0.6212,0.57,0.194,60,200,260,260,1,Sore
10525,2012-03-19,1,3,15,0,1,1,1,0.64,0.6212,0.57,0.2239,97,189,286,286,1,Sore
10526,2012-03-19,1,3,16,0,1,1,1,0.66,0.6212,0.5,0.2239,65,320,385,385,1,Sore
10527,2012-03-19,1,3,17,0,1,1,1,0.64,0.6212,0.53,0.2239,106,615,721,721,1,Sore
10528,2012-03-19,1,3,18,0,1,1,1,0.64,0.6212,0.57,0.2537,120,681,801,801,1,Sore
10529,2012-03-19,1,3,19,0,1,1,1,0.62,0.6061,0.61,0.2239,86,463,549,549,1,Malam
10530,2012-03-19,1,3,20,0,1,1,1,0.6,0.6061,0.64,0.2239,34,296,330,330,1,Malam
10531,2012-03-19,1,3,21,0,1,1,1,0.6,0.6061,0.64,0.1642,33,190,223,223,1,Malam
10532,2012-03-19,1,3,22,0,1,1,2,0.56,0.5303,0.73,0.1642,17,131,148,148,1,Malam
10533,2012-03-19,1,3,23,0,1,1,2,0.56,0.5303,0.78,0.1343,9,45,54,54,1,Malam
10534,2012-03-20,1,3,0,0,2,1,2,0.56,0.5303,0.78,0.0896,5,24,29,29,1,
10535,2012-03-20,1,3,1,0,2,1,1,0.54,0.5152,0.88,0.0,6,9,15,15,1,Pagi
10536,2012-03-20,1,3,2,0,2,1,1,0.54,0.5152,0.88,0.0896,2,8,10,10,1,Pagi
10537,2012-03-20,1,3,3,0,2,1,2,0.54,0.5152,0.88,0.0,0,3,3,3,1,Pagi
10538,2012-03-20,1,3,4,0,2,1,2,0.52,0.5,0.88,0.1343,0,6,6,6,1,Pagi
10539,2012-03-20,1,3,5,0,2,1,2,0.52,0.5,0.94,0.0,0,20,20,20,1,Pagi
10540,2012-03-20,1,3,6,0,2,1,2,0.52,0.5,0.94,0.1642,6,94,100,100,1,Pagi
10541,2012-03-20,1,3,7,0,2,1,3,0.52,0.5,0.94,0.2239,3,167,170,170,1,Siang
10542,2012-03-20,1,3,8,0,2,1,2,0.52,0.5,0.88,0.1045,28,488,516,516,1,Siang
10543,2012-03-20,1,3,9,0,2,1,2,0.54,0.5152,0.88,0.1642,41,284,325,325,1,Siang
10544,2012-03-20,1,3,10,0,2,1,1,0.54,0.5152,0.88,0.194,44,119,163,163,1,Siang
10545,2012-03-20,1,3,11,0,2,1,1,0.58,0.5455,0.83,0.1343,74,156,230,230,1,Siang
10546,2012-03-20,1,3,12,0,2,1,1,0.6,0.5758,0.78,0.2537,56,205,261,261,1,Siang
10547,2012-03-20,1,3,13,0,2,1,1,0.6,0.5758,0.78,0.194,77,207,284,284,1,Sore
10548,2012-03-20,1,3,14,0,2,1,2,0.6,0.5909,0.73,0.1642,66,182,248,248,1,Sore
10549,2012-03-20,1,3,15,0,2,1,2,0.62,0.6061,0.69,0.1045,67,177,244,244,1,Sore
10550,2012-03-20,1,3,16,0,2,1,1,0.62,0.6061,0.66,0.2239,99,332,431,431,1,Sore
10551,2012-03-20,1,3,17,0,2,1,1,0.6,0.5909,0.73,0.194,108,642,750,750,1,Sore
10552,2012-03-20,1,3,18,0,2,1,1,0.6,0.5909,0.69,0.2537,136,665,801,801,1,Sore
10553,2012-03-20,1,3,19,0,2,1,1,0.58,0.5455,0.73,0.1343,75,480,555,555,1,Malam
10554,2012-03-20,1,3,20,0,2,1,1,0.58,0.5455,0.68,0.0896,78,299,377,377,1,Malam
10555,2012-03-20,1,3,21,0,2,1,1,0.56,0.5303,0.73,0.0,38,239,277,277,1,Malam
10556,2012-03-20,1,3,22,0,2,1,1,0.54,0.5152,0.77,0.0,32,156,188,188,1,Malam
10557,2012-03-20,1,3,23,0,2,1,1,0.52,0.5,0.83,0.0,10,80,90,90,1,Malam
10558,2012-03-21,1,3,0,0,3,1,1,0.52,0.5,0.88,0.0,4,29,33,33,2,
10559,2012-03-21,1,3,1,0,3,1,1,0.52,0.5,0.83,0.0896,4,22,26,26,2,Pagi
10560,2012-03-21,1,3,2,0,3,1,1,0.5,0.4848,0.88,0.1343,2,8,10,10,2,Pagi
10561,2012-03-21,1,3,3,0,3,1,2,0.5,0.4848,0.88,0.194,1,7,8,8,2,Pagi
10562,2012-03-21,1,3,4,0,3,1,2,0.5,0.4848,0.88,0.1343,0,4,4,4,2,Pagi
10563,2012-03-21,1,3,5,0,3,1,2,0.5,0.4848,0.88,0.1343,4,35,39,39,2,Pagi
10564,2012-03-21,1,3,6,0,3,1,2,0.48,0.4697,0.94,0.2239,10,139,149,149,2,Pagi
10565,2012-03-21,1,3,7,0,3,1,3,0.48,0.4697,0.94,0.194,34,338,372,372,2,Siang
10566,2012-03-21,1,3,8,0,3,1,3,0.48,0.4697,0.94,0.1045,33,502,535,535,2,Siang
10567,2012-03-21,1,3,9,0,3,1,2,0.5,0.4848,0.88,0.1642,38,255,293,293,2,Siang
10568,2012-03-21,1,3,10,0,3,1,2,0.52,0.5,0.83,0.1642,30,124,154,154,2,Siang
10569,2012-03-21,1,3,11,0,3,1,2,0.52,0.5,0.83,0.1642,38,154,192,192,2,Siang
10570,2012-03-21,1,3,12,0,3,1,2,0.54,0.5152,0.77,0.0,58,171,229,229,2,Siang
10571,2012-03-21,1,3,13,0,3,1,2,0.54,0.5152,0.83,0.0,81,222,303,303,2,Sore
10572,2012-03-21,1,3,14,0,3,1,2,0.56,0.5303,0.78,0.0,74,151,225,225,2,Sore
10573,2012-03-21,1,3,15,0,3,1,2,0.56,0.5303,0.78,0.0,68,175,243,243,2,Sore
10574,2012-03-21,1,3,16,0,3,1,1,0.58,0.5455,0.73,0.0,91,287,378,378,2,Sore
10575,2012-03-21,1,3,17,0,3,1,1,0.6,0.5909,0.69,0.0896,113,616,729,729,2,Sore
10576,2012-03-21,1,3,18,0,3,1,1,0.6,0.5909,0.69,0.0,152,627,779,779,2,Sore
10577,2012-03-21,1,3,19,0,3,1,1,0.6,0.6061,0.64,0.0,86,496,582,582,2,Malam
10578,2012-03-21,1,3,20,0,3,1,1,0.56,0.5303,0.78,0.0896,76,298,374,374,2,Malam
10579,2012-03-21,1,3,21,0,3,1,1,0.54,0.5152,0.83,0.1045,47,204,251,251,2,Malam
10580,2012-03-21,1,3,22,0,3,1,1,0.52,0.5,0.83,0.1642,41,156,197,197,2,Malam
10581,2012-03-21,1,3,23,0,3,1,1,0.54,0.5152,0.77,0.0,37,88,125,125,2,Malam
10582,2012-03-22,1,3,0,0,4,1,1,0.52,0.5,0.83,0.0896,9,32,41,41,2,
10583,2012-03-22,1,3,1,0,4,1,1,0.52,0.5,0.83,0.0896,14,16,30,30,2,Pagi
10584,2012-03-22,1,3,2,0,4,1,1,0.52,0.5,0.83,0.0896,1,5,6,6,2,Pagi
10585,2012-03-22,1,3,3,0,4,1,1,0.52,0.5,0.83,0.0896,0,7,7,7,2,Pagi
10586,2012-03-22,1,3,4,0,4,1,2,0.48,0.4697,1.0,0.0896,0,6,6,6,2,Pagi
10587,2012-03-22,1,3,5,0,4,1,2,0.48,0.4697,1.0,0.0896,2,32,34,34,2,Pagi
10588,2012-03-22,1,3,6,0,4,1,2,0.48,0.4697,1.0,0.0896,10,126,136,136,2,Pagi
10589,2012-03-22,1,3,7,0,4,1,2,0.48,0.4697,1.0,0.0896,29,332,361,361,2,Siang
10590,2012-03-22,1,3,8,0,4,1,2,0.5,0.4848,0.94,0.0896,51,598,649,649,2,Siang
10591,2012-03-22,1,3,9,0,4,1,2,0.5,0.4848,0.94,0.0896,41,277,318,318,2,Siang
10592,2012-03-22,1,3,10,0,4,1,2,0.5,0.4848,1.0,0.0896,32,110,142,142,2,Siang
10593,2012-03-22,1,3,11,0,4,1,2,0.52,0.5,0.94,0.0,53,166,219,219,2,Siang
10594,2012-03-22,1,3,12,0,4,1,2,0.54,0.5152,0.88,0.194,48,224,272,272,2,Siang
10595,2012-03-22,1,3,13,0,4,1,1,0.58,0.5455,0.78,0.0896,83,215,298,298,2,Sore
10596,2012-03-22,1,3,14,0,4,1,1,0.6,0.5909,0.73,0.1045,96,161,257,257,2,Sore
10597,2012-03-22,1,3,15,0,4,1,1,0.62,0.6061,0.69,0.194,102,202,304,304,2,Sore
10598,2012-03-22,1,3,16,0,4,1,1,0.64,0.6061,0.65,0.194,125,300,425,425,2,Sore
10599,2012-03-22,1,3,17,0,4,1,1,0.66,0.6212,0.65,0.1642,154,656,810,810,2,Sore
10600,2012-03-22,1,3,18,0,4,1,1,0.66,0.6212,0.65,0.1642,147,654,801,801,2,Sore
10601,2012-03-22,1,3,19,0,4,1,1,0.66,0.6212,0.61,0.0,117,469,586,586,2,Malam
10602,2012-03-22,1,3,20,0,4,1,1,0.62,0.5909,0.73,0.2836,64,360,424,424,2,Malam
10603,2012-03-22,1,3,21,0,4,1,1,0.58,0.5455,0.78,0.1642,66,308,374,374,2,Malam
10604,2012-03-22,1,3,22,0,4,1,1,0.56,0.5303,0.83,0.194,56,164,220,220,2,Malam
10605,2012-03-22,1,3,23,0,4,1,1,0.56,0.5303,0.83,0.0896,34,117,151,151,2,Malam
10606,2012-03-23,1,3,0,0,5,1,1,0.56,0.5303,0.83,0.0,30,65,95,95,2,
10607,2012-03-23,1,3,1,0,5,1,1,0.54,0.5152,0.88,0.0,18,32,50,50,2,Pagi
10608,2012-03-23,1,3,2,0,5,1,1,0.54,0.5152,0.88,0.0896,12,20,32,32,2,Pagi
10609,2012-03-23,1,3,3,0,5,1,1,0.52,0.5,0.88,0.1045,4,6,10,10,2,Pagi
10610,2012-03-23,1,3,4,0,5,1,2,0.5,0.4848,0.94,0.1045,0,3,3,3,2,Pagi
10611,2012-03-23,1,3,5,0,5,1,2,0.5,0.4848,0.94,0.0,5,29,34,34,2,Pagi
10612,2012-03-23,1,3,6,0,5,1,2,0.5,0.4848,0.88,0.0,6,110,116,116,2,Pagi
10613,2012-03-23,1,3,7,0,5,1,2,0.5,0.4848,0.93,0.1343,28,318,346,346,2,Siang
10614,2012-03-23,1,3,8,0,5,1,2,0.5,0.4848,0.94,0.1343,47,615,662,662,2,Siang
10615,2012-03-23,1,3,9,0,5,1,2,0.52,0.5,0.9,0.0896,75,305,380,380,2,Siang
10616,2012-03-23,1,3,10,0,5,1,2,0.56,0.5303,0.88,0.1045,125,150,275,275,2,Siang
10617,2012-03-23,1,3,11,0,5,1,2,0.62,0.5909,0.73,0.1045,131,187,318,318,2,Siang
10618,2012-03-23,1,3,12,0,5,1,2,0.66,0.6212,0.61,0.2239,199,272,471,471,2,Siang
10619,2012-03-23,1,3,13,0,5,1,2,0.7,0.6515,0.48,0.0,172,256,428,428,2,Sore
10620,2012-03-23,1,3,14,0,5,1,2,0.72,0.6515,0.42,0.1045,208,224,432,432,2,Sore
10621,2012-03-23,1,3,15,0,5,1,2,0.72,0.6515,0.42,0.1343,191,281,472,472,2,Sore
10622,2012-03-23,1,3,16,0,5,1,2,0.72,0.6515,0.42,0.1642,219,370,589,589,2,Sore
10623,2012-03-23,1,3,17,0,5,1,2,0.72,0.6515,0.42,0.1642,264,693,957,957,2,Sore
10624,2012-03-23,1,3,18,0,5,1,1,0.7,0.6364,0.45,0.1642,237,593,830,830,2,Sore
10625,2012-03-23,1,3,19,0,5,1,1,0.66,0.6212,0.5,0.194,213,473,686,686,2,Malam
10626,2012-03-23,1,3,20,0,5,1,1,0.66,0.6212,0.47,0.1343,117,328,445,445,2,Malam
10627,2012-03-23,1,3,21,0,5,1,1,0.62,0.6212,0.53,0.1045,64,220,284,284,2,Malam
10628,2012-03-23,1,3,22,0,5,1,1,0.6,0.6061,0.64,0.2836,53,218,271,271,2,Malam
10629,2012-03-23,1,3,23,0,5,1,1,0.6,0.5909,0.69,0.2537,51,125,176,176,2,Malam
10630,2012-03-24,1,3,0,0,6,0,1,0.58,0.5455,0.68,0.0,45,111,156,156,2,
10631,2012-03-24,1,3,1,0,6,0,1,0.56,0.5303,0.73,0.0896,20,108,128,128,2,Pagi
10632,2012-03-24,1,3,2,0,6,0,1,0.54,0.5152,0.77,0.1045,14,55,69,69,2,Pagi
10633,2012-03-24,1,3,3,0,6,0,1,0.54,0.5152,0.77,0.1045,10,22,32,32,2,Pagi
10634,2012-03-24,1,3,4,0,6,0,1,0.52,0.5,0.83,0.0896,1,6,7,7,2,Pagi
10635,2012-03-24,1,3,5,0,6,0,2,0.52,0.5,0.83,0.1642,0,4,4,4,2,Pagi
10636,2012-03-24,1,3,6,0,6,0,2,0.52,0.5,0.83,0.1642,4,24,28,28,2,Pagi
10637,2012-03-24,1,3,7,0,6,0,2,0.5,0.4848,0.88,0.1343,25,45,70,70,2,Siang
10638,2012-03-24,1,3,8,0,6,0,2,0.5,0.4848,0.94,0.194,41,113,154,154,2,Siang
10639,2012-03-24,1,3,9,0,6,0,2,0.52,0.5,0.83,0.1343,96,153,249,249,2,Siang
10640,2012-03-24,1,3,10,0,6,0,2,0.52,0.5,0.88,0.194,148,197,345,345,2,Siang
10641,2012-03-24,1,3,11,0,6,0,2,0.5,0.4848,0.94,0.194,98,175,273,273,2,Siang
10642,2012-03-24,1,3,12,0,6,0,3,0.52,0.5,0.94,0.2239,61,122,183,183,2,Siang
10643,2012-03-24,1,3,13,0,6,0,3,0.52,0.5,0.94,0.2537,62,134,196,196,2,Sore
10644,2012-03-24,1,3,14,0,6,0,3,0.52,0.5,0.88,0.3582,63,160,223,223,2,Sore
10645,2012-03-24,1,3,15,0,6,0,3,0.5,0.4848,0.94,0.4179,118,172,290,290,2,Sore
10646,2012-03-24,1,3,16,0,6,0,3,0.5,0.4848,0.94,0.2985,49,128,177,177,2,Sore
10647,2012-03-24,1,3,17,0,6,0,3,0.5,0.4848,0.88,0.2239,47,68,115,115,2,Sore
10648,2012-03-24,1,3,18,0,6,0,3,0.46,0.4545,0.94,0.2239,27,110,137,137,2,Sore
10649,2012-03-24,1,3,19,0,6,0,3,0.46,0.4545,0.94,0.1343,28,105,133,133,2,Malam
10650,2012-03-24,1,3,20,0,6,0,3,0.44,0.4394,1.0,0.194,31,80,111,111,2,Malam
10651,2012-03-24,1,3,21,0,6,0,3,0.44,0.4394,1.0,0.194,16,88,104,104,2,Malam
10652,2012-03-24,1,3,22,0,6,0,3,0.44,0.4394,1.0,0.2537,12,71,83,83,2,Malam
10653,2012-03-24,1,3,23,0,6,0,2,0.44,0.4394,0.94,0.2836,17,88,105,105,2,Malam
10654,2012-03-25,1,3,0,0,0,0,2,0.44,0.4394,0.94,0.2836,18,62,80,80,2,
10655,2012-03-25,1,3,1,0,0,0,2,0.42,0.4242,1.0,0.2537,24,65,89,89,2,Pagi
10656,2012-03-25,1,3,2,0,0,0,3,0.42,0.4242,1.0,0.2985,6,29,35,35,2,Pagi
10657,2012-03-25,1,3,3,0,0,0,3,0.42,0.4242,0.94,0.2985,8,10,18,18,2,Pagi
10658,2012-03-25,1,3,4,0,0,0,2,0.42,0.4242,0.94,0.3284,1,7,8,8,2,Pagi
10659,2012-03-25,1,3,5,0,0,0,2,0.4,0.4091,1.0,0.2537,0,6,6,6,2,Pagi
10660,2012-03-25,1,3,6,0,0,0,2,0.4,0.4091,1.0,0.2537,5,13,18,18,2,Pagi
10661,2012-03-25,1,3,7,0,0,0,2,0.4,0.4091,0.94,0.3284,14,25,39,39,2,Siang
10662,2012-03-25,1,3,8,0,0,0,2,0.4,0.4091,0.94,0.3284,21,68,89,89,2,Siang
10663,2012-03-25,1,3,9,0,0,0,2,0.4,0.4091,0.94,0.2537,26,92,118,118,2,Siang
10664,2012-03-25,1,3,10,0,0,0,2,0.4,0.4091,0.87,0.3284,78,172,250,250,2,Siang
10665,2012-03-25,1,3,11,0,0,0,2,0.4,0.4091,0.94,0.2537,106,217,323,323,2,Siang
10666,2012-03-25,1,3,12,0,0,0,2,0.4,0.4091,0.94,0.2239,122,238,360,360,2,Siang
10667,2012-03-25,1,3,13,0,0,0,2,0.42,0.4242,0.88,0.1642,110,257,367,367,2,Sore
10668,2012-03-25,1,3,14,0,0,0,2,0.44,0.4394,0.88,0.1642,123,291,414,414,2,Sore
10669,2012-03-25,1,3,15,0,0,0,2,0.44,0.4394,0.88,0.194,139,282,421,421,2,Sore
10670,2012-03-25,1,3,16,0,0,0,1,0.48,0.4697,0.77,0.0,153,339,492,492,2,Sore
10671,2012-03-25,1,3,17,0,0,0,1,0.5,0.4848,0.72,0.0896,146,273,419,419,2,Sore
10672,2012-03-25,1,3,18,0,0,0,1,0.5,0.4848,0.72,0.0896,202,289,491,491,2,Sore
10673,2012-03-25,1,3,19,0,0,0,1,0.5,0.4848,0.72,0.2537,114,261,375,375,2,Malam
10674,2012-03-25,1,3,20,0,0,0,1,0.48,0.4697,0.77,0.2239,63,196,259,259,2,Malam
10675,2012-03-25,1,3,21,0,0,0,1,0.48,0.4697,0.77,0.1642,25,124,149,149,2,Malam
10676,2012-03-25,1,3,22,0,0,0,1,0.46,0.4545,0.82,0.1343,19,92,111,111,2,Malam
10677,2012-03-25,1,3,23,0,0,0,1,0.48,0.4697,0.82,0.1343,9,56,65,65,2,Malam
10678,2012-03-26,1,3,0,0,1,1,2,0.48,0.4697,0.82,0.1642,10,23,33,33,2,
10679,2012-03-26,1,3,1,0,1,1,1,0.48,0.4697,0.82,0.2537,18,10,28,28,2,Pagi
10680,2012-03-26,1,3,2,0,1,1,1,0.46,0.4545,0.88,0.2239,14,6,20,20,2,Pagi
10681,2012-03-26,1,3,3,0,1,1,1,0.46,0.4545,0.82,0.194,0,1,1,1,2,Pagi
10682,2012-03-26,1,3,4,0,1,1,1,0.44,0.4394,0.82,0.1642,0,4,4,4,2,Pagi
10683,2012-03-26,1,3,5,0,1,1,1,0.44,0.4394,0.77,0.1642,0,36,36,36,2,Pagi
10684,2012-03-26,1,3,6,0,1,1,1,0.42,0.4242,0.82,0.194,7,110,117,117,2,Pagi
10685,2012-03-26,1,3,7,0,1,1,1,0.44,0.4394,0.72,0.194,15,355,370,370,2,Siang
10686,2012-03-26,1,3,8,0,1,1,1,0.44,0.4394,0.62,0.2239,32,625,657,657,2,Siang
10687,2012-03-26,1,3,9,0,1,1,1,0.46,0.4545,0.47,0.2836,37,245,282,282,2,Siang
10688,2012-03-26,1,3,10,0,1,1,1,0.5,0.4848,0.36,0.5821,55,98,153,153,2,Siang
10689,2012-03-26,1,3,11,0,1,1,1,0.48,0.4697,0.31,0.5821,47,131,178,178,2,Siang
10690,2012-03-26,1,3,12,0,1,1,1,0.48,0.4697,0.33,0.5224,63,216,279,279,2,Siang
10691,2012-03-26,1,3,13,0,1,1,1,0.48,0.4697,0.29,0.6866,79,222,301,301,2,Sore
10692,2012-03-26,1,3,14,0,1,1,1,0.48,0.4697,0.33,0.4478,58,159,217,217,2,Sore
10693,2012-03-26,1,3,15,0,1,1,1,0.48,0.4697,0.29,0.6119,66,157,223,223,2,Sore
10694,2012-03-26,1,3,16,0,1,1,1,0.48,0.4697,0.25,0.6418,60,245,305,305,2,Sore
10695,2012-03-26,1,3,17,0,1,1,1,0.46,0.4545,0.24,0.4478,65,599,664,664,2,Sore
10696,2012-03-26,1,3,18,0,1,1,1,0.44,0.4394,0.26,0.4478,90,594,684,684,2,Sore
10697,2012-03-26,1,3,19,0,1,1,1,0.42,0.4242,0.24,0.3582,41,417,458,458,2,Malam
10698,2012-03-26,1,3,20,0,1,1,1,0.4,0.4091,0.26,0.5224,12,209,221,221,2,Malam
10699,2012-03-26,1,3,21,0,1,1,1,0.38,0.3939,0.25,0.4925,11,175,186,186,2,Malam
10700,2012-03-26,1,3,22,0,1,1,1,0.36,0.3333,0.25,0.3582,13,80,93,93,2,Malam
10701,2012-03-26,1,3,23,0,1,1,1,0.34,0.2879,0.25,0.5224,2,46,48,48,2,Malam
10702,2012-03-27,1,3,0,0,2,1,1,0.32,0.2879,0.26,0.5224,1,9,10,10,2,
10703,2012-03-27,1,3,1,0,2,1,1,0.3,0.2727,0.26,0.4627,1,4,5,5,2,Pagi
10704,2012-03-27,1,3,2,0,2,1,1,0.26,0.2273,0.3,0.2985,1,6,7,7,2,Pagi
10705,2012-03-27,1,3,3,0,2,1,1,0.26,0.2273,0.3,0.3284,0,4,4,4,2,Pagi
10706,2012-03-27,1,3,4,0,2,1,1,0.24,0.2121,0.32,0.3582,0,3,3,3,2,Pagi
10707,2012-03-27,1,3,5,0,2,1,1,0.22,0.2121,0.37,0.2836,1,16,17,17,2,Pagi
10708,2012-03-27,1,3,6,0,2,1,1,0.22,0.2273,0.37,0.194,5,96,101,101,2,Pagi
10709,2012-03-27,1,3,7,0,2,1,1,0.22,0.2273,0.37,0.194,9,277,286,286,2,Siang
10710,2012-03-27,1,3,8,0,2,1,1,0.22,0.2121,0.37,0.2985,14,567,581,581,2,Siang
10711,2012-03-27,1,3,9,0,2,1,1,0.24,0.2273,0.38,0.194,8,259,267,267,2,Siang
10712,2012-03-27,1,3,10,0,2,1,1,0.26,0.2576,0.35,0.2239,20,118,138,138,2,Siang
10713,2012-03-27,1,3,11,0,2,1,1,0.3,0.303,0.31,0.1642,34,141,175,175,2,Siang
10714,2012-03-27,1,3,12,0,2,1,1,0.32,0.3182,0.31,0.1642,34,186,220,220,2,Siang
10715,2012-03-27,1,3,13,0,2,1,1,0.36,0.3485,0.27,0.0,46,165,211,211,2,Sore
10716,2012-03-27,1,3,14,0,2,1,1,0.4,0.4091,0.24,0.1343,37,147,184,184,2,Sore
10717,2012-03-27,1,3,15,0,2,1,1,0.42,0.4242,0.2,0.0,42,158,200,200,2,Sore
10718,2012-03-27,1,3,16,0,2,1,1,0.42,0.4242,0.2,0.0,38,267,305,305,2,Sore
10719,2012-03-27,1,3,17,0,2,1,1,0.44,0.4394,0.16,0.0,72,542,614,614,2,Sore
10720,2012-03-27,1,3,18,0,2,1,1,0.42,0.4242,0.17,0.0896,67,577,644,644,2,Sore
10721,2012-03-27,1,3,19,0,2,1,1,0.42,0.4242,0.17,0.0,40,377,417,417,2,Malam
10722,2012-03-27,1,3,20,0,2,1,1,0.42,0.4242,0.17,0.0896,28,266,294,294,2,Malam
10723,2012-03-27,1,3,21,0,2,1,1,0.36,0.3485,0.37,0.1642,21,200,221,221,2,Malam
10724,2012-03-27,1,3,22,0,2,1,1,0.36,0.3485,0.37,0.1343,7,127,134,134,2,Malam
10725,2012-03-27,1,3,23,0,2,1,1,0.36,0.3485,0.37,0.194,5,59,64,64,2,Malam
10726,2012-03-28,1,3,0,0,3,1,1,0.36,0.3333,0.4,0.2836,1,29,30,30,2,
10727,2012-03-28,1,3,1,0,3,1,1,0.36,0.3333,0.46,0.2985,0,8,8,8,2,Pagi
10728,2012-03-28,1,3,2,0,3,1,1,0.34,0.303,0.49,0.2985,0,3,3,3,2,Pagi
10729,2012-03-28,1,3,3,0,3,1,1,0.34,0.303,0.42,0.3284,1,4,5,5,2,Pagi
10730,2012-03-28,1,3,4,0,3,1,1,0.36,0.3333,0.43,0.2985,1,0,1,1,2,Pagi
10731,2012-03-28,1,3,5,0,3,1,1,0.36,0.3333,0.43,0.2985,2,38,40,40,2,Pagi
10732,2012-03-28,1,3,6,0,3,1,1,0.36,0.3333,0.46,0.3582,4,111,115,115,2,Pagi
10733,2012-03-28,1,3,7,0,3,1,1,0.36,0.3333,0.46,0.3284,10,348,358,358,2,Siang
10734,2012-03-28,1,3,8,0,3,1,1,0.38,0.3939,0.46,0.3582,19,639,658,658,2,Siang
10735,2012-03-28,1,3,9,0,3,1,1,0.4,0.4091,0.43,0.4478,16,298,314,314,2,Siang
10736,2012-03-28,1,3,10,0,3,1,1,0.46,0.4545,0.41,0.4179,33,140,173,173,2,Siang
10737,2012-03-28,1,3,11,0,3,1,1,0.5,0.4848,0.42,0.3881,54,168,222,222,2,Siang
10738,2012-03-28,1,3,12,0,3,1,2,0.54,0.5152,0.39,0.3582,50,218,268,268,2,Siang
10739,2012-03-28,1,3,13,0,3,1,1,0.56,0.5303,0.43,0.3284,60,213,273,273,2,Sore
10740,2012-03-28,1,3,14,0,3,1,1,0.62,0.6212,0.38,0.3582,52,169,221,221,2,Sore
10741,2012-03-28,1,3,15,0,3,1,2,0.62,0.6212,0.41,0.2985,47,152,199,199,2,Sore
10742,2012-03-28,1,3,16,0,3,1,3,0.62,0.6212,0.43,0.0896,51,170,221,221,2,Sore
10743,2012-03-28,1,3,17,0,3,1,1,0.6,0.6061,0.6,0.2239,72,532,604,604,2,Sore
10744,2012-03-28,1,3,18,0,3,1,1,0.6,0.6061,0.6,0.2239,61,580,641,641,2,Sore
10745,2012-03-28,1,3,19,0,3,1,1,0.6,0.6212,0.56,0.194,41,415,456,456,2,Malam
10746,2012-03-28,1,3,20,0,3,1,1,0.6,0.6212,0.56,0.2985,38,324,362,362,2,Malam
10747,2012-03-28,1,3,21,0,3,1,1,0.58,0.5455,0.6,0.2537,28,233,261,261,2,Malam
10748,2012-03-28,1,3,22,0,3,1,1,0.56,0.5303,0.64,0.1343,21,151,172,172,2,Malam
10749,2012-03-28,1,3,23,0,3,1,1,0.54,0.5152,0.68,0.1343,12,81,93,93,2,Malam
10750,2012-03-29,1,3,0,0,4,1,1,0.54,0.5152,0.68,0.194,10,38,48,48,2,
10751,2012-03-29,1,3,1,0,4,1,1,0.56,0.5303,0.6,0.1343,15,18,33,33,2,Pagi
10752,2012-03-29,1,3,2,0,4,1,1,0.6,0.6061,0.28,0.2985,0,6,6,6,2,Pagi
10753,2012-03-29,1,3,3,0,4,1,1,0.58,0.5455,0.28,0.2537,1,4,5,5,2,Pagi
10754,2012-03-29,1,3,4,0,4,1,1,0.52,0.5,0.36,0.2537,1,8,9,9,2,Pagi
10755,2012-03-29,1,3,5,0,4,1,1,0.5,0.4848,0.45,0.2239,2,30,32,32,2,Pagi
10756,2012-03-29,1,3,6,0,4,1,1,0.46,0.4545,0.59,0.2537,3,114,117,117,2,Pagi
10757,2012-03-29,1,3,7,0,4,1,1,0.46,0.4545,0.51,0.3582,14,353,367,367,2,Siang
10758,2012-03-29,1,3,8,0,4,1,1,0.46,0.4545,0.47,0.4179,26,628,654,654,2,Siang
10759,2012-03-29,1,3,9,0,4,1,1,0.48,0.4697,0.48,0.4179,22,299,321,321,2,Siang
10760,2012-03-29,1,3,10,0,4,1,1,0.46,0.4545,0.47,0.4478,42,124,166,166,2,Siang
10761,2012-03-29,1,3,11,0,4,1,1,0.5,0.4848,0.45,0.4179,54,166,220,220,2,Siang
10762,2012-03-29,1,3,12,0,4,1,1,0.5,0.4848,0.42,0.4925,64,228,292,292,2,Siang
10763,2012-03-29,1,3,13,0,4,1,1,0.46,0.4545,0.44,0.3284,50,223,273,273,2,Sore
10764,2012-03-29,1,3,14,0,4,1,1,0.5,0.4848,0.42,0.3582,63,175,238,238,2,Sore
10765,2012-03-29,1,3,15,0,4,1,1,0.52,0.5,0.39,0.3582,109,198,307,307,2,Sore
10766,2012-03-29,1,3,16,0,4,1,1,0.52,0.5,0.36,0.3284,67,321,388,388,2,Sore
10767,2012-03-29,1,3,17,0,4,1,1,0.52,0.5,0.38,0.3881,83,620,703,703,2,Sore
10768,2012-03-29,1,3,18,0,4,1,1,0.5,0.4848,0.39,0.2985,83,598,681,681,2,Sore
10769,2012-03-29,1,3,19,0,4,1,1,0.48,0.4697,0.39,0.2836,47,421,468,468,2,Malam
10770,2012-03-29,1,3,20,0,4,1,1,0.46,0.4545,0.38,0.2985,34,301,335,335,2,Malam
10771,2012-03-29,1,3,21,0,4,1,1,0.44,0.4394,0.44,0.2836,10,214,224,224,2,Malam
10772,2012-03-29,1,3,22,0,4,1,1,0.42,0.4242,0.44,0.2836,17,135,152,152,2,Malam
10773,2012-03-29,1,3,23,0,4,1,1,0.42,0.4242,0.47,0.2985,17,77,94,94,2,Malam
10774,2012-03-30,1,3,0,0,5,1,1,0.4,0.4091,0.47,0.2985,10,49,59,59,2,
10775,2012-03-30,1,3,1,0,5,1,1,0.38,0.3939,0.5,0.2836,6,21,27,27,2,Pagi
10776,2012-03-30,1,3,2,0,5,1,1,0.36,0.3333,0.53,0.2985,1,6,7,7,2,Pagi
10777,2012-03-30,1,3,3,0,5,1,1,0.34,0.3333,0.61,0.1343,0,7,7,7,2,Pagi
10778,2012-03-30,1,3,4,0,5,1,1,0.34,0.3485,0.53,0.0896,1,1,2,2,2,Pagi
10779,2012-03-30,1,3,5,0,5,1,1,0.32,0.3333,0.61,0.0896,0,26,26,26,2,Pagi
10780,2012-03-30,1,3,6,0,5,1,1,0.32,0.3333,0.57,0.1343,5,81,86,86,2,Pagi
10781,2012-03-30,1,3,7,0,5,1,1,0.32,0.3182,0.57,0.1642,9,280,289,289,2,Siang
10782,2012-03-30,1,3,8,0,5,1,1,0.32,0.3182,0.66,0.1642,38,555,593,593,2,Siang
10783,2012-03-30,1,3,9,0,5,1,1,0.34,0.3333,0.57,0.1642,29,292,321,321,2,Siang
10784,2012-03-30,1,3,10,0,5,1,2,0.36,0.3636,0.57,0.1045,50,137,187,187,2,Siang
10785,2012-03-30,1,3,11,0,5,1,2,0.36,0.3788,0.53,0.0,48,153,201,201,2,Siang
10786,2012-03-30,1,3,12,0,5,1,2,0.38,0.3939,0.54,0.0,62,208,270,270,2,Siang
10787,2012-03-30,1,3,13,0,5,1,3,0.4,0.4091,0.5,0.0,44,198,242,242,2,Sore
10788,2012-03-30,1,3,14,0,5,1,3,0.4,0.4091,0.54,0.0,56,173,229,229,2,Sore
10789,2012-03-30,1,3,15,0,5,1,3,0.42,0.4242,0.54,0.0,73,207,280,280,2,Sore
10790,2012-03-30,1,3,16,0,5,1,3,0.4,0.4091,0.62,0.2836,75,292,367,367,2,Sore
10791,2012-03-30,1,3,17,0,5,1,2,0.4,0.4091,0.62,0.2239,93,513,606,606,2,Sore
10792,2012-03-30,1,3,18,0,5,1,1,0.42,0.4242,0.54,0.194,68,492,560,560,2,Sore
10793,2012-03-30,1,3,19,0,5,1,1,0.4,0.4091,0.62,0.2239,42,353,395,395,2,Malam
10794,2012-03-30,1,3,20,0,5,1,1,0.4,0.4091,0.62,0.1642,17,192,209,209,2,Malam
10795,2012-03-30,1,3,21,0,5,1,1,0.38,0.3939,0.66,0.1343,30,190,220,220,2,Malam
10796,2012-03-30,1,3,22,0,5,1,1,0.36,0.3485,0.71,0.1642,23,130,153,153,2,Malam
10797,2012-03-30,1,3,23,0,5,1,1,0.36,0.3788,0.71,0.0,16,107,123,123,2,Malam
10798,2012-03-31,1,3,0,0,6,0,1,0.38,0.3939,0.82,0.194,12,80,92,92,2,
10799,2012-03-31,1,3,1,0,6,0,2,0.4,0.4091,0.76,0.194,17,65,82,82,2,Pagi
10800,2012-03-31,1,3,2,0,6,0,2,0.42,0.4242,0.77,0.2537,14,55,69,69,2,Pagi
10801,2012-03-31,1,3,3,0,6,0,1,0.4,0.4091,0.82,0.2537,10,21,31,31,2,Pagi
10802,2012-03-31,1,3,4,0,6,0,1,0.42,0.4242,0.77,0.4179,4,4,8,8,2,Pagi
10803,2012-03-31,1,3,5,0,6,0,1,0.4,0.4091,0.82,0.2239,0,5,5,5,2,Pagi
10804,2012-03-31,1,3,6,0,6,0,2,0.36,0.3485,0.87,0.1642,7,16,23,23,2,Pagi
10805,2012-03-31,1,3,7,0,6,0,2,0.36,0.3485,0.87,0.1642,5,39,44,44,2,Siang
10806,2012-03-31,1,3,8,0,6,0,2,0.36,0.3485,0.87,0.194,19,126,145,145,2,Siang
10807,2012-03-31,1,3,9,0,6,0,2,0.4,0.4091,0.76,0.194,62,161,223,223,2,Siang
10808,2012-03-31,1,3,10,0,6,0,2,0.4,0.4091,0.76,0.1343,108,205,313,313,2,Siang
10809,2012-03-31,1,3,11,0,6,0,1,0.46,0.4545,0.72,0.1343,184,279,463,463,2,Siang
10810,2012-03-31,1,3,12,0,6,0,1,0.48,0.4697,0.67,0.0,263,358,621,621,2,Siang
10811,2012-03-31,1,3,13,0,6,0,1,0.54,0.5152,0.6,0.1343,265,373,638,638,2,Sore
10812,2012-03-31,1,3,14,0,6,0,2,0.5,0.4848,0.63,0.2537,240,311,551,551,2,Sore
10813,2012-03-31,1,3,15,0,6,0,2,0.52,0.5,0.59,0.2836,275,330,605,605,2,Sore
10814,2012-03-31,1,3,16,0,6,0,2,0.5,0.4848,0.63,0.2985,243,292,535,535,2,Sore
10815,2012-03-31,1,3,17,0,6,0,1,0.48,0.4697,0.67,0.4179,238,305,543,543,2,Sore
10816,2012-03-31,1,3,18,0,6,0,2,0.44,0.4394,0.72,0.4627,102,239,341,341,2,Sore
10817,2012-03-31,1,3,19,0,6,0,1,0.42,0.4242,0.71,0.4478,93,191,284,284,2,Malam
10818,2012-03-31,1,3,20,0,6,0,2,0.4,0.4091,0.71,0.3284,52,156,208,208,2,Malam
10819,2012-03-31,1,3,21,0,6,0,2,0.4,0.4091,0.71,0.3284,36,107,143,143,2,Malam
10820,2012-03-31,1,3,22,0,6,0,2,0.38,0.3939,0.71,0.2537,40,116,156,156,2,Malam
10821,2012-03-31,1,3,23,0,6,0,2,0.36,0.3333,0.76,0.2836,12,100,112,112,2,Malam
10822,2012-04-01,1,4,0,0,0,0,2,0.36,0.3333,0.76,0.2537,8,59,67,67,2,
10823,2012-04-01,1,4,1,0,0,0,2,0.36,0.3485,0.76,0.1642,13,49,62,62,2,Pagi
10824,2012-04-01,1,4,2,0,0,0,2,0.36,0.3485,0.76,0.1642,20,61,81,81,2,Pagi
10825,2012-04-01,1,4,3,0,0,0,2,0.34,0.3333,0.81,0.1343,4,21,25,25,2,Pagi
10826,2012-04-01,1,4,4,0,0,0,2,0.34,0.3485,0.81,0.0896,3,9,12,12,2,Pagi
10827,2012-04-01,1,4,5,0,0,0,2,0.34,0.3485,0.81,0.0896,8,10,18,18,2,Pagi
10828,2012-04-01,1,4,6,0,0,0,2,0.36,0.3485,0.76,0.1343,9,88,97,97,2,Pagi
10829,2012-04-01,1,4,7,0,0,0,2,0.36,0.3485,0.71,0.1343,29,55,84,84,2,Siang
10830,2012-04-01,1,4,8,0,0,0,2,0.36,0.3636,0.76,0.0896,37,88,125,125,2,Siang
10831,2012-04-01,1,4,9,0,0,0,2,0.36,0.3485,0.81,0.1343,102,173,275,275,2,Siang
10832,2012-04-01,1,4,10,0,0,0,2,0.4,0.4091,0.71,0.1045,132,228,360,360,2,Siang
10833,2012-04-01,1,4,11,0,0,0,2,0.4,0.4091,0.71,0.194,180,271,451,451,2,Siang
10834,2012-04-01,1,4,12,0,0,0,2,0.42,0.4242,0.67,0.2239,187,258,445,445,2,Siang
10835,2012-04-01,1,4,13,0,0,0,2,0.44,0.4394,0.62,0.194,190,274,464,464,2,Sore
10836,2012-04-01,1,4,14,0,0,0,2,0.48,0.4697,0.55,0.2239,283,278,561,561,2,Sore
10837,2012-04-01,1,4,15,0,0,0,1,0.5,0.4848,0.55,0.2537,295,278,573,573,2,Sore
10838,2012-04-01,1,4,16,0,0,0,1,0.52,0.5,0.52,0.2537,236,275,511,511,2,Sore
10839,2012-04-01,1,4,17,0,0,0,1,0.52,0.5,0.55,0.2836,232,323,555,555,2,Sore
10840,2012-04-01,1,4,18,0,0,0,1,0.52,0.5,0.52,0.2985,153,279,432,432,2,Sore
10841,2012-04-01,1,4,19,0,0,0,1,0.52,0.5,0.55,0.2239,110,236,346,346,2,Malam
10842,2012-04-01,1,4,20,0,0,0,2,0.5,0.4848,0.59,0.2239,66,166,232,232,2,Malam
10843,2012-04-01,1,4,21,0,0,0,2,0.5,0.4848,0.59,0.1642,33,101,134,134,2,Malam
10844,2012-04-01,1,4,22,0,0,0,3,0.5,0.4848,0.63,0.1045,7,61,68,68,2,Malam
10845,2012-04-01,1,4,23,0,0,0,3,0.46,0.4545,0.72,0.0,10,53,63,63,2,Malam
10846,2012-04-02,1,4,0,0,1,1,3,0.44,0.4394,0.82,0.1045,6,11,17,17,2,
10847,2012-04-02,1,4,1,0,1,1,3,0.42,0.4242,0.88,0.0896,0,5,5,5,2,Pagi
10848,2012-04-02,1,4,2,0,1,1,3,0.44,0.4394,0.94,0.1343,2,3,5,5,2,Pagi
10849,2012-04-02,1,4,4,0,1,1,1,0.4,0.4091,0.76,0.4925,2,2,4,4,2,Pagi
10850,2012-04-02,1,4,5,0,1,1,1,0.4,0.4091,0.76,0.4925,2,22,24,24,2,Pagi
10851,2012-04-02,1,4,6,0,1,1,1,0.36,0.3182,0.71,0.4627,6,104,110,110,2,Pagi
10852,2012-04-02,1,4,7,0,1,1,1,0.34,0.303,0.66,0.3881,12,294,306,306,2,Siang
10853,2012-04-02,1,4,8,0,1,1,1,0.36,0.3333,0.57,0.3284,36,553,589,589,2,Siang
10854,2012-04-02,1,4,9,0,1,1,1,0.38,0.3939,0.54,0.3582,52,265,317,317,2,Siang
10855,2012-04-02,1,4,10,0,1,1,1,0.4,0.4091,0.5,0.5224,85,119,204,204,2,Siang
10856,2012-04-02,1,4,11,0,1,1,1,0.42,0.4242,0.47,0.4478,81,128,209,209,2,Siang
10857,2012-04-02,1,4,12,0,1,1,1,0.44,0.4394,0.44,0.4478,100,181,281,281,2,Siang
10858,2012-04-02,1,4,13,0,1,1,1,0.46,0.4545,0.36,0.2985,97,184,281,281,2,Sore
10859,2012-04-02,1,4,14,0,1,1,1,0.46,0.4545,0.31,0.4179,127,141,268,268,2,Sore
10860,2012-04-02,1,4,15,0,1,1,1,0.48,0.4697,0.33,0.4179,132,192,324,324,2,Sore
10861,2012-04-02,1,4,16,0,1,1,1,0.5,0.4848,0.34,0.3284,104,291,395,395,2,Sore
10862,2012-04-02,1,4,17,0,1,1,1,0.5,0.4848,0.29,0.2836,128,601,729,729,2,Sore
10863,2012-04-02,1,4,18,0,1,1,1,0.5,0.4848,0.27,0.2537,75,543,618,618,2,Sore
10864,2012-04-02,1,4,19,0,1,1,1,0.5,0.4848,0.27,0.2537,66,428,494,494,2,Malam
10865,2012-04-02,1,4,20,0,1,1,1,0.46,0.4545,0.31,0.1642,48,281,329,329,2,Malam
10866,2012-04-02,1,4,21,0,1,1,1,0.46,0.4545,0.28,0.1343,24,214,238,238,2,Malam
10867,2012-04-02,1,4,22,0,1,1,1,0.42,0.4242,0.44,0.194,17,106,123,123,2,Malam
10868,2012-04-02,1,4,23,0,1,1,1,0.44,0.4394,0.35,0.1642,6,60,66,66,2,Malam
10869,2012-04-03,1,4,0,0,2,1,1,0.4,0.4091,0.43,0.1343,1,32,33,33,2,
10870,2012-04-03,1,4,1,0,2,1,1,0.38,0.3939,0.46,0.2239,0,11,11,11,2,Pagi
10871,2012-04-03,1,4,2,0,2,1,1,0.36,0.3485,0.53,0.1642,0,5,5,5,2,Pagi
10872,2012-04-03,1,4,3,0,2,1,1,0.38,0.3939,0.46,0.0,0,3,3,3,2,Pagi
10873,2012-04-03,1,4,4,0,2,1,1,0.32,0.3333,0.66,0.0896,0,1,1,1,2,Pagi
10874,2012-04-03,1,4,5,0,2,1,1,0.32,0.3333,0.66,0.0896,2,25,27,27,2,Pagi
10875,2012-04-03,1,4,6,0,2,1,1,0.3,0.3182,0.61,0.0896,2,98,100,100,2,Pagi
10876,2012-04-03,1,4,7,0,2,1,1,0.32,0.3333,0.66,0.0896,14,327,341,341,2,Siang
10877,2012-04-03,1,4,8,0,2,1,1,0.34,0.3636,0.57,0.0,27,577,604,604,2,Siang
10878,2012-04-03,1,4,9,0,2,1,1,0.42,0.4242,0.38,0.0896,54,354,408,408,2,Siang
10879,2012-04-03,1,4,10,0,2,1,1,0.44,0.4394,0.33,0.0,77,142,219,219,2,Siang
10880,2012-04-03,1,4,11,0,2,1,1,0.48,0.4697,0.23,0.0,91,167,258,258,2,Siang
10881,2012-04-03,1,4,12,0,2,1,1,0.52,0.5,0.25,0.0,101,230,331,331,2,Siang
10882,2012-04-03,1,4,13,0,2,1,1,0.56,0.5303,0.19,0.2537,120,225,345,345,2,Sore
10883,2012-04-03,1,4,14,0,2,1,1,0.56,0.5303,0.21,0.2239,120,191,311,311,2,Sore
10884,2012-04-03,1,4,15,0,2,1,1,0.6,0.5909,0.2,0.194,109,207,316,316,2,Sore
10885,2012-04-03,1,4,16,0,2,1,1,0.62,0.6061,0.21,0.1642,145,340,485,485,2,Sore
10886,2012-04-03,1,4,17,0,2,1,1,0.62,0.6061,0.17,0.194,123,634,757,757,2,Sore
10887,2012-04-03,1,4,18,0,2,1,1,0.6,0.6061,0.26,0.1642,139,661,800,800,2,Sore
10888,2012-04-03,1,4,19,0,2,1,1,0.56,0.5303,0.26,0.1045,98,460,558,558,2,Malam
10889,2012-04-03,1,4,20,0,2,1,1,0.56,0.5303,0.24,0.1343,54,325,379,379,2,Malam
10890,2012-04-03,1,4,21,0,2,1,1,0.54,0.5152,0.45,0.0,33,210,243,243,2,Malam
10891,2012-04-03,1,4,22,0,2,1,1,0.5,0.4848,0.51,0.0,25,133,158,158,2,Malam
10892,2012-04-03,1,4,23,0,2,1,1,0.5,0.4848,0.59,0.0,13,66,79,79,2,Malam
10893,2012-04-04,1,4,0,0,3,1,1,0.48,0.4697,0.48,0.0,18,23,41,41,2,
10894,2012-04-04,1,4,1,0,3,1,1,0.46,0.4545,0.59,0.0,0,11,11,11,2,Pagi
10895,2012-04-04,1,4,2,0,3,1,1,0.46,0.4545,0.51,0.0,0,5,5,5,2,Pagi
10896,2012-04-04,1,4,3,0,3,1,1,0.44,0.4394,0.58,0.0896,0,3,3,3,2,Pagi
10897,2012-04-04,1,4,4,0,3,1,1,0.42,0.4242,0.67,0.0896,0,1,1,1,2,Pagi
10898,2012-04-04,1,4,5,0,3,1,1,0.42,0.4242,0.67,0.0896,0,27,27,27,2,Pagi
10899,2012-04-04,1,4,6,0,3,1,2,0.42,0.4242,0.58,0.0,6,120,126,126,2,Pagi
10900,2012-04-04,1,4,7,0,3,1,2,0.44,0.4394,0.62,0.0,12,354,366,366,2,Siang
10901,2012-04-04,1,4,8,0,3,1,2,0.44,0.4394,0.72,0.1045,31,653,684,684,2,Siang
10902,2012-04-04,1,4,9,0,3,1,2,0.48,0.4697,0.55,0.1343,47,316,363,363,2,Siang
10903,2012-04-04,1,4,10,0,3,1,2,0.54,0.5152,0.45,0.1343,68,99,167,167,2,Siang
10904,2012-04-04,1,4,11,0,3,1,2,0.6,0.6212,0.43,0.3582,61,152,213,213,2,Siang
10905,2012-04-04,1,4,12,0,3,1,2,0.6,0.6212,0.46,0.4179,73,210,283,283,2,Siang
10906,2012-04-04,1,4,13,0,3,1,2,0.6,0.6212,0.46,0.2537,70,181,251,251,2,Sore
10907,2012-04-04,1,4,14,0,3,1,2,0.62,0.6212,0.46,0.194,82,176,258,258,2,Sore
10908,2012-04-04,1,4,15,0,3,1,2,0.64,0.6212,0.44,0.2836,86,182,268,268,2,Sore
10909,2012-04-04,1,4,16,0,3,1,2,0.64,0.6212,0.44,0.2836,86,304,390,390,2,Sore
10910,2012-04-04,1,4,17,0,3,1,1,0.66,0.6212,0.41,0.2985,99,645,744,744,2,Sore
10911,2012-04-04,1,4,18,0,3,1,1,0.66,0.6212,0.41,0.2537,113,646,759,759,2,Sore
10912,2012-04-04,1,4,19,0,3,1,1,0.66,0.6212,0.39,0.2239,75,419,494,494,2,Malam
10913,2012-04-04,1,4,20,0,3,1,1,0.64,0.6212,0.27,0.2239,39,333,372,372,2,Malam
10914,2012-04-04,1,4,21,0,3,1,1,0.6,0.6061,0.23,0.3284,43,255,298,298,2,Malam
10915,2012-04-04,1,4,22,0,3,1,1,0.56,0.5303,0.22,0.1642,30,151,181,181,2,Malam
10916,2012-04-04,1,4,23,0,3,1,1,0.52,0.5,0.23,0.4179,19,112,131,131,2,Malam
10917,2012-04-05,1,4,0,0,4,1,1,0.52,0.5,0.23,0.4179,12,33,45,45,2,
10918,2012-04-05,1,4,1,0,4,1,1,0.48,0.4697,0.27,0.3284,4,9,13,13,2,Pagi
10919,2012-04-05,1,4,2,0,4,1,1,0.46,0.4545,0.33,0.4478,7,11,18,18,2,Pagi
10920,2012-04-05,1,4,3,0,4,1,1,0.42,0.4242,0.41,0.2985,0,5,5,5,2,Pagi
10921,2012-04-05,1,4,4,0,4,1,1,0.38,0.3939,0.43,0.2836,0,1,1,1,2,Pagi
10922,2012-04-05,1,4,5,0,4,1,1,0.38,0.3939,0.43,0.2836,1,28,29,29,2,Pagi
10923,2012-04-05,1,4,6,0,4,1,1,0.36,0.3333,0.46,0.3284,8,118,126,126,2,Pagi
10924,2012-04-05,1,4,7,0,4,1,1,0.34,0.3333,0.49,0.194,15,339,354,354,2,Siang
10925,2012-04-05,1,4,8,0,4,1,1,0.36,0.3485,0.46,0.2239,28,610,638,638,2,Siang
10926,2012-04-05,1,4,9,0,4,1,1,0.4,0.4091,0.37,0.2537,61,290,351,351,2,Siang
10927,2012-04-05,1,4,10,0,4,1,1,0.42,0.4242,0.35,0.2836,88,158,246,246,2,Siang
10928,2012-04-05,1,4,11,0,4,1,2,0.42,0.4242,0.38,0.2239,109,159,268,268,2,Siang
10929,2012-04-05,1,4,12,0,4,1,1,0.44,0.4394,0.33,0.0,66,210,276,276,2,Siang
10930,2012-04-05,1,4,13,0,4,1,1,0.46,0.4545,0.31,0.0,89,202,291,291,2,Sore
10931,2012-04-05,1,4,14,0,4,1,1,0.46,0.4545,0.33,0.1642,143,144,287,287,2,Sore
10932,2012-04-05,1,4,15,0,4,1,1,0.5,0.4848,0.31,0.1045,98,171,269,269,2,Sore
10933,2012-04-05,1,4,16,0,4,1,1,0.5,0.4848,0.31,0.194,84,318,402,402,2,Sore
10934,2012-04-05,1,4,17,0,4,1,1,0.5,0.4848,0.31,0.1642,145,677,822,822,2,Sore
10935,2012-04-05,1,4,18,0,4,1,1,0.5,0.4848,0.31,0.1045,80,618,698,698,2,Sore
10936,2012-04-05,1,4,19,0,4,1,1,0.48,0.4697,0.31,0.2537,64,423,487,487,2,Malam
10937,2012-04-05,1,4,20,0,4,1,1,0.44,0.4394,0.41,0.194,33,279,312,312,2,Malam
10938,2012-04-05,1,4,21,0,4,1,1,0.42,0.4242,0.47,0.194,25,209,234,234,2,Malam
10939,2012-04-05,1,4,22,0,4,1,1,0.4,0.4091,0.47,0.194,20,129,149,149,2,Malam
10940,2012-04-05,1,4,23,0,4,1,1,0.4,0.4091,0.5,0.1343,12,124,136,136,2,Malam
10941,2012-04-06,1,4,0,0,5,1,1,0.4,0.4091,0.43,0.0,12,49,61,61,2,
10942,2012-04-06,1,4,1,0,5,1,1,0.36,0.3485,0.62,0.1343,10,28,38,38,2,Pagi
10943,2012-04-06,1,4,2,0,5,1,1,0.36,0.3333,0.5,0.3881,6,5,11,11,2,Pagi
10944,2012-04-06,1,4,3,0,5,1,1,0.34,0.303,0.53,0.3284,3,5,8,8,2,Pagi
10945,2012-04-06,1,4,4,0,5,1,1,0.34,0.3182,0.49,0.2537,2,3,5,5,2,Pagi
10946,2012-04-06,1,4,5,0,5,1,1,0.32,0.303,0.53,0.3284,0,23,23,23,2,Pagi
10947,2012-04-06,1,4,6,0,5,1,1,0.3,0.2727,0.49,0.3881,0,80,80,80,2,Pagi
10948,2012-04-06,1,4,7,0,5,1,1,0.3,0.2879,0.49,0.2836,15,231,246,246,2,Siang
10949,2012-04-06,1,4,8,0,5,1,1,0.3,0.2727,0.49,0.3284,19,489,508,508,2,Siang
10950,2012-04-06,1,4,9,0,5,1,1,0.34,0.303,0.42,0.3284,58,318,376,376,2,Siang
10951,2012-04-06,1,4,10,0,5,1,1,0.36,0.3333,0.4,0.3284,81,157,238,238,2,Siang
10952,2012-04-06,1,4,11,0,5,1,1,0.4,0.4091,0.37,0.2985,112,179,291,291,2,Siang
10953,2012-04-06,1,4,12,0,5,1,1,0.42,0.4242,0.35,0.2985,113,224,337,337,2,Siang
10954,2012-04-06,1,4,13,0,5,1,1,0.44,0.4394,0.33,0.3284,173,238,411,411,2,Sore
10955,2012-04-06,1,4,14,0,5,1,1,0.48,0.4697,0.29,0.3881,240,250,490,490,2,Sore
10956,2012-04-06,1,4,15,0,5,1,1,0.5,0.4848,0.27,0.2836,218,319,537,537,2,Sore
10957,2012-04-06,1,4,16,0,5,1,1,0.5,0.4848,0.22,0.4179,184,352,536,536,2,Sore
10958,2012-04-06,1,4,17,0,5,1,1,0.52,0.5,0.23,0.4179,172,483,655,655,2,Sore
10959,2012-04-06,1,4,18,0,5,1,1,0.5,0.4848,0.22,0.4627,104,380,484,484,2,Sore
10960,2012-04-06,1,4,19,0,5,1,1,0.48,0.4697,0.23,0.2985,115,297,412,412,2,Malam
10961,2012-04-06,1,4,20,0,5,1,1,0.46,0.4545,0.24,0.2836,61,191,252,252,2,Malam
10962,2012-04-06,1,4,21,0,5,1,1,0.44,0.4394,0.26,0.1343,54,136,190,190,2,Malam
10963,2012-04-06,1,4,22,0,5,1,1,0.4,0.4091,0.35,0.2239,34,124,158,158,2,Malam
10964,2012-04-06,1,4,23,0,5,1,1,0.42,0.4242,0.3,0.2836,21,92,113,113,2,Malam
10965,2012-04-07,1,4,0,0,6,0,1,0.42,0.4242,0.26,0.2985,9,85,94,94,2,
10966,2012-04-07,1,4,1,0,6,0,1,0.4,0.4091,0.28,0.2537,9,60,69,69,2,Pagi
10967,2012-04-07,1,4,2,0,6,0,1,0.36,0.3333,0.29,0.3582,11,25,36,36,2,Pagi
10968,2012-04-07,1,4,3,0,6,0,1,0.36,0.3333,0.32,0.2537,7,21,28,28,2,Pagi
10969,2012-04-07,1,4,4,0,6,0,1,0.32,0.3182,0.36,0.1642,3,4,7,7,2,Pagi
10970,2012-04-07,1,4,5,0,6,0,1,0.32,0.3182,0.33,0.1642,0,2,2,2,2,Pagi
10971,2012-04-07,1,4,6,0,6,0,1,0.32,0.3182,0.36,0.194,1,18,19,19,2,Pagi
10972,2012-04-07,1,4,7,0,6,0,1,0.32,0.303,0.33,0.2836,14,40,54,54,2,Siang
10973,2012-04-07,1,4,8,0,6,0,1,0.34,0.3182,0.34,0.2537,29,94,123,123,2,Siang
10974,2012-04-07,1,4,9,0,6,0,1,0.4,0.4091,0.3,0.2537,103,173,276,276,2,Siang
10975,2012-04-07,1,4,10,0,6,0,1,0.42,0.4242,0.28,0.2537,187,176,363,363,2,Siang
10976,2012-04-07,1,4,11,0,6,0,1,0.44,0.4394,0.24,0.2985,251,244,495,495,2,Siang
10977,2012-04-07,1,4,12,0,6,0,1,0.46,0.4545,0.23,0.3881,320,270,590,590,2,Siang
10978,2012-04-07,1,4,13,0,6,0,1,0.5,0.4848,0.22,0.194,355,288,643,643,2,Sore
10979,2012-04-07,1,4,14,0,6,0,1,0.5,0.4848,0.22,0.2985,326,252,578,578,2,Sore
10980,2012-04-07,1,4,15,0,6,0,1,0.52,0.5,0.19,0.4179,321,305,626,626,2,Sore
10981,2012-04-07,1,4,16,0,6,0,1,0.54,0.5152,0.19,0.3881,354,261,615,615,2,Sore
10982,2012-04-07,1,4,17,0,6,0,1,0.54,0.5152,0.19,0.4179,299,268,567,567,2,Sore
10983,2012-04-07,1,4,18,0,6,0,1,0.54,0.5152,0.18,0.2985,227,290,517,517,2,Sore
10984,2012-04-07,1,4,19,0,6,0,1,0.54,0.5152,0.16,0.3284,170,243,413,413,2,Malam
10985,2012-04-07,1,4,20,0,6,0,1,0.5,0.4848,0.2,0.2239,73,135,208,208,2,Malam
10986,2012-04-07,1,4,21,0,6,0,1,0.5,0.4848,0.2,0.194,75,159,234,234,2,Malam
10987,2012-04-07,1,4,22,0,6,0,1,0.48,0.4697,0.2,0.194,76,106,182,182,2,Malam
10988,2012-04-07,1,4,23,0,6,0,1,0.46,0.4545,0.23,0.2239,32,86,118,118,2,Malam
10989,2012-04-08,1,4,0,0,0,0,1,0.44,0.4394,0.24,0.2239,21,64,85,85,2,
10990,2012-04-08,1,4,1,0,0,0,1,0.44,0.4394,0.24,0.2239,14,50,64,64,2,Pagi
10991,2012-04-08,1,4,2,0,0,0,1,0.44,0.4394,0.24,0.2239,7,25,32,32,2,Pagi
10992,2012-04-08,1,4,3,0,0,0,1,0.42,0.4242,0.26,0.1343,8,18,26,26,2,Pagi
10993,2012-04-08,1,4,4,0,0,0,1,0.4,0.4091,0.4,0.0,0,7,7,7,2,Pagi
10994,2012-04-08,1,4,5,0,0,0,1,0.38,0.3939,0.46,0.0,4,8,12,12,2,Pagi
10995,2012-04-08,1,4,6,0,0,0,1,0.36,0.3788,0.37,0.0,7,21,28,28,2,Pagi
10996,2012-04-08,1,4,7,0,0,0,1,0.38,0.3939,0.27,0.1642,12,25,37,37,2,Siang
10997,2012-04-08,1,4,8,0,0,0,1,0.4,0.4091,0.3,0.194,19,65,84,84,2,Siang
10998,2012-04-08,1,4,9,0,0,0,1,0.44,0.4394,0.26,0.2239,71,108,179,179,2,Siang
10999,2012-04-08,1,4,10,0,0,0,1,0.5,0.4848,0.25,0.2239,113,186,299,299,2,Siang
11000,2012-04-08,1,4,11,0,0,0,1,0.5,0.4848,0.25,0.2836,195,209,404,404,2,Siang
11001,2012-04-08,1,4,12,0,0,0,1,0.54,0.5152,0.24,0.2537,198,259,457,457,2,Siang
11002,2012-04-08,1,4,13,0,0,0,1,0.58,0.5455,0.23,0.1642,229,254,483,483,2,Sore
11003,2012-04-08,1,4,14,0,0,0,1,0.6,0.5909,0.18,0.4478,254,249,503,503,2,Sore
11004,2012-04-08,1,4,15,0,0,0,1,0.62,0.6061,0.17,0.3582,260,226,486,486,2,Sore
11005,2012-04-08,1,4,16,0,0,0,1,0.64,0.6061,0.19,0.3284,232,244,476,476,2,Sore
11006,2012-04-08,1,4,17,0,0,0,1,0.62,0.6061,0.22,0.2985,185,226,411,411,2,Sore
11007,2012-04-08,1,4,18,0,0,0,1,0.62,0.6061,0.25,0.3284,151,159,310,310,2,Sore
11008,2012-04-08,1,4,19,0,0,0,1,0.6,0.6061,0.23,0.3881,89,187,276,276,2,Malam
11009,2012-04-08,1,4,20,0,0,0,1,0.56,0.5303,0.28,0.4179,65,146,211,211,2,Malam
11010,2012-04-08,1,4,21,0,0,0,1,0.52,0.5,0.34,0.2239,53,77,130,130,2,Malam
11011,2012-04-08,1,4,22,0,0,0,1,0.5,0.4848,0.36,0.2239,33,85,118,118,2,Malam
11012,2012-04-08,1,4,23,0,0,0,1,0.5,0.4848,0.39,0.2537,10,41,51,51,2,Malam
11013,2012-04-09,1,4,0,0,1,1,1,0.48,0.4697,0.39,0.2836,8,29,37,37,2,
11014,2012-04-09,1,4,1,0,1,1,1,0.46,0.4545,0.41,0.1343,4,12,16,16,2,Pagi
11015,2012-04-09,1,4,2,0,1,1,1,0.46,0.4545,0.31,0.194,2,4,6,6,2,Pagi
11016,2012-04-09,1,4,3,0,1,1,1,0.44,0.4394,0.3,0.1642,0,3,3,3,2,Pagi
11017,2012-04-09,1,4,4,0,1,1,1,0.44,0.4394,0.24,0.194,2,3,5,5,2,Pagi
11018,2012-04-09,1,4,5,0,1,1,1,0.44,0.4394,0.24,0.194,2,30,32,32,2,Pagi
11019,2012-04-09,1,4,6,0,1,1,1,0.42,0.4242,0.26,0.2239,3,108,111,111,2,Pagi
11020,2012-04-09,1,4,7,0,1,1,1,0.42,0.4242,0.28,0.194,11,320,331,331,2,Siang
11021,2012-04-09,1,4,8,0,1,1,1,0.44,0.4394,0.3,0.194,22,595,617,617,2,Siang
11022,2012-04-09,1,4,9,0,1,1,1,0.46,0.4545,0.31,0.3582,50,236,286,286,2,Siang
11023,2012-04-09,1,4,10,0,1,1,1,0.5,0.4848,0.27,0.4925,65,113,178,178,2,Siang
11024,2012-04-09,1,4,11,0,1,1,1,0.52,0.5,0.27,0.4179,96,127,223,223,2,Siang
11025,2012-04-09,1,4,12,0,1,1,1,0.54,0.5152,0.28,0.7164,94,186,280,280,2,Siang
11026,2012-04-09,1,4,13,0,1,1,1,0.54,0.5152,0.28,0.5821,108,173,281,281,2,Sore
11027,2012-04-09,1,4,14,0,1,1,1,0.56,0.5303,0.28,0.5522,66,152,218,218,2,Sore
11028,2012-04-09,1,4,15,0,1,1,1,0.58,0.5455,0.28,0.5522,82,173,255,255,2,Sore
11029,2012-04-09,1,4,16,0,1,1,1,0.56,0.5303,0.3,0.4179,81,310,391,391,2,Sore
11030,2012-04-09,1,4,17,0,1,1,1,0.54,0.5152,0.32,0.4179,67,565,632,632,2,Sore
11031,2012-04-09,1,4,18,0,1,1,1,0.54,0.5152,0.34,0.2985,60,586,646,646,2,Sore
11032,2012-04-09,1,4,19,0,1,1,1,0.52,0.5,0.34,0.3582,35,386,421,421,2,Malam
11033,2012-04-09,1,4,20,0,1,1,1,0.5,0.4848,0.36,0.4478,21,255,276,276,2,Malam
11034,2012-04-09,1,4,21,0,1,1,3,0.48,0.4697,0.41,0.4179,14,151,165,165,2,Malam
11035,2012-04-09,1,4,22,0,1,1,2,0.46,0.4545,0.41,0.4925,6,102,108,108,2,Malam
11036,2012-04-09,1,4,23,0,1,1,1,0.44,0.4394,0.44,0.2985,6,61,67,67,2,Malam
11037,2012-04-10,1,4,0,0,2,1,2,0.44,0.4394,0.47,0.2836,3,23,26,26,2,
11038,2012-04-10,1,4,1,0,2,1,1,0.42,0.4242,0.5,0.2239,0,9,9,9,2,Pagi
11039,2012-04-10,1,4,2,0,2,1,1,0.36,0.3485,0.71,0.1343,0,2,2,2,2,Pagi
11040,2012-04-10,1,4,3,0,2,1,1,0.36,0.3485,0.71,0.1343,0,2,2,2,2,Pagi
11041,2012-04-10,1,4,4,0,2,1,1,0.34,0.3333,0.71,0.1343,0,2,2,2,2,Pagi
11042,2012-04-10,1,4,5,0,2,1,1,0.34,0.3333,0.71,0.1343,0,24,24,24,2,Pagi
11043,2012-04-10,1,4,6,0,2,1,1,0.34,0.3485,0.71,0.1045,3,100,103,103,2,Pagi
11044,2012-04-10,1,4,7,0,2,1,1,0.34,0.3485,0.71,0.1045,16,368,384,384,2,Siang
11045,2012-04-10,1,4,8,0,2,1,1,0.38,0.3939,0.62,0.1343,22,670,692,692,2,Siang
11046,2012-04-10,1,4,9,0,2,1,1,0.42,0.4242,0.67,0.194,16,303,319,319,2,Siang
11047,2012-04-10,1,4,10,0,2,1,1,0.46,0.4545,0.47,0.1642,49,132,181,181,2,Siang
11048,2012-04-10,1,4,11,0,2,1,1,0.5,0.4848,0.36,0.0,78,161,239,239,2,Siang
11049,2012-04-10,1,4,12,0,2,1,1,0.54,0.5152,0.22,0.2836,75,184,259,259,2,Siang
11050,2012-04-10,1,4,13,0,2,1,1,0.52,0.5,0.23,0.1642,81,202,283,283,2,Sore
11051,2012-04-10,1,4,14,0,2,1,1,0.54,0.5152,0.24,0.194,75,149,224,224,2,Sore
11052,2012-04-10,1,4,15,0,2,1,1,0.56,0.5303,0.21,0.2985,46,157,203,203,2,Sore
11053,2012-04-10,1,4,16,0,2,1,1,0.58,0.5455,0.21,0.2537,66,296,362,362,2,Sore
11054,2012-04-10,1,4,17,0,2,1,1,0.56,0.5303,0.21,0.5224,88,656,744,744,2,Sore
11055,2012-04-10,1,4,18,0,2,1,1,0.54,0.5152,0.22,0.4179,78,626,704,704,2,Sore
11056,2012-04-10,1,4,19,0,2,1,1,0.52,0.5,0.2,0.3582,51,428,479,479,2,Malam
11057,2012-04-10,1,4,20,0,2,1,1,0.46,0.4545,0.28,0.3881,34,248,282,282,2,Malam
11058,2012-04-10,1,4,21,0,2,1,1,0.44,0.4394,0.3,0.4478,15,191,206,206,2,Malam
11059,2012-04-10,1,4,22,0,2,1,1,0.4,0.4091,0.37,0.4925,9,118,127,127,2,Malam
11060,2012-04-10,1,4,23,0,2,1,1,0.36,0.3333,0.4,0.4179,14,48,62,62,2,Malam
11061,2012-04-11,1,4,0,0,3,1,1,0.34,0.303,0.36,0.4179,8,22,30,30,2,
11062,2012-04-11,1,4,1,0,3,1,1,0.34,0.3182,0.39,0.2836,3,9,12,12,2,Pagi
11063,2012-04-11,1,4,2,0,3,1,1,0.32,0.303,0.45,0.2836,0,2,2,2,2,Pagi
11064,2012-04-11,1,4,3,0,3,1,1,0.3,0.2879,0.49,0.2239,0,2,2,2,2,Pagi
11065,2012-04-11,1,4,5,0,3,1,1,0.28,0.2727,0.56,0.194,1,26,27,27,2,Pagi
11066,2012-04-11,1,4,6,0,3,1,1,0.28,0.2879,0.56,0.1045,3,103,106,106,2,Pagi
11067,2012-04-11,1,4,7,0,3,1,1,0.28,0.2879,0.52,0.1343,18,303,321,321,2,Siang
11068,2012-04-11,1,4,8,0,3,1,1,0.3,0.2879,0.49,0.2239,14,581,595,595,2,Siang
11069,2012-04-11,1,4,9,0,3,1,2,0.32,0.303,0.49,0.2985,20,282,302,302,2,Siang
11070,2012-04-11,1,4,10,0,3,1,2,0.34,0.303,0.49,0.3284,26,127,153,153,2,Siang
11071,2012-04-11,1,4,11,0,3,1,2,0.38,0.3939,0.43,0.3284,38,142,180,180,2,Siang
11072,2012-04-11,1,4,12,0,3,1,2,0.36,0.3333,0.46,0.3881,35,147,182,182,2,Siang
11073,2012-04-11,1,4,13,0,3,1,2,0.4,0.4091,0.4,0.3582,16,147,163,163,2,Sore
11074,2012-04-11,1,4,14,0,3,1,1,0.36,0.3485,0.57,0.194,34,101,135,135,2,Sore
11075,2012-04-11,1,4,15,0,3,1,3,0.38,0.3939,0.46,0.2239,50,152,202,202,2,Sore
11076,2012-04-11,1,4,16,0,3,1,1,0.44,0.4394,0.33,0.2985,51,256,307,307,2,Sore
11077,2012-04-11,1,4,17,0,3,1,1,0.42,0.4242,0.35,0.3881,52,527,579,579,2,Sore
11078,2012-04-11,1,4,18,0,3,1,3,0.4,0.4091,0.43,0.4179,39,546,585,585,2,Sore
11079,2012-04-11,1,4,19,0,3,1,1,0.4,0.4091,0.4,0.3582,28,356,384,384,2,Malam
11080,2012-04-11,1,4,20,0,3,1,1,0.36,0.3333,0.46,0.3284,22,213,235,235,2,Malam
11081,2012-04-11,1,4,21,0,3,1,1,0.34,0.303,0.57,0.3881,11,154,165,165,2,Malam
11082,2012-04-11,1,4,22,0,3,1,1,0.34,0.303,0.57,0.3284,4,130,134,134,2,Malam
11083,2012-04-11,1,4,23,0,3,1,1,0.34,0.303,0.57,0.2985,9,52,61,61,2,Malam
11084,2012-04-12,1,4,0,0,4,1,1,0.32,0.303,0.66,0.2836,1,22,23,23,2,
11085,2012-04-12,1,4,1,0,4,1,1,0.32,0.303,0.66,0.2239,2,7,9,9,2,Pagi
11086,2012-04-12,1,4,2,0,4,1,1,0.32,0.303,0.61,0.2836,0,4,4,4,2,Pagi
11087,2012-04-12,1,4,3,0,4,1,1,0.32,0.303,0.61,0.2537,2,3,5,5,2,Pagi
11088,2012-04-12,1,4,4,0,4,1,1,0.3,0.2879,0.61,0.2239,0,1,1,1,2,Pagi
11089,2012-04-12,1,4,5,0,4,1,1,0.3,0.2879,0.61,0.2239,0,21,21,21,2,Pagi
11090,2012-04-12,1,4,6,0,4,1,1,0.3,0.2879,0.65,0.2537,2,94,96,96,2,Pagi
11091,2012-04-12,1,4,7,0,4,1,1,0.3,0.2727,0.65,0.3284,12,294,306,306,2,Siang
11092,2012-04-12,1,4,8,0,4,1,1,0.32,0.303,0.66,0.3284,20,604,624,624,2,Siang
11093,2012-04-12,1,4,9,0,4,1,1,0.36,0.3333,0.57,0.3582,16,271,287,287,2,Siang
11094,2012-04-12,1,4,10,0,4,1,1,0.4,0.4091,0.5,0.2985,38,103,141,141,2,Siang
11095,2012-04-12,1,4,11,0,4,1,1,0.42,0.4242,0.47,0.2985,50,174,224,224,2,Siang
11096,2012-04-12,1,4,12,0,4,1,1,0.46,0.4545,0.41,0.4478,60,199,259,259,2,Siang
11097,2012-04-12,1,4,13,0,4,1,1,0.48,0.4697,0.36,0.4478,55,148,203,203,2,Sore
11098,2012-04-12,1,4,14,0,4,1,1,0.5,0.4848,0.31,0.3284,74,150,224,224,2,Sore
11099,2012-04-12,1,4,15,0,4,1,1,0.48,0.4697,0.31,0.2537,42,169,211,211,2,Sore
11100,2012-04-12,1,4,16,0,4,1,1,0.48,0.4697,0.31,0.2836,54,299,353,353,2,Sore
11101,2012-04-12,1,4,17,0,4,1,1,0.5,0.4848,0.27,0.3881,60,596,656,656,2,Sore
11102,2012-04-12,1,4,18,0,4,1,1,0.5,0.4848,0.27,0.3881,63,547,610,610,2,Sore
11103,2012-04-12,1,4,19,0,4,1,1,0.46,0.4545,0.31,0.2985,50,383,433,433,2,Malam
11104,2012-04-12,1,4,20,0,4,1,1,0.44,0.4394,0.33,0.2537,26,254,280,280,2,Malam
11105,2012-04-12,1,4,21,0,4,1,1,0.42,0.4242,0.35,0.1343,13,174,187,187,2,Malam
11106,2012-04-12,1,4,22,0,4,1,1,0.42,0.4242,0.35,0.194,15,143,158,158,2,Malam
11107,2012-04-12,1,4,23,0,4,1,1,0.42,0.4242,0.35,0.194,8,86,94,94,2,Malam
11108,2012-04-13,1,4,0,0,5,1,1,0.4,0.4091,0.37,0.2537,14,41,55,55,2,
11109,2012-04-13,1,4,1,0,5,1,1,0.36,0.3485,0.46,0.194,2,28,30,30,2,Pagi
11110,2012-04-13,1,4,2,0,5,1,1,0.34,0.3333,0.49,0.194,6,5,11,11,2,Pagi
11111,2012-04-13,1,4,3,0,5,1,1,0.34,0.3333,0.61,0.1642,3,8,11,11,2,Pagi
11112,2012-04-13,1,4,4,0,5,1,2,0.34,0.3333,0.53,0.1343,1,4,5,5,2,Pagi
11113,2012-04-13,1,4,5,0,5,1,2,0.34,0.3333,0.53,0.1642,2,19,21,21,2,Pagi
11114,2012-04-13,1,4,6,0,5,1,1,0.32,0.3182,0.57,0.1642,0,84,84,84,2,Pagi
11115,2012-04-13,1,4,7,0,5,1,1,0.34,0.3182,0.61,0.2239,13,283,296,296,2,Siang
11116,2012-04-13,1,4,8,0,5,1,1,0.38,0.3939,0.46,0.1642,24,539,563,563,2,Siang
11117,2012-04-13,1,4,9,0,5,1,1,0.42,0.4242,0.41,0.1642,36,294,330,330,2,Siang
11118,2012-04-13,1,4,10,0,5,1,1,0.44,0.4394,0.38,0.194,59,133,192,192,2,Siang
11119,2012-04-13,1,4,11,0,5,1,1,0.46,0.4545,0.36,0.1343,75,158,233,233,2,Siang
11120,2012-04-13,1,4,12,0,5,1,1,0.5,0.4848,0.31,0.0,104,218,322,322,2,Siang
11121,2012-04-13,1,4,13,0,5,1,1,0.52,0.5,0.27,0.2836,112,246,358,358,2,Sore
11122,2012-04-13,1,4,14,0,5,1,1,0.52,0.5,0.27,0.0,125,223,348,348,2,Sore
11123,2012-04-13,1,4,15,0,5,1,1,0.54,0.5152,0.28,0.2537,115,237,352,352,2,Sore
11124,2012-04-13,1,4,16,0,5,1,1,0.56,0.5303,0.26,0.2537,113,350,463,463,2,Sore
11125,2012-04-13,1,4,17,0,5,1,1,0.56,0.5303,0.24,0.1642,117,621,738,738,2,Sore
11126,2012-04-13,1,4,18,0,5,1,1,0.54,0.5152,0.26,0.1343,107,564,671,671,2,Sore
11127,2012-04-13,1,4,19,0,5,1,1,0.54,0.5152,0.24,0.1642,75,352,427,427,2,Malam
11128,2012-04-13,1,4,20,0,5,1,1,0.5,0.4848,0.29,0.1343,44,242,286,286,2,Malam
11129,2012-04-13,1,4,21,0,5,1,1,0.5,0.4848,0.36,0.0,36,153,189,189,2,Malam
11130,2012-04-13,1,4,22,0,5,1,1,0.44,0.4394,0.62,0.1045,34,181,215,215,2,Malam
11131,2012-04-13,1,4,23,0,5,1,1,0.42,0.4242,0.62,0.0896,35,163,198,198,2,Malam
11132,2012-04-14,1,4,0,0,6,0,1,0.4,0.4091,0.58,0.1343,11,85,96,96,2,
11133,2012-04-14,1,4,1,0,6,0,1,0.4,0.4091,0.58,0.1343,10,60,70,70,2,Pagi
11134,2012-04-14,1,4,2,0,6,0,1,0.38,0.3939,0.66,0.1343,3,53,56,56,2,Pagi
11135,2012-04-14,1,4,3,0,6,0,1,0.36,0.3636,0.66,0.0896,6,26,32,32,2,Pagi
11136,2012-04-14,1,4,4,0,6,0,1,0.36,0.3636,0.71,0.1045,5,9,14,14,2,Pagi
11137,2012-04-14,1,4,5,0,6,0,1,0.36,0.3636,0.66,0.1045,2,5,7,7,2,Pagi
11138,2012-04-14,1,4,6,0,6,0,1,0.34,0.3333,0.76,0.1642,2,19,21,21,2,Pagi
11139,2012-04-14,1,4,7,0,6,0,1,0.36,0.3636,0.71,0.1045,8,56,64,64,2,Siang
11140,2012-04-14,1,4,8,0,6,0,1,0.36,0.3485,0.71,0.1343,24,136,160,160,2,Siang
11141,2012-04-14,1,4,9,0,6,0,1,0.42,0.4242,0.54,0.1343,59,206,265,265,2,Siang
11142,2012-04-14,1,4,10,0,6,0,1,0.46,0.4545,0.51,0.1642,139,267,406,406,2,Siang
11143,2012-04-14,1,4,11,0,6,0,1,0.52,0.5,0.45,0.194,207,357,564,564,2,Siang
11144,2012-04-14,1,4,12,0,6,0,1,0.58,0.5455,0.35,0.2537,274,404,678,678,2,Siang
11145,2012-04-14,1,4,13,0,6,0,1,0.62,0.6212,0.33,0.2985,308,370,678,678,2,Sore
11146,2012-04-14,1,4,14,0,6,0,2,0.64,0.6212,0.27,0.4478,288,372,660,660,2,Sore
11147,2012-04-14,1,4,15,0,6,0,2,0.64,0.6212,0.27,0.3582,311,347,658,658,2,Sore
11148,2012-04-14,1,4,16,0,6,0,2,0.64,0.6212,0.27,0.3582,253,329,582,582,2,Sore
11149,2012-04-14,1,4,17,0,6,0,2,0.62,0.6212,0.33,0.2537,251,309,560,560,2,Sore
11150,2012-04-14,1,4,18,0,6,0,2,0.62,0.6212,0.35,0.2239,197,284,481,481,2,Sore
11151,2012-04-14,1,4,19,0,6,0,2,0.6,0.6212,0.4,0.1642,163,296,459,459,2,Malam
11152,2012-04-14,1,4,20,0,6,0,2,0.56,0.5303,0.46,0.1343,112,209,321,321,2,Malam
11153,2012-04-14,1,4,21,0,6,0,2,0.56,0.5303,0.43,0.1343,53,167,220,220,2,Malam
11154,2012-04-14,1,4,22,0,6,0,2,0.54,0.5152,0.52,0.1642,64,148,212,212,2,Malam
11155,2012-04-14,1,4,23,0,6,0,2,0.54,0.5152,0.56,0.194,45,151,196,196,2,Malam
11156,2012-04-15,1,4,0,0,0,0,2,0.54,0.5152,0.56,0.194,30,94,124,124,2,
11157,2012-04-15,1,4,1,0,0,0,2,0.54,0.5152,0.56,0.1642,17,89,106,106,2,Pagi
11158,2012-04-15,1,4,2,0,0,0,2,0.54,0.5152,0.56,0.1045,20,54,74,74,2,Pagi
11159,2012-04-15,1,4,3,0,0,0,2,0.52,0.5,0.59,0.1343,18,27,45,45,2,Pagi
11160,2012-04-15,1,4,4,0,0,0,2,0.54,0.5152,0.52,0.0,2,10,12,12,2,Pagi
11161,2012-04-15,1,4,5,0,0,0,1,0.5,0.4848,0.68,0.1642,4,6,10,10,2,Pagi
11162,2012-04-15,1,4,6,0,0,0,1,0.5,0.4848,0.63,0.1343,5,11,16,16,2,Pagi
11163,2012-04-15,1,4,7,0,0,0,1,0.5,0.4848,0.63,0.1045,16,30,46,46,2,Siang
11164,2012-04-15,1,4,8,0,0,0,1,0.52,0.5,0.59,0.0,33,64,97,97,2,Siang
11165,2012-04-15,1,4,9,0,0,0,1,0.54,0.5152,0.56,0.2239,97,154,251,251,2,Siang
11166,2012-04-15,1,4,10,0,0,0,1,0.58,0.5455,0.53,0.2239,186,235,421,421,2,Siang
11167,2012-04-15,1,4,11,0,0,0,1,0.62,0.6212,0.46,0.2985,227,301,528,528,2,Siang
11168,2012-04-15,1,4,12,0,0,0,1,0.64,0.6212,0.44,0.2836,275,360,635,635,2,Siang
11169,2012-04-15,1,4,13,0,0,0,1,0.66,0.6212,0.44,0.2836,298,383,681,681,2,Sore
11170,2012-04-15,1,4,14,0,0,0,1,0.7,0.6364,0.39,0.2836,282,346,628,628,2,Sore
11171,2012-04-15,1,4,15,0,0,0,1,0.7,0.6364,0.39,0.3881,266,351,617,617,2,Sore
11172,2012-04-15,1,4,16,0,0,0,1,0.72,0.6515,0.39,0.3582,286,330,616,616,2,Sore
11173,2012-04-15,1,4,17,0,0,0,1,0.7,0.6364,0.42,0.3284,262,361,623,623,2,Sore
11174,2012-04-15,1,4,18,0,0,0,1,0.7,0.6364,0.42,0.2537,184,295,479,479,2,Sore
11175,2012-04-15,1,4,19,0,0,0,1,0.7,0.6364,0.42,0.2537,114,265,379,379,2,Malam
11176,2012-04-15,1,4,20,0,0,0,1,0.64,0.6212,0.5,0.2239,86,205,291,291,2,Malam
11177,2012-04-15,1,4,21,0,0,0,1,0.62,0.6212,0.57,0.2537,76,153,229,229,2,Malam
11178,2012-04-15,1,4,22,0,0,0,1,0.68,0.6364,0.44,0.3582,37,97,134,134,2,Malam
11179,2012-04-15,1,4,23,0,0,0,1,0.66,0.6212,0.5,0.3881,25,65,90,90,2,Malam
11180,2012-04-16,1,4,0,1,1,0,1,0.64,0.6212,0.53,0.3284,15,26,41,41,2,
11181,2012-04-16,1,4,1,1,1,0,1,0.62,0.6061,0.61,0.3582,7,21,28,28,2,Pagi
11182,2012-04-16,1,4,2,1,1,0,1,0.6,0.6061,0.64,0.2537,5,9,14,14,2,Pagi
11183,2012-04-16,1,4,3,1,1,0,1,0.58,0.5455,0.68,0.194,3,5,8,8,2,Pagi
11184,2012-04-16,1,4,4,1,1,0,1,0.54,0.5152,0.77,0.2239,0,6,6,6,2,Pagi
11185,2012-04-16,1,4,5,1,1,0,1,0.54,0.5152,0.77,0.2239,4,34,38,38,2,Pagi
11186,2012-04-16,1,4,6,1,1,0,1,0.52,0.5,0.83,0.1642,10,123,133,133,2,Pagi
11187,2012-04-16,1,4,7,1,1,0,1,0.52,0.5,0.83,0.1343,20,367,387,387,2,Siang
11188,2012-04-16,1,4,8,1,1,0,2,0.56,0.5303,0.83,0.1642,48,549,597,597,2,Siang
11189,2012-04-16,1,4,9,1,1,0,1,0.62,0.6061,0.69,0.2239,59,238,297,297,2,Siang
11190,2012-04-16,1,4,10,1,1,0,1,0.62,0.6061,0.69,0.2537,75,149,224,224,2,Siang
11191,2012-04-16,1,4,11,1,1,0,1,0.64,0.6061,0.65,0.2537,115,136,251,251,2,Siang
11192,2012-04-16,1,4,12,1,1,0,1,0.68,0.6364,0.57,0.2537,75,196,271,271,2,Siang
11193,2012-04-16,1,4,13,1,1,0,1,0.74,0.6667,0.45,0.2985,79,184,263,263,2,Sore
11194,2012-04-16,1,4,14,1,1,0,1,0.76,0.6818,0.45,0.3284,105,183,288,288,2,Sore
11195,2012-04-16,1,4,15,1,1,0,1,0.8,0.697,0.33,0.4478,81,194,275,275,2,Sore
11196,2012-04-16,1,4,16,1,1,0,1,0.8,0.697,0.33,0.4627,92,266,358,358,2,Sore
11197,2012-04-16,1,4,17,1,1,0,1,0.8,0.697,0.33,0.3881,111,601,712,712,2,Sore
11198,2012-04-16,1,4,18,1,1,0,1,0.8,0.697,0.31,0.3881,87,589,676,676,2,Sore
11199,2012-04-16,1,4,19,1,1,0,1,0.76,0.6667,0.35,0.3881,61,461,522,522,2,Malam
11200,2012-04-16,1,4,20,1,1,0,1,0.74,0.6515,0.37,0.2985,48,327,375,375,2,Malam
11201,2012-04-16,1,4,21,1,1,0,1,0.68,0.6364,0.51,0.2537,39,232,271,271,2,Malam
11202,2012-04-16,1,4,22,1,1,0,1,0.68,0.6364,0.51,0.2537,35,179,214,214,2,Malam
11203,2012-04-16,1,4,23,1,1,0,1,0.7,0.6364,0.45,0.2985,24,97,121,121,2,Malam
11204,2012-04-17,1,4,0,0,2,1,1,0.66,0.6212,0.54,0.194,10,33,43,43,2,
11205,2012-04-17,1,4,1,0,2,1,1,0.64,0.6212,0.57,0.1642,6,5,11,11,2,Pagi
11206,2012-04-17,1,4,2,0,2,1,1,0.56,0.5303,0.83,0.1045,1,3,4,4,2,Pagi
11207,2012-04-17,1,4,3,0,2,1,1,0.56,0.5303,0.83,0.0896,0,6,6,6,2,Pagi
11208,2012-04-17,1,4,4,0,2,1,1,0.66,0.6212,0.44,0.2239,3,6,9,9,2,Pagi
11209,2012-04-17,1,4,5,0,2,1,1,0.6,0.6212,0.53,0.2537,1,29,30,30,2,Pagi
11210,2012-04-17,1,4,6,0,2,1,1,0.6,0.6212,0.46,0.2537,8,136,144,144,2,Pagi
11211,2012-04-17,1,4,7,0,2,1,1,0.6,0.6212,0.43,0.2537,18,443,461,461,2,Siang
11212,2012-04-17,1,4,8,0,2,1,1,0.6,0.6212,0.43,0.2239,42,631,673,673,2,Siang
11213,2012-04-17,1,4,9,0,2,1,1,0.6,0.6212,0.38,0.4925,71,329,400,400,2,Siang
11214,2012-04-17,1,4,10,0,2,1,1,0.6,0.6212,0.38,0.4179,52,165,217,217,2,Siang
11215,2012-04-17,1,4,11,0,2,1,1,0.6,0.6212,0.33,0.4179,65,174,239,239,2,Siang
11216,2012-04-17,1,4,12,0,2,1,1,0.6,0.6212,0.33,0.3582,65,179,244,244,2,Siang
11217,2012-04-17,1,4,13,0,2,1,1,0.62,0.6212,0.29,0.2537,52,187,239,239,2,Sore
11218,2012-04-17,1,4,14,0,2,1,1,0.64,0.6212,0.27,0.2836,59,198,257,257,2,Sore
11219,2012-04-17,1,4,15,0,2,1,1,0.66,0.6212,0.24,0.3284,91,217,308,308,2,Sore
11220,2012-04-17,1,4,16,0,2,1,1,0.68,0.6212,0.22,0.3582,50,320,370,370,2,Sore
11221,2012-04-17,1,4,17,0,2,1,1,0.64,0.6061,0.25,0.2985,108,673,781,781,2,Sore
11222,2012-04-17,1,4,18,0,2,1,1,0.64,0.6061,0.25,0.2836,105,670,775,775,2,Sore
11223,2012-04-17,1,4,19,0,2,1,1,0.6,0.6061,0.26,0.2537,73,464,537,537,2,Malam
11224,2012-04-17,1,4,20,0,2,1,1,0.6,0.6061,0.23,0.2836,44,358,402,402,2,Malam
11225,2012-04-17,1,4,21,0,2,1,1,0.56,0.5303,0.26,0.2985,37,260,297,297,2,Malam
11226,2012-04-17,1,4,22,0,2,1,1,0.54,0.5152,0.3,0.2537,18,144,162,162,2,Malam
11227,2012-04-17,1,4,23,0,2,1,1,0.54,0.5152,0.32,0.2239,10,72,82,82,2,Malam
11228,2012-04-18,1,4,0,0,3,1,1,0.54,0.5152,0.32,0.1642,3,35,38,38,2,
11229,2012-04-18,1,4,1,0,3,1,1,0.52,0.5,0.34,0.194,1,13,14,14,2,Pagi
11230,2012-04-18,1,4,2,0,3,1,2,0.5,0.4848,0.42,0.194,1,8,9,9,2,Pagi
11231,2012-04-18,1,4,3,0,3,1,2,0.5,0.4848,0.42,0.2239,0,6,6,6,2,Pagi
11232,2012-04-18,1,4,4,0,3,1,2,0.5,0.4848,0.42,0.2836,0,7,7,7,2,Pagi
11233,2012-04-18,1,4,5,0,3,1,2,0.5,0.4848,0.39,0.2836,0,34,34,34,2,Pagi
11234,2012-04-18,1,4,6,0,3,1,2,0.5,0.4848,0.39,0.2836,6,128,134,134,2,Pagi
11235,2012-04-18,1,4,7,0,3,1,2,0.5,0.4848,0.39,0.194,10,408,418,418,2,Siang
11236,2012-04-18,1,4,8,0,3,1,3,0.5,0.4848,0.39,0.194,25,551,576,576,2,Siang
11237,2012-04-18,1,4,9,0,3,1,3,0.48,0.4697,0.44,0.2985,20,245,265,265,2,Siang
11238,2012-04-18,1,4,10,0,3,1,3,0.48,0.4697,0.47,0.2239,31,116,147,147,2,Siang
11239,2012-04-18,1,4,11,0,3,1,3,0.46,0.4545,0.47,0.2537,14,105,119,119,2,Siang
11240,2012-04-18,1,4,12,0,3,1,3,0.46,0.4545,0.51,0.1045,15,95,110,110,2,Siang
11241,2012-04-18,1,4,13,0,3,1,3,0.46,0.4545,0.59,0.0,13,51,64,64,2,Sore
11242,2012-04-18,1,4,14,0,3,1,3,0.44,0.4394,0.72,0.1045,8,43,51,51,2,Sore
11243,2012-04-18,1,4,15,0,3,1,3,0.42,0.4242,0.77,0.194,10,88,98,98,2,Sore
11244,2012-04-18,1,4,16,0,3,1,2,0.42,0.4242,0.77,0.2239,36,199,235,235,2,Sore
11245,2012-04-18,1,4,17,0,3,1,2,0.42,0.4242,0.77,0.194,46,442,488,488,2,Sore
11246,2012-04-18,1,4,18,0,3,1,2,0.42,0.4242,0.77,0.0,27,478,505,505,2,Sore
11247,2012-04-18,1,4,19,0,3,1,2,0.42,0.4242,0.77,0.1343,26,342,368,368,2,Malam
11248,2012-04-18,1,4,20,0,3,1,2,0.42,0.4242,0.77,0.1045,8,252,260,260,2,Malam
11249,2012-04-18,1,4,21,0,3,1,2,0.42,0.4242,0.82,0.0896,24,165,189,189,2,Malam
11250,2012-04-18,1,4,22,0,3,1,2,0.42,0.4242,0.77,0.0896,9,153,162,162,2,Malam
11251,2012-04-18,1,4,23,0,3,1,2,0.42,0.4242,0.77,0.0,14,56,70,70,2,Malam
11252,2012-04-19,1,4,0,0,4,1,3,0.42,0.4242,0.77,0.0,5,20,25,25,2,
11253,2012-04-19,1,4,1,0,4,1,3,0.42,0.4242,0.77,0.1045,2,11,13,13,2,Pagi
11254,2012-04-19,1,4,2,0,4,1,2,0.42,0.4242,0.77,0.0,2,4,6,6,2,Pagi
11255,2012-04-19,1,4,3,0,4,1,2,0.42,0.4242,0.77,0.0,1,3,4,4,2,Pagi
11256,2012-04-19,1,4,4,0,4,1,2,0.42,0.4242,0.71,0.0,0,4,4,4,2,Pagi
11257,2012-04-19,1,4,5,0,4,1,1,0.4,0.4091,0.82,0.0,0,30,30,30,2,Pagi
11258,2012-04-19,1,4,6,0,4,1,2,0.4,0.4091,0.82,0.1045,4,116,120,120,2,Pagi
11259,2012-04-19,1,4,7,0,4,1,2,0.4,0.4091,0.82,0.1343,15,391,406,406,2,Siang
11260,2012-04-19,1,4,8,0,4,1,2,0.42,0.4242,0.82,0.1045,26,651,677,677,2,Siang
11261,2012-04-19,1,4,9,0,4,1,2,0.46,0.4545,0.72,0.0,31,270,301,301,2,Siang
11262,2012-04-19,1,4,10,0,4,1,1,0.48,0.4697,0.63,0.0896,46,143,189,189,2,Siang
11263,2012-04-19,1,4,11,0,4,1,1,0.52,0.5,0.48,0.0,46,183,229,229,2,Siang
11264,2012-04-19,1,4,12,0,4,1,1,0.54,0.5152,0.49,0.0,51,213,264,264,2,Siang
11265,2012-04-19,1,4,13,0,4,1,1,0.56,0.5303,0.46,0.0,52,186,238,238,2,Sore
11266,2012-04-19,1,4,14,0,4,1,1,0.58,0.5455,0.43,0.0,54,183,237,237,2,Sore
11267,2012-04-19,1,4,15,0,4,1,1,0.6,0.6212,0.43,0.0,66,196,262,262,2,Sore
11268,2012-04-19,1,4,16,0,4,1,1,0.62,0.6212,0.41,0.1045,63,324,387,387,2,Sore
11269,2012-04-19,1,4,17,0,4,1,1,0.6,0.6212,0.43,0.0896,85,663,748,748,2,Sore
11270,2012-04-19,1,4,18,0,4,1,1,0.6,0.6212,0.43,0.0896,99,677,776,776,2,Sore
11271,2012-04-19,1,4,19,0,4,1,1,0.58,0.5455,0.46,0.1343,70,516,586,586,2,Malam
11272,2012-04-19,1,4,20,0,4,1,1,0.56,0.5303,0.49,0.2239,52,352,404,404,2,Malam
11273,2012-04-19,1,4,21,0,4,1,1,0.52,0.5,0.55,0.1045,27,240,267,267,2,Malam
11274,2012-04-19,1,4,22,0,4,1,1,0.52,0.5,0.59,0.194,29,219,248,248,2,Malam
11275,2012-04-19,1,4,23,0,4,1,1,0.5,0.4848,0.63,0.1045,20,124,144,144,2,Malam
11276,2012-04-20,1,4,0,0,5,1,1,0.48,0.4697,0.67,0.1045,5,59,64,64,2,
11277,2012-04-20,1,4,1,0,5,1,1,0.46,0.4545,0.82,0.194,3,22,25,25,2,Pagi
11278,2012-04-20,1,4,2,0,5,1,1,0.44,0.4394,0.88,0.194,3,18,21,21,2,Pagi
11279,2012-04-20,1,4,3,0,5,1,1,0.44,0.4394,0.88,0.1045,1,9,10,10,2,Pagi
11280,2012-04-20,1,4,4,0,5,1,1,0.42,0.4242,0.94,0.1045,0,3,3,3,2,Pagi
11281,2012-04-20,1,4,5,0,5,1,1,0.42,0.4242,0.94,0.0,1,24,25,25,2,Pagi
11282,2012-04-20,1,4,6,0,5,1,1,0.42,0.4242,0.88,0.0,8,105,113,113,2,Pagi
11283,2012-04-20,1,4,7,0,5,1,1,0.42,0.4242,0.94,0.0,9,350,359,359,2,Siang
11284,2012-04-20,1,4,8,0,5,1,1,0.44,0.4394,0.94,0.0,32,668,700,700,2,Siang
11285,2012-04-20,1,4,9,0,5,1,1,0.46,0.4545,0.88,0.0896,30,329,359,359,2,Siang
11286,2012-04-20,1,4,10,0,5,1,1,0.5,0.4848,0.77,0.194,67,170,237,237,2,Siang
11287,2012-04-20,1,4,11,0,5,1,1,0.54,0.5152,0.68,0.1642,64,190,254,254,2,Siang
11288,2012-04-20,1,4,12,0,5,1,1,0.58,0.5455,0.53,0.194,102,260,362,362,2,Siang
11289,2012-04-20,1,4,13,0,5,1,1,0.62,0.6212,0.43,0.194,105,276,381,381,2,Sore
11290,2012-04-20,1,4,14,0,5,1,1,0.64,0.6212,0.44,0.2239,156,238,394,394,2,Sore
11291,2012-04-20,1,4,15,0,5,1,1,0.64,0.6212,0.47,0.194,145,262,407,407,2,Sore
11292,2012-04-20,1,4,16,0,5,1,1,0.66,0.6212,0.44,0.194,151,429,580,580,2,Sore
11293,2012-04-20,1,4,17,0,5,1,1,0.64,0.6212,0.47,0.2836,122,697,819,819,2,Sore
11294,2012-04-20,1,4,18,0,5,1,1,0.62,0.6212,0.5,0.2836,110,558,668,668,2,Sore
11295,2012-04-20,1,4,19,0,5,1,1,0.6,0.6212,0.53,0.194,82,410,492,492,2,Malam
11296,2012-04-20,1,4,20,0,5,1,1,0.58,0.5455,0.56,0.1642,52,289,341,341,2,Malam
11297,2012-04-20,1,4,21,0,5,1,1,0.56,0.5303,0.68,0.1343,35,252,287,287,2,Malam
11298,2012-04-20,1,4,22,0,5,1,1,0.54,0.5152,0.68,0.2537,26,176,202,202,2,Malam
11299,2012-04-20,1,4,23,0,5,1,1,0.52,0.5,0.72,0.1343,31,156,187,187,2,Malam
11300,2012-04-21,1,4,0,0,6,0,1,0.52,0.5,0.77,0.2239,31,111,142,142,2,
11301,2012-04-21,1,4,1,0,6,0,1,0.52,0.5,0.77,0.2239,24,64,88,88,2,Pagi
11302,2012-04-21,1,4,2,0,6,0,1,0.52,0.5,0.77,0.1343,12,69,81,81,2,Pagi
11303,2012-04-21,1,4,3,0,6,0,1,0.5,0.4848,0.82,0.2239,4,25,29,29,2,Pagi
11304,2012-04-21,1,4,4,0,6,0,1,0.5,0.4848,0.82,0.2537,0,9,9,9,2,Pagi
11305,2012-04-21,1,4,5,0,6,0,1,0.5,0.4848,0.82,0.2537,0,1,1,1,2,Pagi
11306,2012-04-21,1,4,6,0,6,0,1,0.5,0.4848,0.82,0.2239,10,21,31,31,2,Pagi
11307,2012-04-21,1,4,7,0,6,0,1,0.5,0.4848,0.82,0.2836,21,55,76,76,2,Siang
11308,2012-04-21,1,4,8,0,6,0,1,0.52,0.5,0.81,0.2537,52,149,201,201,2,Siang
11309,2012-04-21,1,4,9,0,6,0,1,0.54,0.5152,0.77,0.1642,115,216,331,331,2,Siang
11310,2012-04-21,1,4,10,0,6,0,1,0.6,0.6061,0.64,0.2836,183,299,482,482,2,Siang
11311,2012-04-21,1,4,11,0,6,0,1,0.62,0.6061,0.61,0.3284,260,348,608,608,2,Siang
11312,2012-04-21,1,4,12,0,6,0,1,0.64,0.6212,0.57,0.2239,262,378,640,640,2,Siang
11313,2012-04-21,1,4,13,0,6,0,1,0.66,0.6212,0.54,0.2239,291,358,649,649,2,Sore
11314,2012-04-21,1,4,14,0,6,0,1,0.7,0.6364,0.45,0.2836,278,331,609,609,2,Sore
11315,2012-04-21,1,4,15,0,6,0,1,0.72,0.6515,0.39,0.2537,267,361,628,628,2,Sore
11316,2012-04-21,1,4,16,0,6,0,1,0.7,0.6364,0.42,0.3284,267,372,639,639,2,Sore
11317,2012-04-21,1,4,17,0,6,0,2,0.74,0.6515,0.3,0.3881,259,309,568,568,2,Sore
11318,2012-04-21,1,4,18,0,6,0,2,0.68,0.6364,0.47,0.4925,133,283,416,416,2,Sore
11319,2012-04-21,1,4,19,0,6,0,3,0.56,0.5303,0.73,0.4925,9,45,54,54,2,Malam
11320,2012-04-21,1,4,20,0,6,0,3,0.5,0.4848,0.82,0.2985,5,34,39,39,2,Malam
11321,2012-04-21,1,4,21,0,6,0,3,0.5,0.4848,0.82,0.3881,20,82,102,102,2,Malam
11322,2012-04-21,1,4,22,0,6,0,1,0.48,0.4697,0.82,0.2985,20,90,110,110,2,Malam
11323,2012-04-21,1,4,23,0,6,0,2,0.46,0.4545,0.82,0.2836,18,73,91,91,2,Malam
11324,2012-04-22,1,4,0,0,0,0,2,0.46,0.4545,0.82,0.194,32,85,117,117,2,
11325,2012-04-22,1,4,1,0,0,0,2,0.46,0.4545,0.82,0.3284,10,63,73,73,2,Pagi
11326,2012-04-22,1,4,2,0,0,0,1,0.46,0.4545,0.72,0.2836,7,49,56,56,2,Pagi
11327,2012-04-22,1,4,3,0,0,0,2,0.44,0.4394,0.82,0.1642,7,33,40,40,2,Pagi
11328,2012-04-22,1,4,4,0,0,0,2,0.44,0.4394,0.77,0.1642,0,7,7,7,2,Pagi
11329,2012-04-22,1,4,5,0,0,0,2,0.44,0.4394,0.77,0.2239,0,6,6,6,2,Pagi
11330,2012-04-22,1,4,6,0,0,0,2,0.44,0.4394,0.72,0.3284,6,6,12,12,2,Pagi
11331,2012-04-22,1,4,7,0,0,0,3,0.42,0.4242,0.77,0.3881,2,22,24,24,2,Siang
11332,2012-04-22,1,4,8,0,0,0,3,0.4,0.4091,0.82,0.2537,8,43,51,51,2,Siang
11333,2012-04-22,1,4,9,0,0,0,3,0.4,0.4091,0.82,0.2537,8,71,79,79,2,Siang
11334,2012-04-22,1,4,10,0,0,0,3,0.38,0.3939,0.82,0.3284,11,57,68,68,2,Siang
11335,2012-04-22,1,4,11,0,0,0,3,0.38,0.3939,0.87,0.2985,7,70,77,77,2,Siang
11336,2012-04-22,1,4,12,0,0,0,3,0.38,0.3939,0.87,0.3284,5,56,61,61,2,Siang
11337,2012-04-22,1,4,13,0,0,0,3,0.38,0.3939,0.82,0.3582,5,47,52,52,2,Sore
11338,2012-04-22,1,4,14,0,0,0,3,0.38,0.3939,0.87,0.3284,3,50,53,53,2,Sore
11339,2012-04-22,1,4,15,0,0,0,3,0.38,0.3939,0.87,0.3881,0,38,38,38,2,Sore
11340,2012-04-22,1,4,16,0,0,0,3,0.38,0.3939,0.87,0.4478,4,32,36,36,2,Sore
11341,2012-04-22,1,4,17,0,0,0,3,0.36,0.3182,0.93,0.4478,2,25,27,27,2,Sore
11342,2012-04-22,1,4,18,0,0,0,3,0.36,0.3182,0.93,0.4478,1,38,39,39,2,Sore
11343,2012-04-22,1,4,19,0,0,0,3,0.36,0.3182,0.87,0.5224,1,34,35,35,2,Malam
11344,2012-04-22,1,4,20,0,0,0,3,0.36,0.3333,0.93,0.4179,1,34,35,35,2,Malam
11345,2012-04-22,1,4,21,0,0,0,3,0.36,0.3333,0.87,0.3881,0,11,11,11,2,Malam
11346,2012-04-22,1,4,22,0,0,0,3,0.34,0.2879,0.87,0.5224,0,13,13,13,2,Malam
11347,2012-04-22,1,4,23,0,0,0,3,0.36,0.3182,0.81,0.4627,0,17,17,17,2,Malam
11348,2012-04-23,1,4,0,0,1,1,3,0.36,0.3333,0.81,0.4179,0,6,6,6,2,
11349,2012-04-23,1,4,1,0,1,1,3,0.34,0.303,0.87,0.3582,1,1,2,2,2,Pagi
11350,2012-04-23,1,4,2,0,1,1,2,0.32,0.303,0.87,0.3284,1,3,4,4,2,Pagi
11351,2012-04-23,1,4,3,0,1,1,2,0.32,0.303,0.81,0.2836,0,1,1,1,2,Pagi
11352,2012-04-23,1,4,4,0,1,1,3,0.3,0.2879,0.81,0.2836,0,3,3,3,2,Pagi
11353,2012-04-23,1,4,5,0,1,1,3,0.3,0.2879,0.81,0.2836,0,14,14,14,2,Pagi
11354,2012-04-23,1,4,6,0,1,1,2,0.3,0.2727,0.81,0.2985,2,43,45,45,2,Pagi
11355,2012-04-23,1,4,7,0,1,1,3,0.3,0.2879,0.81,0.2537,1,206,207,207,2,Siang
11356,2012-04-23,1,4,8,0,1,1,2,0.3,0.2727,0.75,0.3284,11,471,482,482,2,Siang
11357,2012-04-23,1,4,9,0,1,1,2,0.3,0.2727,0.75,0.3881,17,255,272,272,2,Siang
11358,2012-04-23,1,4,10,0,1,1,2,0.32,0.303,0.7,0.3284,12,88,100,100,2,Siang
11359,2012-04-23,1,4,11,0,1,1,2,0.32,0.2879,0.7,0.3582,10,91,101,101,2,Siang
11360,2012-04-23,1,4,12,0,1,1,3,0.34,0.303,0.71,0.3582,12,117,129,129,2,Siang
11361,2012-04-23,1,4,13,0,1,1,3,0.34,0.303,0.66,0.3881,9,98,107,107,2,Sore
11362,2012-04-23,1,4,14,0,1,1,3,0.36,0.3182,0.62,0.4478,12,102,114,114,2,Sore
11363,2012-04-23,1,4,15,0,1,1,2,0.36,0.3333,0.62,0.3881,11,101,112,112,2,Sore
11364,2012-04-23,1,4,16,0,1,1,3,0.3,0.2727,0.81,0.3582,10,93,103,103,2,Sore
11365,2012-04-23,1,4,17,0,1,1,3,0.3,0.2727,0.82,0.3284,13,219,232,232,2,Sore
11366,2012-04-23,1,4,18,0,1,1,3,0.32,0.3333,0.81,0.1343,10,369,379,379,2,Sore
11367,2012-04-23,1,4,19,0,1,1,2,0.34,0.3182,0.76,0.2239,11,287,298,298,2,Malam
11368,2012-04-23,1,4,20,0,1,1,2,0.32,0.3182,0.76,0.1642,17,186,203,203,2,Malam
11369,2012-04-23,1,4,21,0,1,1,2,0.32,0.303,0.81,0.2239,7,145,152,152,2,Malam
11370,2012-04-23,1,4,22,0,1,1,1,0.32,0.3182,0.76,0.194,18,71,89,89,2,Malam
11371,2012-04-23,1,4,23,0,1,1,1,0.32,0.3182,0.76,0.1642,10,49,59,59,2,Malam
11372,2012-04-24,1,4,0,0,2,1,2,0.32,0.3333,0.76,0.1343,0,13,13,13,2,
11373,2012-04-24,1,4,1,0,2,1,2,0.32,0.3333,0.81,0.1343,1,6,7,7,2,Pagi
11374,2012-04-24,1,4,2,0,2,1,1,0.32,0.3182,0.81,0.194,0,3,3,3,2,Pagi
11375,2012-04-24,1,4,3,0,2,1,1,0.32,0.303,0.81,0.2239,0,2,2,2,2,Pagi
11376,2012-04-24,1,4,4,0,2,1,1,0.3,0.2879,0.7,0.194,0,3,3,3,2,Pagi
11377,2012-04-24,1,4,5,0,2,1,1,0.3,0.2879,0.7,0.194,0,22,22,22,2,Pagi
11378,2012-04-24,1,4,6,0,2,1,1,0.3,0.2879,0.7,0.2239,3,117,120,120,2,Pagi
11379,2012-04-24,1,4,7,0,2,1,1,0.32,0.303,0.66,0.2836,3,387,390,390,2,Siang
11380,2012-04-24,1,4,8,0,2,1,1,0.34,0.3182,0.61,0.2537,12,599,611,611,2,Siang
11381,2012-04-24,1,4,9,0,2,1,1,0.4,0.4091,0.47,0.3582,6,302,308,308,2,Siang
11382,2012-04-24,1,4,10,0,2,1,1,0.42,0.4242,0.47,0.2985,33,129,162,162,2,Siang
11383,2012-04-24,1,4,11,0,2,1,1,0.46,0.4545,0.31,0.3881,27,157,184,184,2,Siang
11384,2012-04-24,1,4,12,0,2,1,1,0.48,0.4697,0.29,0.3881,36,188,224,224,2,Siang
11385,2012-04-24,1,4,13,0,2,1,1,0.5,0.4848,0.29,0.3881,35,189,224,224,2,Sore
11386,2012-04-24,1,4,14,0,2,1,1,0.5,0.4848,0.25,0.3881,50,166,216,216,2,Sore
11387,2012-04-24,1,4,15,0,2,1,1,0.5,0.4848,0.23,0.4179,60,176,236,236,2,Sore
11388,2012-04-24,1,4,16,0,2,1,1,0.5,0.4848,0.23,0.194,54,308,362,362,2,Sore
11389,2012-04-24,1,4,17,0,2,1,1,0.52,0.5,0.22,0.3881,72,619,691,691,2,Sore
11390,2012-04-24,1,4,18,0,2,1,1,0.5,0.4848,0.18,0.0,52,580,632,632,2,Sore
11391,2012-04-24,1,4,19,0,2,1,1,0.5,0.4848,0.18,0.2537,33,449,482,482,2,Malam
11392,2012-04-24,1,4,20,0,2,1,1,0.48,0.4697,0.21,0.3284,16,269,285,285,2,Malam
11393,2012-04-24,1,4,21,0,2,1,2,0.46,0.4545,0.28,0.1642,13,213,226,226,2,Malam
11394,2012-04-24,1,4,22,0,2,1,1,0.44,0.4394,0.35,0.1045,8,149,157,157,2,Malam
11395,2012-04-24,1,4,23,0,2,1,1,0.42,0.4242,0.38,0.0896,4,69,73,73,2,Malam
11396,2012-04-25,1,4,0,0,3,1,1,0.44,0.4394,0.38,0.0,13,23,36,36,2,
11397,2012-04-25,1,4,1,0,3,1,1,0.42,0.4242,0.41,0.0,8,17,25,25,2,Pagi
11398,2012-04-25,1,4,2,0,3,1,1,0.36,0.3788,0.62,0.0,1,6,7,7,2,Pagi
11399,2012-04-25,1,4,3,0,3,1,1,0.32,0.3333,0.7,0.0896,0,3,3,3,2,Pagi
11400,2012-04-25,1,4,4,0,3,1,1,0.34,0.3485,0.66,0.0896,0,6,6,6,2,Pagi
11401,2012-04-25,1,4,5,0,3,1,1,0.34,0.3636,0.66,0.0,0,24,24,24,2,Pagi
11402,2012-04-25,1,4,6,0,3,1,1,0.34,0.3636,0.66,0.0,3,103,106,106,2,Pagi
11403,2012-04-25,1,4,7,0,3,1,1,0.34,0.3636,0.71,0.0,13,376,389,389,2,Siang
11404,2012-04-25,1,4,8,0,3,1,1,0.36,0.3636,0.76,0.0896,20,634,654,654,2,Siang
11405,2012-04-25,1,4,9,0,3,1,1,0.42,0.4242,0.54,0.0,33,288,321,321,2,Siang
11406,2012-04-25,1,4,10,0,3,1,1,0.52,0.5,0.34,0.0,44,138,182,182,2,Siang
11407,2012-04-25,1,4,11,0,3,1,1,0.52,0.5,0.32,0.1343,42,177,219,219,2,Siang
11408,2012-04-25,1,4,12,0,3,1,1,0.54,0.5152,0.28,0.2836,49,220,269,269,2,Siang
11409,2012-04-25,1,4,13,0,3,1,1,0.56,0.5303,0.26,0.2239,35,193,228,228,2,Sore
11410,2012-04-25,1,4,14,0,3,1,1,0.56,0.5303,0.22,0.3582,47,176,223,223,2,Sore
11411,2012-04-25,1,4,15,0,3,1,1,0.58,0.5455,0.19,0.1642,47,182,229,229,2,Sore
11412,2012-04-25,1,4,16,0,3,1,1,0.6,0.5909,0.2,0.3284,49,327,376,376,2,Sore
11413,2012-04-25,1,4,17,0,3,1,1,0.6,0.5909,0.2,0.2985,68,664,732,732,2,Sore
11414,2012-04-25,1,4,18,0,3,1,1,0.6,0.5909,0.2,0.2836,60,649,709,709,2,Sore
11415,2012-04-25,1,4,19,0,3,1,1,0.6,0.5909,0.2,0.194,42,501,543,543,2,Malam
11416,2012-04-25,1,4,20,0,3,1,1,0.56,0.5303,0.22,0.0896,22,358,380,380,2,Malam
11417,2012-04-25,1,4,21,0,3,1,1,0.52,0.5,0.52,0.1343,27,212,239,239,2,Malam
11418,2012-04-25,1,4,22,0,3,1,1,0.5,0.4848,0.51,0.0,22,170,192,192,2,Malam
11419,2012-04-25,1,4,23,0,3,1,2,0.5,0.4848,0.51,0.0896,10,94,104,104,2,Malam
11420,2012-04-26,1,4,0,0,4,1,2,0.48,0.4697,0.63,0.0,1,42,43,43,2,
11421,2012-04-26,1,4,1,0,4,1,2,0.48,0.4697,0.48,0.0896,1,22,23,23,2,Pagi
11422,2012-04-26,1,4,2,0,4,1,2,0.48,0.4697,0.55,0.1045,3,10,13,13,2,Pagi
11423,2012-04-26,1,4,3,0,4,1,2,0.48,0.4697,0.55,0.0896,1,5,6,6,2,Pagi
11424,2012-04-26,1,4,4,0,4,1,2,0.48,0.4697,0.59,0.0896,1,2,3,3,2,Pagi
11425,2012-04-26,1,4,5,0,4,1,2,0.48,0.4697,0.63,0.1343,0,17,17,17,2,Pagi
11426,2012-04-26,1,4,6,0,4,1,2,0.48,0.4697,0.63,0.2537,5,122,127,127,2,Pagi
11427,2012-04-26,1,4,7,0,4,1,3,0.46,0.4545,0.82,0.3582,3,222,225,225,2,Siang
11428,2012-04-26,1,4,8,0,4,1,3,0.46,0.4545,0.82,0.194,4,358,362,362,2,Siang
11429,2012-04-26,1,4,9,0,4,1,3,0.46,0.4545,0.88,0.1642,12,189,201,201,2,Siang
11430,2012-04-26,1,4,10,0,4,1,2,0.46,0.4545,0.94,0.1642,14,125,139,139,2,Siang
11431,2012-04-26,1,4,11,0,4,1,2,0.46,0.4545,0.94,0.2239,16,135,151,151,2,Siang
11432,2012-04-26,1,4,12,0,4,1,2,0.52,0.5,0.83,0.1343,24,180,204,204,2,Siang
11433,2012-04-26,1,4,13,0,4,1,2,0.5,0.4848,0.82,0.1642,19,178,197,197,2,Sore
11434,2012-04-26,1,4,14,0,4,1,2,0.54,0.5152,0.77,0.194,37,132,169,169,2,Sore
11435,2012-04-26,1,4,15,0,4,1,2,0.52,0.5,0.83,0.3284,39,165,204,204,2,Sore
11436,2012-04-26,1,4,16,0,4,1,2,0.52,0.5,0.83,0.2239,37,281,318,318,2,Sore
11437,2012-04-26,1,4,17,0,4,1,1,0.54,0.5152,0.77,0.1642,49,565,614,614,2,Sore
11438,2012-04-26,1,4,18,0,4,1,2,0.54,0.5152,0.77,0.194,75,589,664,664,2,Sore
11439,2012-04-26,1,4,19,0,4,1,2,0.54,0.5152,0.77,0.2239,57,407,464,464,2,Malam
11440,2012-04-26,1,4,20,0,4,1,1,0.54,0.5152,0.77,0.194,23,314,337,337,2,Malam
11441,2012-04-26,1,4,21,0,4,1,1,0.52,0.5,0.83,0.2239,28,222,250,250,2,Malam
11442,2012-04-26,1,4,22,0,4,1,1,0.52,0.5,0.83,0.1642,20,163,183,183,2,Malam
11443,2012-04-26,1,4,23,0,4,1,1,0.5,0.4848,0.88,0.1642,6,106,112,112,2,Malam
11444,2012-04-27,1,4,0,0,5,1,1,0.54,0.5152,0.68,0.5522,12,61,73,73,2,
11445,2012-04-27,1,4,1,0,5,1,1,0.5,0.4848,0.59,0.4478,3,32,35,35,2,Pagi
11446,2012-04-27,1,4,2,0,5,1,1,0.48,0.4697,0.59,0.4179,4,18,22,22,2,Pagi
11447,2012-04-27,1,4,3,0,5,1,1,0.44,0.4394,0.47,0.4925,1,2,3,3,2,Pagi
11448,2012-04-27,1,4,4,0,5,1,1,0.42,0.4242,0.44,0.2537,0,6,6,6,2,Pagi
11449,2012-04-27,1,4,5,0,5,1,1,0.42,0.4242,0.44,0.3582,0,19,19,19,2,Pagi
11450,2012-04-27,1,4,6,0,5,1,1,0.4,0.4091,0.43,0.2537,5,115,120,120,2,Pagi
11451,2012-04-27,1,4,7,0,5,1,1,0.38,0.3939,0.5,0.2836,10,305,315,315,2,Siang
11452,2012-04-27,1,4,8,0,5,1,1,0.4,0.4091,0.5,0.0,17,575,592,592,2,Siang
11453,2012-04-27,1,4,9,0,5,1,1,0.42,0.4242,0.44,0.4925,42,292,334,334,2,Siang
11454,2012-04-27,1,4,10,0,5,1,1,0.44,0.4394,0.38,0.4179,64,172,236,236,2,Siang
11455,2012-04-27,1,4,11,0,5,1,1,0.44,0.4394,0.38,0.3284,47,186,233,233,2,Siang
11456,2012-04-27,1,4,12,0,5,1,1,0.46,0.4545,0.36,0.3582,63,244,307,307,2,Siang
11457,2012-04-27,1,4,13,0,5,1,1,0.46,0.4545,0.33,0.3881,94,212,306,306,2,Sore
11458,2012-04-27,1,4,14,0,5,1,1,0.46,0.4545,0.33,0.3284,94,206,300,300,2,Sore
11459,2012-04-27,1,4,15,0,5,1,1,0.52,0.5,0.29,0.4925,101,223,324,324,2,Sore
11460,2012-04-27,1,4,16,0,5,1,1,0.52,0.5,0.29,0.2537,105,335,440,440,2,Sore
11461,2012-04-27,1,4,17,0,5,1,1,0.54,0.5152,0.24,0.3881,89,613,702,702,2,Sore
11462,2012-04-27,1,4,18,0,5,1,1,0.52,0.5,0.25,0.3582,94,560,654,654,2,Sore
11463,2012-04-27,1,4,19,0,5,1,1,0.5,0.4848,0.27,0.3881,62,379,441,441,2,Malam
11464,2012-04-27,1,4,20,0,5,1,1,0.46,0.4545,0.31,0.2836,49,240,289,289,2,Malam
11465,2012-04-27,1,4,21,0,5,1,1,0.44,0.4394,0.33,0.2985,23,185,208,208,2,Malam
11466,2012-04-27,1,4,22,0,5,1,1,0.42,0.4242,0.38,0.2537,24,134,158,158,2,Malam
11467,2012-04-27,1,4,23,0,5,1,1,0.4,0.4091,0.4,0.2537,11,105,116,116,2,Malam
11468,2012-04-28,1,4,0,0,6,0,1,0.38,0.3939,0.43,0.1642,4,99,103,103,2,
11469,2012-04-28,1,4,1,0,6,0,1,0.36,0.3333,0.5,0.2985,7,60,67,67,2,Pagi
11470,2012-04-28,1,4,2,0,6,0,1,0.36,0.3485,0.43,0.1642,8,49,57,57,2,Pagi
11471,2012-04-28,1,4,3,0,6,0,1,0.34,0.3182,0.49,0.2239,3,23,26,26,2,Pagi
11472,2012-04-28,1,4,4,0,6,0,1,0.34,0.3333,0.49,0.1642,0,2,2,2,2,Pagi
11473,2012-04-28,1,4,5,0,6,0,1,0.34,0.3333,0.46,0.1343,2,3,5,5,2,Pagi
11474,2012-04-28,1,4,6,0,6,0,1,0.34,0.3333,0.49,0.194,10,18,28,28,2,Pagi
11475,2012-04-28,1,4,7,0,6,0,1,0.34,0.3333,0.49,0.1642,10,45,55,55,2,Siang
11476,2012-04-28,1,4,8,0,6,0,1,0.38,0.3939,0.4,0.1343,24,134,158,158,2,Siang
11477,2012-04-28,1,4,9,0,6,0,2,0.38,0.3939,0.37,0.0,45,169,214,214,2,Siang
11478,2012-04-28,1,4,10,0,6,0,2,0.38,0.3939,0.4,0.1642,60,231,291,291,2,Siang
11479,2012-04-28,1,4,11,0,6,0,2,0.38,0.3939,0.4,0.1045,96,262,358,358,2,Siang
11480,2012-04-28,1,4,12,0,6,0,2,0.38,0.3939,0.43,0.0,105,276,381,381,2,Siang
11481,2012-04-28,1,4,13,0,6,0,2,0.4,0.4091,0.37,0.0,120,269,389,389,2,Sore
11482,2012-04-28,1,4,14,0,6,0,1,0.42,0.4242,0.38,0.1045,147,293,440,440,2,Sore
11483,2012-04-28,1,4,15,0,6,0,1,0.42,0.4242,0.41,0.2239,148,260,408,408,2,Sore
11484,2012-04-28,1,4,16,0,6,0,2,0.44,0.4394,0.38,0.194,132,244,376,376,2,Sore
11485,2012-04-28,1,4,17,0,6,0,2,0.42,0.4242,0.41,0.1343,98,224,322,322,2,Sore
11486,2012-04-28,1,4,18,0,6,0,3,0.4,0.4091,0.47,0.0,17,73,90,90,2,Sore
11487,2012-04-28,1,4,19,0,6,0,3,0.36,0.3485,0.71,0.1343,29,110,139,139,2,Malam
11488,2012-04-28,1,4,20,0,6,0,2,0.38,0.3939,0.66,0.0,21,81,102,102,2,Malam
11489,2012-04-28,1,4,21,0,6,0,3,0.36,0.3485,0.71,0.194,12,72,84,84,2,Malam
11490,2012-04-28,1,4,22,0,6,0,2,0.36,0.3485,0.71,0.1343,17,66,83,83,2,Malam
11491,2012-04-28,1,4,23,0,6,0,2,0.38,0.3939,0.76,0.0896,5,37,42,42,2,Malam
11492,2012-04-29,1,4,0,0,0,0,3,0.36,0.3485,0.81,0.1343,0,36,36,36,2,
11493,2012-04-29,1,4,1,0,0,0,2,0.36,0.3485,0.81,0.1343,5,37,42,42,2,Pagi
11494,2012-04-29,1,4,2,0,0,0,2,0.36,0.3636,0.87,0.1045,4,36,40,40,2,Pagi
11495,2012-04-29,1,4,3,0,0,0,2,0.36,0.3485,0.87,0.194,2,14,16,16,2,Pagi
11496,2012-04-29,1,4,4,0,0,0,2,0.36,0.3485,0.87,0.1343,0,4,4,4,2,Pagi
11497,2012-04-29,1,4,5,0,0,0,1,0.34,0.3636,0.87,0.0,0,6,6,6,2,Pagi
11498,2012-04-29,1,4,6,0,0,0,1,0.34,0.3333,0.87,0.1343,1,6,7,7,2,Pagi
11499,2012-04-29,1,4,7,0,0,0,2,0.34,0.3333,0.87,0.1343,7,20,27,27,2,Siang
11500,2012-04-29,1,4,8,0,0,0,1,0.38,0.3939,0.76,0.1343,26,81,107,107,2,Siang
11501,2012-04-29,1,4,9,0,0,0,1,0.4,0.4091,0.71,0.1343,52,133,185,185,2,Siang
11502,2012-04-29,1,4,10,0,0,0,1,0.42,0.4242,0.67,0.0896,127,253,380,380,2,Siang
11503,2012-04-29,1,4,11,0,0,0,1,0.46,0.4545,0.51,0.0,128,283,411,411,2,Siang
11504,2012-04-29,1,4,12,0,0,0,1,0.48,0.4697,0.44,0.1045,223,361,584,584,2,Siang
11505,2012-04-29,1,4,13,0,0,0,1,0.5,0.4848,0.45,0.1045,226,369,595,595,2,Sore
11506,2012-04-29,1,4,14,0,0,0,1,0.54,0.5152,0.34,0.0,281,372,653,653,2,Sore
11507,2012-04-29,1,4,15,0,0,0,1,0.56,0.5303,0.37,0.1343,279,324,603,603,2,Sore
11508,2012-04-29,1,4,16,0,0,0,1,0.6,0.6061,0.28,0.194,240,347,587,587,2,Sore
11509,2012-04-29,1,4,17,0,0,0,1,0.62,0.6061,0.27,0.2985,188,334,522,522,2,Sore
11510,2012-04-29,1,4,18,0,0,0,1,0.6,0.6061,0.26,0.2836,164,323,487,487,2,Sore
11511,2012-04-29,1,4,19,0,0,0,1,0.56,0.5303,0.35,0.1343,128,247,375,375,2,Malam
11512,2012-04-29,1,4,20,0,0,0,1,0.56,0.5303,0.32,0.0896,45,198,243,243,2,Malam
11513,2012-04-29,1,4,21,0,0,0,1,0.52,0.5,0.48,0.1343,65,139,204,204,2,Malam
11514,2012-04-29,1,4,22,0,0,0,1,0.5,0.4848,0.45,0.0,23,85,108,108,2,Malam
11515,2012-04-29,1,4,23,0,0,0,1,0.48,0.4697,0.59,0.0,15,67,82,82,2,Malam
11516,2012-04-30,1,4,0,0,1,1,1,0.44,0.4394,0.72,0.1045,12,36,48,48,2,
11517,2012-04-30,1,4,1,0,1,1,1,0.42,0.4242,0.77,0.0896,9,15,24,24,2,Pagi
11518,2012-04-30,1,4,2,0,1,1,1,0.42,0.4242,0.71,0.1343,3,5,8,8,2,Pagi
11519,2012-04-30,1,4,3,0,1,1,1,0.4,0.4091,0.76,0.1642,0,4,4,4,2,Pagi
11520,2012-04-30,1,4,4,0,1,1,1,0.38,0.3939,0.62,0.2537,0,2,2,2,2,Pagi
11521,2012-04-30,1,4,5,0,1,1,1,0.38,0.3939,0.62,0.2537,1,19,20,20,2,Pagi
11522,2012-04-30,1,4,6,0,1,1,1,0.4,0.4091,0.47,0.194,2,121,123,123,2,Pagi
11523,2012-04-30,1,4,7,0,1,1,1,0.4,0.4091,0.5,0.194,6,343,349,349,2,Siang
11524,2012-04-30,1,4,8,0,1,1,1,0.4,0.4091,0.43,0.194,17,579,596,596,2,Siang
11525,2012-04-30,1,4,9,0,1,1,2,0.4,0.4091,0.43,0.194,29,239,268,268,2,Siang
11526,2012-04-30,1,4,10,0,1,1,2,0.42,0.4242,0.41,0.1642,41,116,157,157,2,Siang
11527,2012-04-30,1,4,11,0,1,1,2,0.44,0.4394,0.44,0.1045,52,111,163,163,2,Siang
11528,2012-04-30,1,4,12,0,1,1,2,0.44,0.4394,0.47,0.1343,45,180,225,225,2,Siang
11529,2012-04-30,1,4,13,0,1,1,2,0.48,0.4697,0.51,0.0896,48,199,247,247,2,Sore
11530,2012-04-30,1,4,14,0,1,1,2,0.5,0.4848,0.55,0.1343,56,162,218,218,2,Sore
11531,2012-04-30,1,4,15,0,1,1,2,0.52,0.5,0.55,0.1045,55,176,231,231,2,Sore
11532,2012-04-30,1,4,16,0,1,1,1,0.56,0.5303,0.6,0.194,44,303,347,347,2,Sore
11533,2012-04-30,1,4,17,0,1,1,1,0.56,0.5303,0.6,0.1642,66,617,683,683,2,Sore
11534,2012-04-30,1,4,18,0,1,1,2,0.56,0.5303,0.6,0.2239,53,611,664,664,2,Sore
11535,2012-04-30,1,4,19,0,1,1,2,0.54,0.5152,0.64,0.2537,51,420,471,471,2,Malam
11536,2012-04-30,1,4,20,0,1,1,2,0.52,0.5,0.59,0.194,28,281,309,309,2,Malam
11537,2012-04-30,1,4,21,0,1,1,2,0.52,0.5,0.59,0.194,26,195,221,221,2,Malam
11538,2012-04-30,1,4,22,0,1,1,2,0.52,0.5,0.55,0.1642,11,123,134,134,2,Malam
11539,2012-04-30,1,4,23,0,1,1,2,0.52,0.5,0.55,0.2239,10,50,60,60,2,Malam
11540,2012-05-01,1,5,0,0,2,1,2,0.5,0.4848,0.59,0.194,7,28,35,35,2,
11541,2012-05-01,1,5,1,0,2,1,2,0.5,0.4848,0.63,0.1343,0,21,21,21,2,Pagi
11542,2012-05-01,1,5,2,0,2,1,2,0.5,0.4848,0.72,0.0896,1,7,8,8,2,Pagi
11543,2012-05-01,1,5,3,0,2,1,2,0.5,0.4848,0.77,0.0,1,2,3,3,2,Pagi
11544,2012-05-01,1,5,4,0,2,1,2,0.52,0.5,0.72,0.0896,1,7,8,8,2,Pagi
11545,2012-05-01,1,5,5,0,2,1,2,0.52,0.5,0.72,0.0896,0,17,17,17,2,Pagi
11546,2012-05-01,1,5,6,0,2,1,3,0.52,0.5,0.77,0.1045,2,24,26,26,2,Pagi
11547,2012-05-01,1,5,7,0,2,1,2,0.5,0.4848,0.94,0.2537,8,161,169,169,2,Siang
11548,2012-05-01,1,5,8,0,2,1,2,0.52,0.5,0.94,0.2836,19,538,557,557,2,Siang
11549,2012-05-01,1,5,9,0,2,1,2,0.54,0.5152,0.88,0.194,18,331,349,349,2,Siang
11550,2012-05-01,1,5,10,0,2,1,1,0.62,0.5909,0.78,0.2537,30,144,174,174,2,Siang
11551,2012-05-01,1,5,11,0,2,1,2,0.66,0.6212,0.65,0.2836,50,179,229,229,2,Siang
11552,2012-05-01,1,5,12,0,2,1,2,0.7,0.6515,0.58,0.2239,41,228,269,269,2,Siang
11553,2012-05-01,1,5,13,0,2,1,2,0.72,0.6667,0.51,0.2239,41,208,249,249,2,Sore
11554,2012-05-01,1,5,14,0,2,1,2,0.74,0.6667,0.48,0.2537,37,167,204,204,2,Sore
11555,2012-05-01,1,5,15,0,2,1,2,0.74,0.6667,0.45,0.2239,48,186,234,234,2,Sore
11556,2012-05-01,1,5,16,0,2,1,1,0.74,0.6667,0.45,0.194,41,313,354,354,2,Sore
11557,2012-05-01,1,5,17,0,2,1,1,0.74,0.6667,0.48,0.0896,65,616,681,681,2,Sore
11558,2012-05-01,1,5,18,0,2,1,1,0.7,0.6515,0.54,0.1343,81,662,743,743,2,Sore
11559,2012-05-01,1,5,19,0,2,1,1,0.7,0.6515,0.54,0.1343,58,429,487,487,2,Malam
11560,2012-05-01,1,5,20,0,2,1,1,0.66,0.6212,0.61,0.1642,36,299,335,335,2,Malam
11561,2012-05-01,1,5,21,0,2,1,1,0.64,0.6061,0.65,0.1343,31,251,282,282,2,Malam
11562,2012-05-01,1,5,22,0,2,1,1,0.64,0.6061,0.65,0.0,21,190,211,211,2,Malam
11563,2012-05-01,1,5,23,0,2,1,1,0.6,0.5758,0.78,0.0,16,79,95,95,2,Malam
11564,2012-05-02,1,5,0,0,3,1,1,0.6,0.5758,0.78,0.1045,4,43,47,47,2,
11565,2012-05-02,1,5,1,0,3,1,1,0.56,0.5303,0.83,0.0,8,7,15,15,2,Pagi
11566,2012-05-02,1,5,2,0,3,1,1,0.56,0.5303,0.83,0.0,7,9,16,16,2,Pagi
11567,2012-05-02,1,5,3,0,3,1,1,0.56,0.5303,0.83,0.0896,0,6,6,6,2,Pagi
11568,2012-05-02,1,5,4,0,3,1,1,0.54,0.5152,0.88,0.0,2,2,4,4,2,Pagi
11569,2012-05-02,1,5,5,0,3,1,1,0.54,0.5152,0.9,0.1343,2,31,33,33,2,Pagi
11570,2012-05-02,1,5,6,0,3,1,3,0.56,0.5303,0.84,0.0,3,117,120,120,2,Pagi
11571,2012-05-02,1,5,7,0,3,1,2,0.54,0.5152,0.88,0.194,14,344,358,358,2,Siang
11572,2012-05-02,1,5,8,0,3,1,2,0.56,0.5303,0.88,0.0,26,640,666,666,2,Siang
11573,2012-05-02,1,5,9,0,3,1,2,0.56,0.5303,0.88,0.0,26,289,315,315,2,Siang
11574,2012-05-02,1,5,10,0,3,1,2,0.58,0.5455,0.83,0.1045,28,147,175,175,2,Siang
11575,2012-05-02,1,5,11,0,3,1,2,0.58,0.5455,0.81,0.1343,39,145,184,184,2,Siang
11576,2012-05-02,1,5,12,0,3,1,2,0.58,0.5455,0.83,0.2239,35,210,245,245,2,Siang
11577,2012-05-02,1,5,13,0,3,1,2,0.58,0.5455,0.78,0.194,49,179,228,228,2,Sore
11578,2012-05-02,1,5,14,0,3,1,1,0.62,0.6061,0.69,0.0896,51,189,240,240,2,Sore
11579,2012-05-02,1,5,15,0,3,1,1,0.64,0.6061,0.65,0.194,52,204,256,256,2,Sore
11580,2012-05-02,1,5,16,0,3,1,1,0.64,0.6061,0.65,0.1642,54,313,367,367,2,Sore
11581,2012-05-02,1,5,17,0,3,1,1,0.6,0.5909,0.73,0.2537,70,659,729,729,2,Sore
11582,2012-05-02,1,5,18,0,3,1,1,0.56,0.5303,0.73,0.2239,43,770,813,813,2,Sore
11583,2012-05-02,1,5,19,0,3,1,1,0.54,0.5152,0.77,0.2537,43,461,504,504,2,Malam
11584,2012-05-02,1,5,20,0,3,1,1,0.52,0.5,0.77,0.2537,42,296,338,338,2,Malam
11585,2012-05-02,1,5,21,0,3,1,1,0.52,0.5,0.77,0.2239,21,218,239,239,2,Malam
11586,2012-05-02,1,5,22,0,3,1,1,0.5,0.4848,0.82,0.2239,27,146,173,173,2,Malam
11587,2012-05-02,1,5,23,0,3,1,2,0.5,0.4848,0.77,0.2537,21,77,98,98,2,Malam
11588,2012-05-03,1,5,0,0,4,1,2,0.48,0.4697,0.82,0.2239,15,75,90,90,2,
11589,2012-05-03,1,5,1,0,4,1,2,0.46,0.4545,0.88,0.1045,9,15,24,24,2,Pagi
11590,2012-05-03,1,5,2,0,4,1,2,0.46,0.4545,0.88,0.1343,4,13,17,17,2,Pagi
11591,2012-05-03,1,5,3,0,4,1,2,0.46,0.4545,0.88,0.0,2,4,6,6,2,Pagi
11592,2012-05-03,1,5,4,0,4,1,2,0.46,0.4545,0.88,0.2537,0,2,2,2,2,Pagi
11593,2012-05-03,1,5,5,0,4,1,2,0.46,0.4545,0.88,0.2537,1,20,21,21,2,Pagi
11594,2012-05-03,1,5,6,0,4,1,2,0.46,0.4545,0.88,0.1642,8,128,136,136,2,Pagi
11595,2012-05-03,1,5,7,0,4,1,3,0.44,0.4394,0.94,0.1045,8,376,384,384,2,Siang
11596,2012-05-03,1,5,8,0,4,1,3,0.46,0.4545,0.88,0.194,19,608,627,627,2,Siang
11597,2012-05-03,1,5,9,0,4,1,2,0.48,0.4697,0.88,0.1045,25,279,304,304,2,Siang
11598,2012-05-03,1,5,10,0,4,1,2,0.52,0.5,0.77,0.0,36,132,168,168,2,Siang
11599,2012-05-03,1,5,11,0,4,1,1,0.54,0.5152,0.77,0.0,34,167,201,201,2,Siang
11600,2012-05-03,1,5,12,0,4,1,1,0.56,0.5303,0.73,0.1343,64,237,301,301,2,Siang
11601,2012-05-03,1,5,13,0,4,1,1,0.6,0.5909,0.69,0.194,48,217,265,265,2,Sore
11602,2012-05-03,1,5,14,0,4,1,1,0.64,0.6061,0.65,0.194,33,171,204,204,2,Sore
11603,2012-05-03,1,5,15,0,4,1,1,0.66,0.6212,0.61,0.194,63,220,283,283,2,Sore
11604,2012-05-03,1,5,16,0,4,1,1,0.68,0.6364,0.57,0.1642,45,325,370,370,2,Sore
11605,2012-05-03,1,5,17,0,4,1,1,0.72,0.6667,0.54,0.1343,87,617,704,704,2,Sore
11606,2012-05-03,1,5,18,0,4,1,1,0.72,0.6667,0.58,0.1343,64,642,706,706,2,Sore
11607,2012-05-03,1,5,19,0,4,1,1,0.7,0.6515,0.61,0.194,55,467,522,522,2,Malam
11608,2012-05-03,1,5,20,0,4,1,1,0.64,0.6061,0.73,0.194,52,368,420,420,2,Malam
11609,2012-05-03,1,5,21,0,4,1,1,0.62,0.5909,0.78,0.1343,42,257,299,299,2,Malam
11610,2012-05-03,1,5,22,0,4,1,1,0.62,0.5909,0.78,0.0,29,217,246,246,2,Malam
11611,2012-05-03,1,5,23,0,4,1,1,0.6,0.5606,0.83,0.0,21,100,121,121,2,Malam
11612,2012-05-04,1,5,0,0,5,1,1,0.6,0.5758,0.78,0.3284,19,70,89,89,2,
11613,2012-05-04,1,5,1,0,5,1,1,0.6,0.5758,0.78,0.1045,15,33,48,48,2,Pagi
11614,2012-05-04,1,5,2,0,5,1,1,0.58,0.5455,0.83,0.1343,0,11,11,11,2,Pagi
11615,2012-05-04,1,5,3,0,5,1,1,0.56,0.5303,0.88,0.2239,0,14,14,14,2,Pagi
11616,2012-05-04,1,5,4,0,5,1,1,0.56,0.5303,0.88,0.194,0,4,4,4,2,Pagi
11617,2012-05-04,1,5,5,0,5,1,1,0.56,0.5303,0.88,0.194,0,24,24,24,2,Pagi
11618,2012-05-04,1,5,6,0,5,1,1,0.54,0.5152,0.94,0.1045,8,127,135,135,2,Pagi
11619,2012-05-04,1,5,7,0,5,1,1,0.56,0.5303,0.88,0.0,9,347,356,356,2,Siang
11620,2012-05-04,1,5,8,0,5,1,1,0.56,0.5303,0.88,0.0,34,584,618,618,2,Siang
11621,2012-05-04,1,5,9,0,5,1,1,0.6,0.5758,0.78,0.0,32,262,294,294,2,Siang
11622,2012-05-04,1,5,10,0,5,1,2,0.62,0.5909,0.73,0.1343,45,154,199,199,2,Siang
11623,2012-05-04,1,5,11,0,5,1,2,0.7,0.6515,0.61,0.0,77,181,258,258,2,Siang
11624,2012-05-04,1,5,12,0,5,1,3,0.62,0.5909,0.78,0.3582,46,125,171,171,2,Siang
11625,2012-05-04,1,5,13,0,5,1,2,0.64,0.6061,0.73,0.0,71,207,278,278,2,Sore
11626,2012-05-04,1,5,14,0,5,1,2,0.66,0.6212,0.74,0.2836,83,159,242,242,2,Sore
11627,2012-05-04,1,5,15,0,5,1,2,0.72,0.6818,0.62,0.1045,103,240,343,343,2,Sore
11628,2012-05-04,1,5,16,0,5,1,1,0.76,0.6818,0.48,0.1642,82,358,440,440,2,Sore
11629,2012-05-04,1,5,17,0,5,1,1,0.7,0.6515,0.54,0.4627,96,547,643,643,2,Sore
11630,2012-05-04,1,5,18,0,5,1,1,0.7,0.6515,0.54,0.4627,77,564,641,641,2,Sore
11631,2012-05-04,1,5,19,0,5,1,1,0.7,0.6515,0.51,0.1343,64,388,452,452,2,Malam
11632,2012-05-04,1,5,20,0,5,1,1,0.68,0.6364,0.51,0.1045,58,255,313,313,2,Malam
11633,2012-05-04,1,5,21,0,5,1,1,0.64,0.6061,0.69,0.194,49,186,235,235,2,Malam
11634,2012-05-04,1,5,22,0,5,1,1,0.6,0.5606,0.83,0.1343,50,182,232,232,2,Malam
11635,2012-05-04,1,5,23,0,5,1,1,0.6,0.5606,0.83,0.0896,51,205,256,256,2,Malam
11636,2012-05-05,1,5,0,0,6,0,1,0.6,0.5606,0.83,0.0,42,111,153,153,2,
11637,2012-05-05,1,5,1,0,6,0,1,0.6,0.5606,0.83,0.0,28,79,107,107,2,Pagi
11638,2012-05-05,1,5,2,0,6,0,1,0.58,0.5455,0.88,0.0,24,51,75,75,2,Pagi
11639,2012-05-05,1,5,3,0,6,0,1,0.58,0.5455,0.83,0.0,11,21,32,32,2,Pagi
11640,2012-05-05,1,5,4,0,6,0,1,0.56,0.5303,0.88,0.1045,0,9,9,9,2,Pagi
11641,2012-05-05,1,5,5,0,6,0,1,0.56,0.5303,0.88,0.0896,8,14,22,22,2,Pagi
11642,2012-05-05,1,5,6,0,6,0,2,0.54,0.5152,0.94,0.0,9,33,42,42,2,Pagi
11643,2012-05-05,1,5,7,0,6,0,1,0.56,0.5303,0.88,0.0,8,79,87,87,2,Siang
11644,2012-05-05,1,5,8,0,6,0,1,0.58,0.5455,0.83,0.0896,42,155,197,197,2,Siang
11645,2012-05-05,1,5,9,0,6,0,1,0.62,0.5909,0.78,0.1045,61,223,284,284,2,Siang
11646,2012-05-05,1,5,10,0,6,0,1,0.66,0.6212,0.65,0.1343,148,284,432,432,2,Siang
11647,2012-05-05,1,5,11,0,6,0,1,0.7,0.6515,0.58,0.0896,221,354,575,575,2,Siang
11648,2012-05-05,1,5,12,0,6,0,1,0.72,0.6667,0.58,0.1045,220,330,550,550,2,Siang
11649,2012-05-05,1,5,13,0,6,0,1,0.74,0.6818,0.55,0.1343,217,307,524,524,2,Sore
11650,2012-05-05,1,5,14,0,6,0,3,0.7,0.6515,0.61,0.2985,187,241,428,428,2,Sore
11651,2012-05-05,1,5,15,0,6,0,3,0.66,0.6212,0.74,0.194,241,300,541,541,2,Sore
11652,2012-05-05,1,5,16,0,6,0,2,0.68,0.6364,0.65,0.3881,230,310,540,540,2,Sore
11653,2012-05-05,1,5,17,0,6,0,2,0.68,0.6364,0.65,0.2985,204,298,502,502,2,Sore
11654,2012-05-05,1,5,18,0,6,0,2,0.66,0.6212,0.69,0.3582,156,278,434,434,2,Sore
11655,2012-05-05,1,5,19,0,6,0,2,0.62,0.5909,0.73,0.3284,151,254,405,405,2,Malam
11656,2012-05-05,1,5,20,0,6,0,1,0.6,0.5758,0.78,0.2537,100,209,309,309,2,Malam
11657,2012-05-05,1,5,21,0,6,0,2,0.58,0.5455,0.78,0.2239,86,183,269,269,2,Malam
11658,2012-05-05,1,5,22,0,6,0,2,0.58,0.5455,0.78,0.194,67,150,217,217,2,Malam
11659,2012-05-05,1,5,23,0,6,0,2,0.56,0.5303,0.83,0.2836,35,114,149,149,2,Malam
11660,2012-05-06,1,5,0,0,0,0,2,0.56,0.5303,0.83,0.1343,23,111,134,134,2,
11661,2012-05-06,1,5,1,0,0,0,2,0.54,0.5152,0.83,0.2239,37,84,121,121,2,Pagi
11662,2012-05-06,1,5,2,0,0,0,2,0.54,0.5152,0.83,0.2836,29,64,93,93,2,Pagi
11663,2012-05-06,1,5,3,0,0,0,2,0.54,0.5152,0.83,0.194,9,19,28,28,2,Pagi
11664,2012-05-06,1,5,4,0,0,0,3,0.52,0.5,0.83,0.1642,9,7,16,16,2,Pagi
11665,2012-05-06,1,5,5,0,0,0,3,0.52,0.5,0.83,0.1642,1,10,11,11,2,Pagi
11666,2012-05-06,1,5,6,0,0,0,3,0.52,0.5,0.83,0.2239,3,14,17,17,2,Pagi
11667,2012-05-06,1,5,7,0,0,0,3,0.52,0.5,0.83,0.1642,5,31,36,36,2,Siang
11668,2012-05-06,1,5,8,0,0,0,2,0.5,0.4848,0.88,0.1343,23,91,114,114,2,Siang
11669,2012-05-06,1,5,9,0,0,0,2,0.52,0.5,0.83,0.1642,63,128,191,191,2,Siang
11670,2012-05-06,1,5,10,0,0,0,2,0.54,0.5152,0.77,0.1045,112,221,333,333,2,Siang
11671,2012-05-06,1,5,11,0,0,0,1,0.56,0.5303,0.73,0.1045,144,270,414,414,2,Siang
11672,2012-05-06,1,5,12,0,0,0,2,0.6,0.6061,0.64,0.0896,207,351,558,558,2,Siang
11673,2012-05-06,1,5,13,0,0,0,2,0.6,0.6061,0.64,0.0,197,368,565,565,2,Sore
11674,2012-05-06,1,5,14,0,0,0,2,0.6,0.6061,0.64,0.1045,226,292,518,518,2,Sore
11675,2012-05-06,1,5,15,0,0,0,2,0.62,0.6061,0.61,0.1045,229,342,571,571,2,Sore
11676,2012-05-06,1,5,16,0,0,0,2,0.62,0.6061,0.61,0.0,181,363,544,544,2,Sore
11677,2012-05-06,1,5,17,0,0,0,2,0.62,0.6061,0.65,0.1343,195,316,511,511,2,Sore
11678,2012-05-06,1,5,18,0,0,0,2,0.62,0.6061,0.61,0.194,131,332,463,463,2,Sore
11679,2012-05-06,1,5,19,0,0,0,2,0.6,0.6061,0.64,0.1642,117,266,383,383,2,Malam
11680,2012-05-06,1,5,20,0,0,0,1,0.6,0.6061,0.64,0.194,73,203,276,276,2,Malam
11681,2012-05-06,1,5,21,0,0,0,1,0.56,0.5303,0.73,0.194,55,148,203,203,2,Malam
11682,2012-05-06,1,5,22,0,0,0,1,0.56,0.5303,0.73,0.1642,44,113,157,157,2,Malam
11683,2012-05-06,1,5,23,0,0,0,1,0.52,0.5,0.77,0.194,22,80,102,102,2,Malam
11684,2012-05-07,1,5,0,0,1,1,2,0.52,0.5,0.77,0.1343,13,21,34,34,2,
11685,2012-05-07,1,5,1,0,1,1,2,0.52,0.5,0.77,0.194,1,8,9,9,2,Pagi
11686,2012-05-07,1,5,2,0,1,1,1,0.5,0.4848,0.77,0.194,1,5,6,6,2,Pagi
11687,2012-05-07,1,5,3,0,1,1,1,0.5,0.4848,0.77,0.194,2,3,5,5,2,Pagi
11688,2012-05-07,1,5,4,0,1,1,2,0.46,0.4545,0.88,0.1343,0,2,2,2,2,Pagi
11689,2012-05-07,1,5,5,0,1,1,1,0.46,0.4545,0.88,0.1045,2,21,23,23,2,Pagi
11690,2012-05-07,1,5,6,0,1,1,1,0.46,0.4545,0.88,0.1045,8,134,142,142,2,Pagi
11691,2012-05-07,1,5,7,0,1,1,2,0.48,0.4697,0.82,0.1045,18,367,385,385,2,Siang
11692,2012-05-07,1,5,8,0,1,1,2,0.5,0.4848,0.82,0.194,31,608,639,639,2,Siang
11693,2012-05-07,1,5,9,0,1,1,2,0.5,0.4848,0.82,0.2239,61,289,350,350,2,Siang
11694,2012-05-07,1,5,10,0,1,1,2,0.52,0.5,0.77,0.194,62,128,190,190,2,Siang
11695,2012-05-07,1,5,11,0,1,1,2,0.54,0.5152,0.73,0.194,64,149,213,213,2,Siang
11696,2012-05-07,1,5,12,0,1,1,2,0.56,0.5303,0.68,0.2239,74,189,263,263,2,Siang
11697,2012-05-07,1,5,13,0,1,1,2,0.6,0.6212,0.53,0.3284,75,197,272,272,2,Sore
11698,2012-05-07,1,5,14,0,1,1,2,0.62,0.6212,0.5,0.3582,59,180,239,239,2,Sore
11699,2012-05-07,1,5,15,0,1,1,2,0.62,0.6212,0.53,0.2985,76,186,262,262,2,Sore
11700,2012-05-07,1,5,16,0,1,1,2,0.6,0.6212,0.53,0.3881,68,320,388,388,2,Sore
11701,2012-05-07,1,5,17,0,1,1,2,0.6,0.6212,0.53,0.3284,102,667,769,769,2,Sore
11702,2012-05-07,1,5,18,0,1,1,2,0.6,0.6212,0.53,0.3582,78,602,680,680,2,Sore
11703,2012-05-07,1,5,19,0,1,1,1,0.58,0.5455,0.56,0.3284,83,463,546,546,2,Malam
11704,2012-05-07,1,5,20,0,1,1,1,0.54,0.5152,0.52,0.2836,46,277,323,323,2,Malam
11705,2012-05-07,1,5,21,0,1,1,2,0.54,0.5152,0.45,0.2239,37,210,247,247,2,Malam
11706,2012-05-07,1,5,22,0,1,1,2,0.54,0.5152,0.45,0.2537,26,147,173,173,2,Malam
11707,2012-05-07,1,5,23,0,1,1,2,0.54,0.5152,0.45,0.194,21,92,113,113,2,Malam
11708,2012-05-08,1,5,0,0,2,1,2,0.52,0.5,0.52,0.2537,10,28,38,38,2,
11709,2012-05-08,1,5,1,0,2,1,2,0.52,0.5,0.59,0.2239,6,3,9,9,2,Pagi
11710,2012-05-08,1,5,2,0,2,1,2,0.52,0.5,0.63,0.2985,9,7,16,16,2,Pagi
11711,2012-05-08,1,5,3,0,2,1,2,0.52,0.5,0.68,0.2836,2,4,6,6,2,Pagi
11712,2012-05-08,1,5,4,0,2,1,2,0.52,0.5,0.68,0.3284,0,5,5,5,2,Pagi
11713,2012-05-08,1,5,5,0,2,1,2,0.52,0.5,0.72,0.2836,0,20,20,20,2,Pagi
11714,2012-05-08,1,5,6,0,2,1,1,0.5,0.4848,0.77,0.2985,7,158,165,165,2,Pagi
11715,2012-05-08,1,5,7,0,2,1,1,0.52,0.5,0.72,0.2836,21,442,463,463,2,Siang
11716,2012-05-08,1,5,8,0,2,1,2,0.54,0.5152,0.73,0.2985,36,605,641,641,2,Siang
11717,2012-05-08,1,5,9,0,2,1,2,0.56,0.5303,0.68,0.3582,37,258,295,295,2,Siang
11718,2012-05-08,1,5,10,0,2,1,2,0.58,0.5455,0.68,0.4179,46,111,157,157,2,Siang
11719,2012-05-08,1,5,11,0,2,1,2,0.6,0.6061,0.64,0.3881,60,157,217,217,2,Siang
11720,2012-05-08,1,5,12,0,2,1,2,0.62,0.6061,0.65,0.3284,60,203,263,263,2,Siang
11721,2012-05-08,1,5,13,0,2,1,3,0.64,0.6061,0.65,0.2537,53,166,219,219,2,Sore
11722,2012-05-08,1,5,14,0,2,1,3,0.62,0.6061,0.69,0.3284,8,63,71,71,2,Sore
11723,2012-05-08,1,5,15,0,2,1,3,0.62,0.5909,0.73,0.2537,40,94,134,134,2,Sore
11724,2012-05-08,1,5,16,0,2,1,3,0.64,0.6061,0.73,0.2239,54,335,389,389,2,Sore
11725,2012-05-08,1,5,17,0,2,1,2,0.64,0.6061,0.69,0.2836,77,640,717,717,2,Sore
11726,2012-05-08,1,5,18,0,2,1,2,0.64,0.6061,0.69,0.2836,69,641,710,710,2,Sore
11727,2012-05-08,1,5,19,0,2,1,2,0.64,0.6061,0.69,0.2836,59,399,458,458,2,Malam
11728,2012-05-08,1,5,20,0,2,1,2,0.64,0.6061,0.69,0.2836,40,262,302,302,2,Malam
11729,2012-05-08,1,5,21,0,2,1,2,0.64,0.6061,0.65,0.2836,21,202,223,223,2,Malam
11730,2012-05-08,1,5,22,0,2,1,3,0.6,0.5758,0.78,0.2537,13,134,147,147,2,Malam
11731,2012-05-08,1,5,23,0,2,1,3,0.6,0.5758,0.78,0.3284,10,53,63,63,2,Malam
11732,2012-05-09,1,5,0,0,3,1,2,0.58,0.5455,0.83,0.194,8,27,35,35,2,
11733,2012-05-09,1,5,1,0,3,1,2,0.6,0.5758,0.78,0.2537,3,11,14,14,2,Pagi
11734,2012-05-09,1,5,2,0,3,1,3,0.56,0.5303,0.88,0.4478,0,1,1,1,2,Pagi
11735,2012-05-09,1,5,3,0,3,1,3,0.56,0.5303,0.88,0.1642,0,2,2,2,2,Pagi
11736,2012-05-09,1,5,4,0,3,1,3,0.56,0.5303,0.88,0.2239,0,5,5,5,2,Pagi
11737,2012-05-09,1,5,5,0,3,1,2,0.56,0.5303,0.88,0.1343,1,27,28,28,2,Pagi
11738,2012-05-09,1,5,6,0,3,1,2,0.56,0.5303,0.88,0.1045,5,121,126,126,2,Pagi
11739,2012-05-09,1,5,7,0,3,1,2,0.56,0.5303,0.94,0.194,17,401,418,418,2,Siang
11740,2012-05-09,1,5,8,0,3,1,2,0.6,0.5606,0.83,0.1343,28,594,622,622,2,Siang
11741,2012-05-09,1,5,9,0,3,1,2,0.6,0.5606,0.83,0.0,40,285,325,325,2,Siang
11742,2012-05-09,1,5,10,0,3,1,2,0.62,0.6061,0.65,0.2537,40,113,153,153,2,Siang
11743,2012-05-09,1,5,11,0,3,1,2,0.62,0.6212,0.59,0.2985,45,156,201,201,2,Siang
11744,2012-05-09,1,5,12,0,3,1,2,0.62,0.6212,0.57,0.2239,58,222,280,280,2,Siang
11745,2012-05-09,1,5,13,0,3,1,2,0.64,0.6212,0.53,0.2537,50,216,266,266,2,Sore
11746,2012-05-09,1,5,14,0,3,1,2,0.64,0.6212,0.53,0.2537,68,175,243,243,2,Sore
11747,2012-05-09,1,5,15,0,3,1,2,0.64,0.6212,0.53,0.1045,68,191,259,259,2,Sore
11748,2012-05-09,1,5,16,0,3,1,2,0.66,0.6212,0.5,0.194,68,289,357,357,2,Sore
11749,2012-05-09,1,5,17,0,3,1,2,0.64,0.6212,0.53,0.1343,76,629,705,705,2,Sore
11750,2012-05-09,1,5,18,0,3,1,3,0.52,0.5,0.77,0.5821,23,349,372,372,2,Sore
11751,2012-05-09,1,5,19,0,3,1,3,0.5,0.4848,0.77,0.3582,2,96,98,98,2,Malam
11752,2012-05-09,1,5,20,0,3,1,3,0.5,0.4848,0.82,0.2239,3,48,51,51,2,Malam
11753,2012-05-09,1,5,21,0,3,1,3,0.5,0.4848,0.82,0.1642,4,30,34,34,2,Malam
11754,2012-05-09,1,5,22,0,3,1,3,0.48,0.4697,0.82,0.1045,5,62,67,67,2,Malam
11755,2012-05-09,1,5,23,0,3,1,3,0.48,0.4697,0.82,0.194,8,47,55,55,2,Malam
11756,2012-05-10,1,5,0,0,4,1,3,0.5,0.4848,0.77,0.1642,2,31,33,33,2,
11757,2012-05-10,1,5,1,0,4,1,2,0.48,0.4697,0.88,0.1343,2,9,11,11,2,Pagi
11758,2012-05-10,1,5,2,0,4,1,2,0.48,0.4697,0.88,0.1045,0,3,3,3,2,Pagi
11759,2012-05-10,1,5,3,0,4,1,1,0.46,0.4545,0.88,0.2239,0,3,3,3,2,Pagi
11760,2012-05-10,1,5,4,0,4,1,1,0.46,0.4545,0.77,0.194,0,2,2,2,2,Pagi
11761,2012-05-10,1,5,5,0,4,1,1,0.46,0.4545,0.72,0.2985,1,23,24,24,2,Pagi
11762,2012-05-10,1,5,6,0,4,1,1,0.44,0.4394,0.72,0.2239,9,130,139,139,2,Pagi
11763,2012-05-10,1,5,7,0,4,1,1,0.44,0.4394,0.72,0.2985,8,393,401,401,2,Siang
11764,2012-05-10,1,5,8,0,4,1,1,0.46,0.4545,0.67,0.3582,27,603,630,630,2,Siang
11765,2012-05-10,1,5,9,0,4,1,1,0.5,0.4848,0.59,0.4627,62,299,361,361,2,Siang
11766,2012-05-10,1,5,10,0,4,1,1,0.5,0.4848,0.51,0.4179,42,112,154,154,2,Siang
11767,2012-05-10,1,5,11,0,4,1,1,0.52,0.5,0.48,0.5224,77,179,256,256,2,Siang
11768,2012-05-10,1,5,12,0,4,1,1,0.52,0.5,0.48,0.4179,65,207,272,272,2,Siang
11769,2012-05-10,1,5,13,0,4,1,1,0.54,0.5152,0.39,0.4478,90,228,318,318,2,Sore
11770,2012-05-10,1,5,14,0,4,1,1,0.56,0.5303,0.37,0.4179,61,186,247,247,2,Sore
11771,2012-05-10,1,5,15,0,4,1,1,0.54,0.5152,0.37,0.3881,79,192,271,271,2,Sore
11772,2012-05-10,1,5,16,0,4,1,1,0.58,0.5455,0.3,0.4627,87,334,421,421,2,Sore
11773,2012-05-10,1,5,17,0,4,1,1,0.6,0.6212,0.31,0.3881,84,648,732,732,2,Sore
11774,2012-05-10,1,5,18,0,4,1,1,0.56,0.5303,0.35,0.5224,109,661,770,770,2,Sore
11775,2012-05-10,1,5,19,0,4,1,1,0.54,0.5152,0.37,0.3582,84,469,553,553,2,Malam
11776,2012-05-10,1,5,20,0,4,1,1,0.52,0.5,0.4,0.3284,59,315,374,374,2,Malam
11777,2012-05-10,1,5,21,0,4,1,1,0.5,0.4848,0.42,0.194,19,211,230,230,2,Malam
11778,2012-05-10,1,5,22,0,4,1,1,0.5,0.4848,0.42,0.1045,36,196,232,232,2,Malam
11779,2012-05-10,1,5,23,0,4,1,1,0.48,0.4697,0.48,0.1045,23,112,135,135,2,Malam
11780,2012-05-11,1,5,0,0,5,1,1,0.46,0.4545,0.55,0.1045,17,47,64,64,2,
11781,2012-05-11,1,5,1,0,5,1,1,0.46,0.4545,0.51,0.1343,14,32,46,46,2,Pagi
11782,2012-05-11,1,5,2,0,5,1,1,0.46,0.4545,0.44,0.1642,15,16,31,31,2,Pagi
11783,2012-05-11,1,5,3,0,5,1,1,0.46,0.4545,0.41,0.2836,5,8,13,13,2,Pagi
11784,2012-05-11,1,5,4,0,5,1,1,0.42,0.4242,0.5,0.194,3,6,9,9,2,Pagi
11785,2012-05-11,1,5,5,0,5,1,1,0.42,0.4242,0.47,0.1642,3,23,26,26,2,Pagi
11786,2012-05-11,1,5,6,0,5,1,1,0.42,0.4242,0.5,0.2537,7,128,135,135,2,Pagi
11787,2012-05-11,1,5,7,0,5,1,1,0.42,0.4242,0.5,0.2537,6,345,351,351,2,Siang
11788,2012-05-11,1,5,8,0,5,1,1,0.46,0.4545,0.44,0.2537,41,579,620,620,2,Siang
11789,2012-05-11,1,5,9,0,5,1,1,0.48,0.4697,0.41,0.2985,34,288,322,322,2,Siang
11790,2012-05-11,1,5,10,0,5,1,1,0.52,0.5,0.36,0.3284,69,141,210,210,2,Siang
11791,2012-05-11,1,5,11,0,5,1,1,0.56,0.5303,0.35,0.2537,88,203,291,291,2,Siang
11792,2012-05-11,1,5,12,0,5,1,1,0.56,0.5303,0.28,0.4179,89,259,348,348,2,Siang
11793,2012-05-11,1,5,13,0,5,1,1,0.6,0.6061,0.26,0.3881,100,263,363,363,2,Sore
11794,2012-05-11,1,5,14,0,5,1,1,0.62,0.6061,0.23,0.2239,116,218,334,334,2,Sore
11795,2012-05-11,1,5,15,0,5,1,1,0.62,0.6061,0.25,0.194,140,299,439,439,2,Sore
11796,2012-05-11,1,5,16,0,5,1,1,0.62,0.6061,0.25,0.3284,128,397,525,525,2,Sore
11797,2012-05-11,1,5,17,0,5,1,1,0.64,0.6061,0.23,0.2537,102,677,779,779,2,Sore
11798,2012-05-11,1,5,18,0,5,1,1,0.64,0.6061,0.23,0.2836,78,518,596,596,2,Sore
11799,2012-05-11,1,5,19,0,5,1,1,0.64,0.6061,0.23,0.2537,73,430,503,503,2,Malam
11800,2012-05-11,1,5,20,0,5,1,1,0.62,0.6061,0.25,0.1343,64,277,341,341,2,Malam
11801,2012-05-11,1,5,21,0,5,1,1,0.6,0.6061,0.28,0.1045,45,225,270,270,2,Malam
11802,2012-05-11,1,5,22,0,5,1,1,0.56,0.5303,0.35,0.2239,44,190,234,234,2,Malam
11803,2012-05-11,1,5,23,0,5,1,1,0.54,0.5152,0.37,0.194,38,142,180,180,2,Malam
11804,2012-05-12,1,5,0,0,6,0,1,0.52,0.5,0.42,0.1642,25,111,136,136,2,
11805,2012-05-12,1,5,1,0,6,0,1,0.5,0.4848,0.48,0.0,14,79,93,93,2,Pagi
11806,2012-05-12,1,5,2,0,6,0,1,0.46,0.4545,0.59,0.1343,10,46,56,56,2,Pagi
11807,2012-05-12,1,5,3,0,6,0,1,0.48,0.4697,0.59,0.0,14,20,34,34,2,Pagi
11808,2012-05-12,1,5,4,0,6,0,1,0.44,0.4394,0.67,0.1045,3,6,9,9,2,Pagi
11809,2012-05-12,1,5,5,0,6,0,1,0.42,0.4242,0.67,0.1343,5,8,13,13,2,Pagi
11810,2012-05-12,1,5,6,0,6,0,1,0.42,0.4242,0.67,0.0896,10,23,33,33,2,Pagi
11811,2012-05-12,1,5,7,0,6,0,1,0.42,0.4242,0.71,0.1343,10,57,67,67,2,Siang
11812,2012-05-12,1,5,8,0,6,0,1,0.52,0.5,0.48,0.0,22,156,178,178,2,Siang
11813,2012-05-12,1,5,9,0,6,0,1,0.54,0.5152,0.49,0.0,87,248,335,335,2,Siang
11814,2012-05-12,1,5,10,0,6,0,1,0.56,0.5303,0.49,0.0896,132,279,411,411,2,Siang
11815,2012-05-12,1,5,11,0,6,0,1,0.62,0.6212,0.41,0.0896,157,365,522,522,2,Siang
11816,2012-05-12,1,5,12,0,6,0,1,0.64,0.6212,0.36,0.1642,206,353,559,559,2,Siang
11817,2012-05-12,1,5,13,0,6,0,1,0.64,0.6212,0.36,0.194,293,366,659,659,2,Sore
11818,2012-05-12,1,5,14,0,6,0,1,0.66,0.6212,0.36,0.194,257,358,615,615,2,Sore
11819,2012-05-12,1,5,15,0,6,0,1,0.68,0.6212,0.24,0.194,269,321,590,590,2,Sore
11820,2012-05-12,1,5,16,0,6,0,2,0.7,0.6364,0.21,0.194,254,337,591,591,2,Sore
11821,2012-05-12,1,5,17,0,6,0,2,0.66,0.6212,0.36,0.194,233,343,576,576,2,Sore
11822,2012-05-12,1,5,18,0,6,0,2,0.66,0.6212,0.31,0.194,164,382,546,546,2,Sore
11823,2012-05-12,1,5,19,0,6,0,2,0.64,0.6212,0.36,0.1642,166,273,439,439,2,Malam
11824,2012-05-12,1,5,20,0,6,0,1,0.62,0.6212,0.46,0.1642,113,174,287,287,2,Malam
11825,2012-05-12,1,5,21,0,6,0,2,0.6,0.6061,0.6,0.1343,74,156,230,230,2,Malam
11826,2012-05-12,1,5,22,0,6,0,1,0.56,0.5303,0.68,0.1343,62,212,274,274,2,Malam
11827,2012-05-12,1,5,23,0,6,0,1,0.58,0.5455,0.56,0.0896,42,134,176,176,2,Malam
11828,2012-05-13,1,5,0,0,0,0,1,0.56,0.5303,0.64,0.1642,19,79,98,98,2,
11829,2012-05-13,1,5,1,0,0,0,2,0.54,0.5152,0.68,0.1343,22,72,94,94,2,Pagi
11830,2012-05-13,1,5,2,0,0,0,2,0.54,0.5152,0.68,0.1642,22,60,82,82,2,Pagi
11831,2012-05-13,1,5,3,0,0,0,2,0.54,0.5152,0.64,0.1343,2,26,28,28,2,Pagi
11832,2012-05-13,1,5,4,0,0,0,2,0.54,0.5152,0.68,0.194,2,7,9,9,2,Pagi
11833,2012-05-13,1,5,5,0,0,0,1,0.52,0.5,0.72,0.194,4,8,12,12,2,Pagi
11834,2012-05-13,1,5,6,0,0,0,1,0.52,0.5,0.68,0.1642,6,15,21,21,2,Pagi
11835,2012-05-13,1,5,7,0,0,0,1,0.52,0.5,0.68,0.1642,18,42,60,60,2,Siang
11836,2012-05-13,1,5,8,0,0,0,1,0.56,0.5303,0.64,0.1642,32,124,156,156,2,Siang
11837,2012-05-13,1,5,9,0,0,0,1,0.6,0.6212,0.56,0.1343,79,143,222,222,2,Siang
11838,2012-05-13,1,5,10,0,0,0,1,0.6,0.6061,0.6,0.2537,128,222,350,350,2,Siang
11839,2012-05-13,1,5,11,0,0,0,1,0.62,0.6212,0.57,0.2537,150,278,428,428,2,Siang
11840,2012-05-13,1,5,12,0,0,0,1,0.64,0.6212,0.57,0.2239,189,342,531,531,2,Siang
11841,2012-05-13,1,5,13,0,0,0,1,0.68,0.6364,0.54,0.2537,255,347,602,602,2,Sore
11842,2012-05-13,1,5,14,0,0,0,1,0.7,0.6515,0.48,0.1343,228,324,552,552,2,Sore
11843,2012-05-13,1,5,15,0,0,0,1,0.72,0.6515,0.45,0.3582,190,309,499,499,2,Sore
11844,2012-05-13,1,5,16,0,0,0,1,0.72,0.6515,0.42,0.2537,225,339,564,564,2,Sore
11845,2012-05-13,1,5,17,0,0,0,1,0.7,0.6364,0.45,0.4179,191,287,478,478,2,Sore
11846,2012-05-13,1,5,18,0,0,0,2,0.68,0.6364,0.44,0.3582,129,260,389,389,2,Sore
11847,2012-05-13,1,5,19,0,0,0,2,0.66,0.6212,0.5,0.4179,107,232,339,339,2,Malam
11848,2012-05-13,1,5,20,0,0,0,2,0.66,0.6212,0.5,0.2836,67,163,230,230,2,Malam
11849,2012-05-13,1,5,21,0,0,0,2,0.64,0.6212,0.53,0.194,48,121,169,169,2,Malam
11850,2012-05-13,1,5,22,0,0,0,2,0.62,0.6061,0.61,0.1642,42,89,131,131,2,Malam
11851,2012-05-13,1,5,23,0,0,0,2,0.62,0.6212,0.57,0.2239,17,57,74,74,2,Malam
11852,2012-05-14,1,5,0,0,1,1,2,0.6,0.6212,0.56,0.2537,21,14,35,35,2,
11853,2012-05-14,1,5,1,0,1,1,2,0.6,0.6061,0.6,0.2836,5,6,11,11,2,Pagi
11854,2012-05-14,1,5,2,0,1,1,1,0.6,0.6061,0.6,0.2985,1,1,2,2,2,Pagi
11855,2012-05-14,1,5,3,0,1,1,2,0.58,0.5455,0.68,0.3284,0,2,2,2,2,Pagi
11856,2012-05-14,1,5,4,0,1,1,2,0.54,0.5152,0.77,0.2239,3,3,6,6,2,Pagi
11857,2012-05-14,1,5,5,0,1,1,2,0.54,0.5152,0.77,0.1642,1,25,26,26,2,Pagi
11858,2012-05-14,1,5,6,0,1,1,3,0.52,0.5,0.94,0.2985,3,62,65,65,2,Pagi
11859,2012-05-14,1,5,7,0,1,1,3,0.52,0.5,0.94,0.194,3,72,75,75,2,Siang
11860,2012-05-14,1,5,8,0,1,1,3,0.54,0.5152,0.88,0.2239,1,155,156,156,2,Siang
11861,2012-05-14,1,5,9,0,1,1,3,0.54,0.5152,0.88,0.2836,5,105,110,110,2,Siang
11862,2012-05-14,1,5,10,0,1,1,3,0.54,0.5152,0.88,0.2537,6,53,59,59,2,Siang
11863,2012-05-14,1,5,11,0,1,1,2,0.56,0.5303,0.83,0.2239,12,67,79,79,2,Siang
11864,2012-05-14,1,5,12,0,1,1,2,0.56,0.5303,0.88,0.2836,53,132,185,185,2,Siang
11865,2012-05-14,1,5,13,0,1,1,2,0.62,0.5909,0.73,0.2239,33,143,176,176,2,Sore
11866,2012-05-14,1,5,14,0,1,1,2,0.62,0.5909,0.73,0.2537,43,128,171,171,2,Sore
11867,2012-05-14,1,5,15,0,1,1,2,0.62,0.5909,0.73,0.1642,40,156,196,196,2,Sore
11868,2012-05-14,1,5,16,0,1,1,3,0.62,0.6061,0.69,0.2836,20,91,111,111,2,Sore
11869,2012-05-14,1,5,17,0,1,1,3,0.56,0.5303,0.88,0.2537,25,204,229,229,2,Sore
11870,2012-05-14,1,5,18,0,1,1,2,0.58,0.5455,0.83,0.0,17,283,300,300,2,Sore
11871,2012-05-14,1,5,19,0,1,1,3,0.58,0.5455,0.88,0.1343,10,294,304,304,2,Malam
11872,2012-05-14,1,5,20,0,1,1,2,0.58,0.5455,0.88,0.194,11,178,189,189,2,Malam
11873,2012-05-14,1,5,21,0,1,1,2,0.58,0.5455,0.83,0.0896,7,145,152,152,2,Malam
11874,2012-05-14,1,5,22,0,1,1,2,0.58,0.5455,0.78,0.0896,11,118,129,129,2,Malam
11875,2012-05-14,1,5,23,0,1,1,2,0.58,0.5455,0.78,0.1045,11,64,75,75,2,Malam
11876,2012-05-15,1,5,0,0,2,1,2,0.56,0.5303,0.88,0.1343,7,25,32,32,2,
11877,2012-05-15,1,5,1,0,2,1,3,0.56,0.5303,0.88,0.1343,5,14,19,19,2,Pagi
11878,2012-05-15,1,5,2,0,2,1,2,0.56,0.5303,0.88,0.1343,1,3,4,4,2,Pagi
11879,2012-05-15,1,5,3,0,2,1,3,0.58,0.5455,0.83,0.1343,1,5,6,6,2,Pagi
11880,2012-05-15,1,5,4,0,2,1,3,0.56,0.5303,0.94,0.0,1,4,5,5,2,Pagi
11881,2012-05-15,1,5,5,0,2,1,3,0.56,0.5303,0.94,0.2239,0,8,8,8,2,Pagi
11882,2012-05-15,1,5,6,0,2,1,3,0.56,0.5303,0.94,0.2239,2,22,24,24,2,Pagi
11883,2012-05-15,1,5,7,0,2,1,3,0.56,0.5303,0.94,0.1343,1,91,92,92,2,Siang
11884,2012-05-15,1,5,8,0,2,1,2,0.58,0.5455,0.88,0.0896,8,401,409,409,2,Siang
11885,2012-05-15,1,5,9,0,2,1,2,0.58,0.5455,0.88,0.0896,28,327,355,355,2,Siang
11886,2012-05-15,1,5,10,0,2,1,1,0.62,0.5909,0.78,0.1045,27,144,171,171,2,Siang
11887,2012-05-15,1,5,11,0,2,1,1,0.64,0.5909,0.78,0.194,38,186,224,224,2,Siang
11888,2012-05-15,1,5,12,0,2,1,1,0.64,0.6061,0.73,0.194,44,220,264,264,2,Siang
11889,2012-05-15,1,5,13,0,2,1,3,0.64,0.6061,0.73,0.194,35,204,239,239,2,Sore
11890,2012-05-15,1,5,14,0,2,1,2,0.64,0.6061,0.73,0.194,39,145,184,184,2,Sore
11891,2012-05-15,1,5,15,0,2,1,2,0.7,0.6515,0.61,0.0896,51,205,256,256,2,Sore
11892,2012-05-15,1,5,16,0,2,1,1,0.68,0.6364,0.65,0.1642,74,300,374,374,2,Sore
11893,2012-05-15,1,5,17,0,2,1,1,0.68,0.6364,0.65,0.1045,75,603,678,678,2,Sore
11894,2012-05-15,1,5,18,0,2,1,1,0.7,0.6515,0.61,0.0896,68,665,733,733,2,Sore
11895,2012-05-15,1,5,19,0,2,1,1,0.66,0.6212,0.69,0.1642,57,455,512,512,2,Malam
11896,2012-05-15,1,5,20,0,2,1,3,0.64,0.6061,0.73,0.1343,30,233,263,263,2,Malam
11897,2012-05-15,1,5,21,0,2,1,3,0.64,0.6061,0.73,0.2836,11,98,109,109,2,Malam
11898,2012-05-15,1,5,22,0,2,1,1,0.58,0.5455,0.78,0.2239,9,74,83,83,2,Malam
11899,2012-05-15,1,5,23,0,2,1,3,0.56,0.5303,0.88,0.1045,13,58,71,71,2,Malam
11900,2012-05-16,1,5,0,0,3,1,2,0.58,0.5455,0.88,0.0,12,27,39,39,2,
11901,2012-05-16,1,5,1,0,3,1,2,0.58,0.5455,0.88,0.1343,7,14,21,21,2,Pagi
11902,2012-05-16,1,5,2,0,3,1,1,0.56,0.5303,0.94,0.194,5,14,19,19,2,Pagi
11903,2012-05-16,1,5,3,0,3,1,1,0.56,0.5303,0.88,0.1045,1,5,6,6,2,Pagi
11904,2012-05-16,1,5,4,0,3,1,1,0.54,0.5152,0.94,0.1343,1,3,4,4,2,Pagi
11905,2012-05-16,1,5,5,0,3,1,1,0.54,0.5152,0.94,0.1045,4,34,38,38,2,Pagi
11906,2012-05-16,1,5,6,0,3,1,1,0.54,0.5152,0.94,0.0896,8,150,158,158,2,Pagi
11907,2012-05-16,1,5,7,0,3,1,1,0.56,0.5303,0.83,0.0,14,426,440,440,2,Siang
11908,2012-05-16,1,5,8,0,3,1,1,0.58,0.5455,0.83,0.0,33,617,650,650,2,Siang
11909,2012-05-16,1,5,9,0,3,1,2,0.6,0.5758,0.78,0.1343,33,314,347,347,2,Siang
11910,2012-05-16,1,5,10,0,3,1,1,0.66,0.6212,0.61,0.0,43,149,192,192,2,Siang
11911,2012-05-16,1,5,11,0,3,1,1,0.7,0.6515,0.54,0.1343,55,212,267,267,2,Siang
11912,2012-05-16,1,5,12,0,3,1,1,0.7,0.6515,0.54,0.194,59,271,330,330,2,Siang
11913,2012-05-16,1,5,13,0,3,1,1,0.72,0.6515,0.42,0.0,77,273,350,350,2,Sore
11914,2012-05-16,1,5,14,0,3,1,1,0.72,0.6515,0.42,0.0896,42,221,263,263,2,Sore
11915,2012-05-16,1,5,15,0,3,1,2,0.72,0.6667,0.48,0.1045,52,222,274,274,2,Sore
11916,2012-05-16,1,5,16,0,3,1,1,0.72,0.6515,0.45,0.1045,70,376,446,446,2,Sore
11917,2012-05-16,1,5,17,0,3,1,1,0.72,0.6667,0.51,0.194,104,769,873,873,2,Sore
11918,2012-05-16,1,5,18,0,3,1,1,0.72,0.6667,0.51,0.2239,97,749,846,846,2,Sore
11919,2012-05-16,1,5,19,0,3,1,1,0.7,0.6515,0.54,0.2836,91,499,590,590,2,Malam
11920,2012-05-16,1,5,20,0,3,1,1,0.66,0.6212,0.65,0.2537,61,398,459,459,2,Malam
11921,2012-05-16,1,5,21,0,3,1,1,0.64,0.6061,0.73,0.194,63,330,393,393,2,Malam
11922,2012-05-16,1,5,22,0,3,1,1,0.64,0.6061,0.73,0.1642,33,253,286,286,2,Malam
11923,2012-05-16,1,5,23,0,3,1,1,0.62,0.5909,0.78,0.1045,26,107,133,133,2,Malam
11924,2012-05-17,1,5,0,0,4,1,1,0.6,0.5758,0.78,0.1343,30,49,79,79,2,
11925,2012-05-17,1,5,1,0,4,1,1,0.6,0.5606,0.83,0.1642,12,16,28,28,2,Pagi
11926,2012-05-17,1,5,2,0,4,1,1,0.6,0.5758,0.78,0.1642,8,8,16,16,2,Pagi
11927,2012-05-17,1,5,3,0,4,1,1,0.6,0.5909,0.73,0.2537,0,3,3,3,2,Pagi
11928,2012-05-17,1,5,4,0,4,1,1,0.6,0.6061,0.64,0.3284,3,13,16,16,2,Pagi
11929,2012-05-17,1,5,5,0,4,1,1,0.56,0.5303,0.68,0.3284,1,34,35,35,2,Pagi
11930,2012-05-17,1,5,6,0,4,1,1,0.54,0.5152,0.73,0.3582,10,149,159,159,2,Pagi
11931,2012-05-17,1,5,7,0,4,1,1,0.54,0.5152,0.73,0.3881,25,449,474,474,2,Siang
11932,2012-05-17,1,5,8,0,4,1,1,0.52,0.5,0.55,0.4478,29,605,634,634,2,Siang
11933,2012-05-17,1,5,9,0,4,1,1,0.54,0.5152,0.52,0.4179,57,289,346,346,2,Siang
11934,2012-05-17,1,5,10,0,4,1,1,0.56,0.5303,0.52,0.2537,43,162,205,205,2,Siang
11935,2012-05-17,1,5,11,0,4,1,1,0.58,0.5455,0.49,0.2239,77,202,279,279,2,Siang
11936,2012-05-17,1,5,12,0,4,1,1,0.6,0.6212,0.43,0.194,72,276,348,348,2,Siang
11937,2012-05-17,1,5,13,0,4,1,1,0.62,0.6212,0.41,0.194,86,241,327,327,2,Sore
11938,2012-05-17,1,5,14,0,4,1,1,0.64,0.6212,0.38,0.194,68,202,270,270,2,Sore
11939,2012-05-17,1,5,15,0,4,1,1,0.64,0.6212,0.36,0.2537,83,233,316,316,2,Sore
11940,2012-05-17,1,5,16,0,4,1,1,0.66,0.6212,0.31,0.194,86,344,430,430,2,Sore
11941,2012-05-17,1,5,17,0,4,1,1,0.66,0.6212,0.31,0.1343,133,719,852,852,2,Sore
11942,2012-05-17,1,5,18,0,4,1,1,0.66,0.6212,0.27,0.1642,134,734,868,868,2,Sore
11943,2012-05-17,1,5,19,0,4,1,1,0.64,0.6212,0.31,0.194,86,451,537,537,2,Malam
11944,2012-05-17,1,5,20,0,4,1,1,0.6,0.6212,0.4,0.194,83,363,446,446,2,Malam
11945,2012-05-17,1,5,21,0,4,1,1,0.58,0.5455,0.4,0.1045,45,254,299,299,2,Malam
11946,2012-05-17,1,5,22,0,4,1,1,0.56,0.5303,0.43,0.0896,42,209,251,251,2,Malam
11947,2012-05-17,1,5,23,0,4,1,1,0.54,0.5152,0.49,0.1343,29,137,166,166,2,Malam
11948,2012-05-18,1,5,0,0,5,1,1,0.52,0.5,0.59,0.1045,13,57,70,70,2,
11949,2012-05-18,1,5,1,0,5,1,1,0.5,0.4848,0.59,0.0896,16,33,49,49,2,Pagi
11950,2012-05-18,1,5,2,0,5,1,1,0.48,0.4697,0.67,0.1343,12,9,21,21,2,Pagi
11951,2012-05-18,1,5,3,0,5,1,1,0.46,0.4545,0.72,0.0896,6,8,14,14,2,Pagi
11952,2012-05-18,1,5,4,0,5,1,1,0.46,0.4545,0.77,0.1642,0,11,11,11,2,Pagi
11953,2012-05-18,1,5,5,0,5,1,1,0.46,0.4545,0.77,0.1045,1,33,34,34,2,Pagi
11954,2012-05-18,1,5,6,0,5,1,1,0.44,0.4394,0.77,0.1343,14,168,182,182,2,Pagi
11955,2012-05-18,1,5,7,0,5,1,1,0.46,0.4545,0.82,0.1045,40,475,515,515,2,Siang
11956,2012-05-18,1,5,8,0,5,1,1,0.52,0.5,0.59,0.1343,49,696,745,745,2,Siang
11957,2012-05-18,1,5,9,0,5,1,1,0.56,0.5303,0.56,0.1045,57,304,361,361,2,Siang
11958,2012-05-18,1,5,10,0,5,1,1,0.6,0.6212,0.46,0.1343,74,181,255,255,2,Siang
11959,2012-05-18,1,5,11,0,5,1,1,0.62,0.6212,0.43,0.0,109,225,334,334,2,Siang
11960,2012-05-18,1,5,12,0,5,1,1,0.62,0.6212,0.41,0.194,108,252,360,360,2,Siang
11961,2012-05-18,1,5,13,0,5,1,1,0.64,0.6212,0.36,0.1642,98,297,395,395,2,Sore
11962,2012-05-18,1,5,14,0,5,1,1,0.66,0.6212,0.34,0.1343,108,242,350,350,2,Sore
11963,2012-05-18,1,5,15,0,5,1,1,0.66,0.6212,0.36,0.194,131,260,391,391,2,Sore
11964,2012-05-18,1,5,16,0,5,1,1,0.66,0.6212,0.34,0.2537,151,417,568,568,2,Sore
11965,2012-05-18,1,5,17,0,5,1,1,0.66,0.6212,0.34,0.1343,124,688,812,812,2,Sore
11966,2012-05-18,1,5,18,0,5,1,1,0.64,0.6212,0.38,0.2239,99,570,669,669,2,Sore
11967,2012-05-18,1,5,19,0,5,1,1,0.62,0.6212,0.41,0.194,91,392,483,483,2,Malam
11968,2012-05-18,1,5,20,0,5,1,1,0.62,0.6212,0.41,0.1642,73,264,337,337,2,Malam
11969,2012-05-18,1,5,21,0,5,1,1,0.6,0.6212,0.4,0.0,49,209,258,258,2,Malam
11970,2012-05-18,1,5,22,0,5,1,1,0.56,0.5303,0.52,0.3284,57,194,251,251,2,Malam
11971,2012-05-18,1,5,23,0,5,1,1,0.52,0.5,0.55,0.0,41,133,174,174,2,Malam
11972,2012-05-19,1,5,0,0,6,0,1,0.52,0.5,0.48,0.1045,30,118,148,148,2,
11973,2012-05-19,1,5,1,0,6,0,1,0.5,0.4848,0.48,0.0,20,84,104,104,2,Pagi
11974,2012-05-19,1,5,2,0,6,0,1,0.5,0.4848,0.51,0.1045,13,56,69,69,2,Pagi
11975,2012-05-19,1,5,3,0,6,0,1,0.5,0.4848,0.48,0.1045,10,23,33,33,2,Pagi
11976,2012-05-19,1,5,4,0,6,0,1,0.48,0.4697,0.59,0.0896,6,8,14,14,2,Pagi
11977,2012-05-19,1,5,5,0,6,0,1,0.46,0.4545,0.67,0.0,1,11,12,12,2,Pagi
11978,2012-05-19,1,5,6,0,6,0,1,0.44,0.4394,0.72,0.0896,12,38,50,50,2,Pagi
11979,2012-05-19,1,5,7,0,6,0,1,0.46,0.4545,0.67,0.1045,28,67,95,95,2,Siang
11980,2012-05-19,1,5,8,0,6,0,1,0.52,0.5,0.52,0.1642,33,162,195,195,2,Siang
11981,2012-05-19,1,5,9,0,6,0,1,0.56,0.5303,0.43,0.1642,79,213,292,292,2,Siang
11982,2012-05-19,1,5,10,0,6,0,1,0.56,0.5303,0.43,0.0,177,275,452,452,2,Siang
11983,2012-05-19,1,5,11,0,6,0,1,0.62,0.6212,0.38,0.0896,235,351,586,586,2,Siang
11984,2012-05-19,1,5,12,0,6,0,1,0.66,0.6212,0.36,0.0,276,366,642,642,2,Siang
11985,2012-05-19,1,5,13,0,6,0,1,0.7,0.6364,0.37,0.1343,332,372,704,704,2,Sore
11986,2012-05-19,1,5,14,0,6,0,1,0.72,0.6515,0.3,0.0896,361,369,730,730,2,Sore
11987,2012-05-19,1,5,15,0,6,0,1,0.72,0.6515,0.3,0.1045,356,316,672,672,2,Sore
11988,2012-05-19,1,5,16,0,6,0,1,0.74,0.6515,0.3,0.1045,331,311,642,642,2,Sore
11989,2012-05-19,1,5,17,0,6,0,1,0.74,0.6515,0.3,0.0896,279,347,626,626,2,Sore
11990,2012-05-19,1,5,18,0,6,0,1,0.74,0.6515,0.33,0.0896,254,391,645,645,2,Sore
11991,2012-05-19,1,5,19,0,6,0,1,0.7,0.6364,0.39,0.1343,203,229,432,432,2,Malam
11992,2012-05-19,1,5,20,0,6,0,1,0.68,0.6364,0.41,0.0896,118,197,315,315,2,Malam
11993,2012-05-19,1,5,21,0,6,0,1,0.64,0.6212,0.5,0.0,81,178,259,259,2,Malam
11994,2012-05-19,1,5,22,0,6,0,1,0.64,0.6212,0.47,0.0,104,234,338,338,2,Malam
11995,2012-05-19,1,5,23,0,6,0,1,0.6,0.6212,0.56,0.1642,71,168,239,239,2,Malam
11996,2012-05-20,1,5,0,0,0,0,1,0.58,0.5455,0.53,0.1045,42,128,170,170,2,
11997,2012-05-20,1,5,1,0,0,0,1,0.56,0.5303,0.52,0.0,28,102,130,130,2,Pagi
11998,2012-05-20,1,5,2,0,0,0,1,0.56,0.5303,0.52,0.0,36,62,98,98,2,Pagi
11999,2012-05-20,1,5,3,0,0,0,1,0.54,0.5152,0.56,0.0896,26,40,66,66,2,Pagi
12000,2012-05-20,1,5,4,0,0,0,1,0.52,0.5,0.68,0.0896,2,14,16,16,2,Pagi
12001,2012-05-20,1,5,5,0,0,0,1,0.5,0.4848,0.72,0.1045,1,7,8,8,2,Pagi
12002,2012-05-20,1,5,6,0,0,0,1,0.5,0.4848,0.63,0.1343,4,21,25,25,2,Pagi
12003,2012-05-20,1,5,7,0,0,0,1,0.52,0.5,0.68,0.194,35,55,90,90,2,Siang
12004,2012-05-20,1,5,8,0,0,0,1,0.56,0.5303,0.56,0.1642,51,120,171,171,2,Siang
12005,2012-05-20,1,5,9,0,0,0,1,0.62,0.6212,0.32,0.2537,129,184,313,313,2,Siang
12006,2012-05-20,1,5,10,0,0,0,1,0.66,0.6212,0.34,0.2985,174,258,432,432,2,Siang
12007,2012-05-20,1,5,11,0,0,0,1,0.66,0.6212,0.36,0.3284,258,323,581,581,2,Siang
12008,2012-05-20,1,5,12,0,0,0,1,0.68,0.6364,0.36,0.3284,247,390,637,637,2,Siang
12009,2012-05-20,1,5,13,0,0,0,1,0.7,0.6364,0.37,0.2836,244,363,607,607,2,Sore
12010,2012-05-20,1,5,14,0,0,0,1,0.72,0.6515,0.39,0.3881,236,307,543,543,2,Sore
12011,2012-05-20,1,5,15,0,0,0,2,0.7,0.6364,0.39,0.4179,246,256,502,502,2,Sore
12012,2012-05-20,1,5,16,0,0,0,1,0.72,0.6515,0.42,0.3582,238,339,577,577,2,Sore
12013,2012-05-20,1,5,17,0,0,0,1,0.72,0.6515,0.45,0.3284,209,340,549,549,2,Sore
12014,2012-05-20,1,5,18,0,0,0,1,0.7,0.6515,0.51,0.3284,146,328,474,474,2,Sore
12015,2012-05-20,1,5,19,0,0,0,1,0.66,0.6212,0.61,0.4179,142,260,402,402,2,Malam
12016,2012-05-20,1,5,20,0,0,0,1,0.66,0.6212,0.61,0.4179,83,191,274,274,2,Malam
12017,2012-05-20,1,5,21,0,0,0,1,0.64,0.6061,0.69,0.3881,51,182,233,233,2,Malam
12018,2012-05-20,1,5,22,0,0,0,1,0.62,0.5909,0.73,0.3284,44,101,145,145,2,Malam
12019,2012-05-20,1,5,23,0,0,0,3,0.6,0.5758,0.78,0.3582,32,54,86,86,2,Malam
12020,2012-05-21,1,5,0,0,1,1,3,0.58,0.5455,0.88,0.2985,12,28,40,40,2,
12021,2012-05-21,1,5,1,0,1,1,3,0.58,0.5455,0.88,0.3582,4,11,15,15,2,Pagi
12022,2012-05-21,1,5,2,0,1,1,3,0.56,0.5303,0.94,0.2537,2,9,11,11,2,Pagi
12023,2012-05-21,1,5,3,0,1,1,2,0.56,0.5303,0.88,0.2985,0,2,2,2,2,Pagi
12024,2012-05-21,1,5,4,0,1,1,3,0.56,0.5303,0.88,0.2985,2,5,7,7,2,Pagi
12025,2012-05-21,1,5,5,0,1,1,3,0.56,0.5303,0.88,0.2985,1,14,15,15,2,Pagi
12026,2012-05-21,1,5,6,0,1,1,3,0.56,0.5303,0.88,0.2985,3,76,79,79,2,Pagi
12027,2012-05-21,1,5,7,0,1,1,3,0.56,0.5303,0.88,0.2985,7,146,153,153,2,Siang
12028,2012-05-21,1,5,8,0,1,1,3,0.56,0.5303,0.88,0.2537,12,258,270,270,2,Siang
12029,2012-05-21,1,5,9,0,1,1,3,0.56,0.5303,0.88,0.2239,14,172,186,186,2,Siang
12030,2012-05-21,1,5,10,0,1,1,3,0.58,0.5455,0.88,0.2836,28,71,99,99,2,Siang
12031,2012-05-21,1,5,11,0,1,1,2,0.6,0.5606,0.83,0.1642,24,82,106,106,2,Siang
12032,2012-05-21,1,5,12,0,1,1,2,0.6,0.5606,0.83,0.2537,46,124,170,170,2,Siang
12033,2012-05-21,1,5,13,0,1,1,3,0.6,0.5606,0.83,0.2537,49,135,184,184,2,Sore
12034,2012-05-21,1,5,14,0,1,1,3,0.6,0.5606,0.83,0.194,45,135,180,180,2,Sore
12035,2012-05-21,1,5,15,0,1,1,2,0.64,0.6061,0.73,0.194,67,158,225,225,2,Sore
12036,2012-05-21,1,5,16,0,1,1,2,0.64,0.6061,0.73,0.2537,46,269,315,315,2,Sore
12037,2012-05-21,1,5,17,0,1,1,2,0.66,0.6212,0.69,0.2537,40,468,508,508,2,Sore
12038,2012-05-21,1,5,18,0,1,1,1,0.64,0.6061,0.73,0.1045,52,478,530,530,2,Sore
12039,2012-05-21,1,5,19,0,1,1,1,0.66,0.6212,0.69,0.0896,57,391,448,448,2,Malam
12040,2012-05-21,1,5,20,0,1,1,1,0.64,0.6061,0.69,0.1343,44,292,336,336,2,Malam
12041,2012-05-21,1,5,21,0,1,1,1,0.62,0.6061,0.69,0.0896,31,210,241,241,2,Malam
12042,2012-05-21,1,5,22,0,1,1,2,0.62,0.5909,0.73,0.1642,26,116,142,142,2,Malam
12043,2012-05-21,1,5,23,0,1,1,1,0.62,0.5909,0.73,0.2836,18,79,97,97,2,Malam
12044,2012-05-22,1,5,0,0,2,1,1,0.58,0.5455,0.83,0.2537,10,26,36,36,2,
12045,2012-05-22,1,5,1,0,2,1,2,0.58,0.5455,0.83,0.1343,11,16,27,27,2,Pagi
12046,2012-05-22,1,5,2,0,2,1,2,0.58,0.5455,0.83,0.1045,1,10,11,11,2,Pagi
12047,2012-05-22,1,5,3,0,2,1,2,0.58,0.5455,0.83,0.1045,0,5,5,5,2,Pagi
12048,2012-05-22,1,5,4,0,2,1,2,0.56,0.5303,0.88,0.1642,0,7,7,7,2,Pagi
12049,2012-05-22,1,5,5,0,2,1,3,0.56,0.5303,0.88,0.194,0,17,17,17,2,Pagi
12050,2012-05-22,1,5,6,0,2,1,3,0.56,0.5303,0.88,0.1045,8,129,137,137,2,Pagi
12051,2012-05-22,1,5,7,0,2,1,3,0.56,0.5303,0.88,0.1045,9,315,324,324,2,Siang
12052,2012-05-22,1,5,8,0,2,1,2,0.56,0.5303,0.88,0.1343,20,570,590,590,2,Siang
12053,2012-05-22,1,5,9,0,2,1,2,0.6,0.5606,0.83,0.1045,46,287,333,333,2,Siang
12054,2012-05-22,1,5,10,0,2,1,2,0.6,0.5758,0.78,0.0896,52,148,200,200,2,Siang
12055,2012-05-22,1,5,11,0,2,1,2,0.6,0.5758,0.78,0.0,39,150,189,189,2,Siang
12056,2012-05-22,1,5,12,0,2,1,2,0.62,0.5909,0.78,0.1045,76,178,254,254,2,Siang
12057,2012-05-22,1,5,13,0,2,1,2,0.64,0.6061,0.73,0.0,48,195,243,243,2,Sore
12058,2012-05-22,1,5,14,0,2,1,2,0.64,0.6061,0.73,0.1045,73,149,222,222,2,Sore
12059,2012-05-22,1,5,15,0,2,1,1,0.7,0.6515,0.61,0.0896,54,191,245,245,2,Sore
12060,2012-05-22,1,5,16,0,2,1,1,0.68,0.6364,0.61,0.1045,70,316,386,386,2,Sore
12061,2012-05-22,1,5,17,0,2,1,1,0.72,0.6667,0.54,0.0,69,716,785,785,2,Sore
12062,2012-05-22,1,5,18,0,2,1,1,0.68,0.6364,0.61,0.1343,76,709,785,785,2,Sore
12063,2012-05-22,1,5,19,0,2,1,1,0.66,0.6212,0.69,0.2239,44,320,364,364,2,Malam
12064,2012-05-22,1,5,20,0,2,1,1,0.64,0.6061,0.73,0.2537,54,319,373,373,2,Malam
12065,2012-05-22,1,5,21,0,2,1,1,0.62,0.5909,0.78,0.1343,28,233,261,261,2,Malam
12066,2012-05-22,1,5,22,0,2,1,1,0.62,0.5909,0.73,0.0896,17,157,174,174,2,Malam
12067,2012-05-22,1,5,23,0,2,1,1,0.62,0.5909,0.73,0.1045,14,91,105,105,2,Malam
12068,2012-05-23,1,5,0,0,3,1,1,0.62,0.5909,0.78,0.1343,19,28,47,47,2,
12069,2012-05-23,1,5,1,0,3,1,1,0.6,0.5606,0.83,0.1642,23,9,32,32,2,Pagi
12070,2012-05-23,1,5,2,0,3,1,2,0.6,0.5606,0.83,0.1642,2,10,12,12,2,Pagi
12071,2012-05-23,1,5,3,0,3,1,1,0.6,0.5758,0.78,0.1045,0,5,5,5,2,Pagi
12072,2012-05-23,1,5,4,0,3,1,3,0.58,0.5455,0.83,0.194,0,3,3,3,2,Pagi
12073,2012-05-23,1,5,5,0,3,1,3,0.56,0.5303,0.88,0.2537,6,29,35,35,2,Pagi
12074,2012-05-23,1,5,6,0,3,1,1,0.56,0.5303,0.88,0.1045,6,154,160,160,2,Pagi
12075,2012-05-23,1,5,7,0,3,1,1,0.58,0.5455,0.83,0.0,16,452,468,468,2,Siang
12076,2012-05-23,1,5,8,0,3,1,1,0.58,0.5455,0.83,0.0,38,681,719,719,2,Siang
12077,2012-05-23,1,5,9,0,3,1,2,0.62,0.5909,0.78,0.0,39,258,297,297,2,Siang
12078,2012-05-23,1,5,10,0,3,1,1,0.62,0.5909,0.78,0.0896,52,139,191,191,2,Siang
12079,2012-05-23,1,5,11,0,3,1,1,0.64,0.6061,0.73,0.0,46,151,197,197,2,Siang
12080,2012-05-23,1,5,12,0,3,1,2,0.66,0.6212,0.69,0.0896,42,206,248,248,2,Siang
12081,2012-05-23,1,5,13,0,3,1,2,0.66,0.6212,0.74,0.1642,69,201,270,270,2,Sore
12082,2012-05-23,1,5,14,0,3,1,1,0.68,0.6364,0.65,0.1343,67,181,248,248,2,Sore
12083,2012-05-23,1,5,15,0,3,1,2,0.7,0.6515,0.61,0.0,65,192,257,257,2,Sore
12084,2012-05-23,1,5,16,0,3,1,3,0.7,0.6515,0.61,0.0896,62,216,278,278,2,Sore
12085,2012-05-23,1,5,17,0,3,1,3,0.64,0.6061,0.69,0.1045,45,240,285,285,2,Sore
12086,2012-05-23,1,5,18,0,3,1,3,0.64,0.6061,0.69,0.1045,31,296,327,327,2,Sore
12087,2012-05-23,1,5,19,0,3,1,2,0.62,0.5758,0.83,0.1642,40,336,376,376,2,Malam
12088,2012-05-23,1,5,20,0,3,1,2,0.62,0.5758,0.83,0.0896,28,267,295,295,2,Malam
12089,2012-05-23,1,5,21,0,3,1,2,0.62,0.5758,0.83,0.0,24,221,245,245,2,Malam
12090,2012-05-23,1,5,22,0,3,1,2,0.62,0.5758,0.83,0.1642,23,136,159,159,2,Malam
12091,2012-05-23,1,5,23,0,3,1,1,0.6,0.5606,0.83,0.1343,23,83,106,106,2,Malam
12092,2012-05-24,1,5,0,0,4,1,1,0.6,0.5606,0.83,0.0896,7,49,56,56,2,
12093,2012-05-24,1,5,1,0,4,1,1,0.6,0.5455,0.88,0.0896,9,21,30,30,2,Pagi
12094,2012-05-24,1,5,2,0,4,1,1,0.6,0.5455,0.88,0.0,1,15,16,16,2,Pagi
12095,2012-05-24,1,5,3,0,4,1,2,0.6,0.5455,0.88,0.1045,1,3,4,4,2,Pagi
12096,2012-05-24,1,5,4,0,4,1,2,0.6,0.5455,0.88,0.1642,0,5,5,5,2,Pagi
12097,2012-05-24,1,5,5,0,4,1,2,0.6,0.5455,0.88,0.1642,1,29,30,30,2,Pagi
12098,2012-05-24,1,5,6,0,4,1,2,0.6,0.5455,0.88,0.1642,10,146,156,156,2,Pagi
12099,2012-05-24,1,5,7,0,4,1,1,0.6,0.5606,0.83,0.1045,22,393,415,415,2,Siang
12100,2012-05-24,1,5,8,0,4,1,1,0.62,0.5909,0.73,0.1343,33,659,692,692,2,Siang
12101,2012-05-24,1,5,9,0,4,1,1,0.62,0.5909,0.73,0.1642,34,267,301,301,2,Siang
12102,2012-05-24,1,5,10,0,4,1,1,0.64,0.6061,0.65,0.1343,47,138,185,185,2,Siang
12103,2012-05-24,1,5,11,0,4,1,1,0.66,0.6212,0.65,0.1343,61,160,221,221,2,Siang
12104,2012-05-24,1,5,12,0,4,1,1,0.7,0.6515,0.58,0.1045,76,213,289,289,2,Siang
12105,2012-05-24,1,5,13,0,4,1,1,0.72,0.6667,0.54,0.1642,69,233,302,302,2,Sore
12106,2012-05-24,1,5,14,0,4,1,1,0.74,0.6818,0.55,0.2239,72,180,252,252,2,Sore
12107,2012-05-24,1,5,15,0,4,1,1,0.74,0.6818,0.55,0.2537,69,222,291,291,2,Sore
12108,2012-05-24,1,5,16,0,4,1,1,0.74,0.6818,0.55,0.3582,61,329,390,390,2,Sore
12109,2012-05-24,1,5,17,0,4,1,1,0.74,0.6818,0.55,0.2836,120,678,798,798,2,Sore
12110,2012-05-24,1,5,18,0,4,1,1,0.72,0.6667,0.54,0.3284,118,634,752,752,2,Sore
12111,2012-05-24,1,5,19,0,4,1,1,0.7,0.6515,0.61,0.2985,76,416,492,492,2,Malam
12112,2012-05-24,1,5,20,0,4,1,2,0.66,0.6212,0.69,0.2836,55,343,398,398,2,Malam
12113,2012-05-24,1,5,21,0,4,1,3,0.64,0.5909,0.78,0.1642,48,237,285,285,2,Malam
12114,2012-05-24,1,5,22,0,4,1,2,0.64,0.5909,0.78,0.1045,33,210,243,243,2,Malam
12115,2012-05-24,1,5,23,0,4,1,2,0.64,0.5909,0.78,0.1343,36,131,167,167,2,Malam
12116,2012-05-25,1,5,0,0,5,1,1,0.62,0.5758,0.83,0.1343,10,63,73,73,2,
12117,2012-05-25,1,5,1,0,5,1,1,0.62,0.5758,0.83,0.0896,8,34,42,42,2,Pagi
12118,2012-05-25,1,5,2,0,5,1,2,0.62,0.5758,0.83,0.0,7,16,23,23,2,Pagi
12119,2012-05-25,1,5,3,0,5,1,2,0.62,0.5606,0.88,0.1045,8,6,14,14,2,Pagi
12120,2012-05-25,1,5,4,0,5,1,2,0.62,0.5606,0.88,0.0,3,6,9,9,2,Pagi
12121,2012-05-25,1,5,5,0,5,1,2,0.62,0.5606,0.88,0.0896,2,28,30,30,2,Pagi
12122,2012-05-25,1,5,6,0,5,1,2,0.62,0.5606,0.88,0.1045,5,108,113,113,2,Pagi
12123,2012-05-25,1,5,7,0,5,1,2,0.62,0.5606,0.88,0.1642,7,352,359,359,2,Siang
12124,2012-05-25,1,5,8,0,5,1,2,0.64,0.5758,0.89,0.1045,32,551,583,583,2,Siang
12125,2012-05-25,1,5,9,0,5,1,2,0.64,0.5758,0.89,0.1343,52,288,340,340,2,Siang
12126,2012-05-25,1,5,10,0,5,1,1,0.68,0.6364,0.79,0.1642,69,163,232,232,2,Siang
12127,2012-05-25,1,5,11,0,5,1,1,0.68,0.6364,0.79,0.1343,90,193,283,283,2,Siang
12128,2012-05-25,1,5,12,0,5,1,1,0.72,0.6818,0.66,0.1045,84,237,321,321,2,Siang
12129,2012-05-25,1,5,13,0,5,1,1,0.74,0.6818,0.62,0.1343,86,247,333,333,2,Sore
12130,2012-05-25,1,5,14,0,5,1,1,0.74,0.6818,0.58,0.1343,104,263,367,367,2,Sore
12131,2012-05-25,1,5,15,0,5,1,1,0.76,0.7121,0.62,0.194,106,360,466,466,2,Sore
12132,2012-05-25,1,5,16,0,5,1,1,0.78,0.7121,0.52,0.2239,137,447,584,584,2,Sore
12133,2012-05-25,1,5,17,0,5,1,1,0.76,0.7121,0.62,0.2836,124,529,653,653,2,Sore
12134,2012-05-25,1,5,18,0,5,1,1,0.76,0.7121,0.62,0.194,131,391,522,522,2,Sore
12135,2012-05-25,1,5,19,0,5,1,1,0.74,0.6818,0.62,0.2537,111,293,404,404,2,Malam
12136,2012-05-25,1,5,20,0,5,1,1,0.7,0.6515,0.65,0.1642,80,270,350,350,2,Malam
12137,2012-05-25,1,5,21,0,5,1,1,0.7,0.6515,0.65,0.1343,62,193,255,255,2,Malam
12138,2012-05-25,1,5,22,0,5,1,1,0.66,0.6212,0.74,0.1045,65,147,212,212,2,Malam
12139,2012-05-25,1,5,23,0,5,1,1,0.66,0.6061,0.78,0.2239,34,132,166,166,2,Malam
12140,2012-05-26,1,5,0,0,6,0,1,0.64,0.5758,0.83,0.1642,18,98,116,116,2,
12141,2012-05-26,1,5,1,0,6,0,1,0.64,0.5758,0.83,0.1343,18,64,82,82,2,Pagi
12142,2012-05-26,1,5,2,0,6,0,1,0.64,0.5758,0.89,0.1343,9,55,64,64,2,Pagi
12143,2012-05-26,1,5,3,0,6,0,1,0.62,0.5606,0.88,0.1045,9,22,31,31,2,Pagi
12144,2012-05-26,1,5,4,0,6,0,1,0.62,0.5606,0.88,0.1343,0,2,2,2,2,Pagi
12145,2012-05-26,1,5,5,0,6,0,1,0.62,0.5758,0.83,0.2537,0,10,10,10,2,Pagi
12146,2012-05-26,1,5,6,0,6,0,1,0.62,0.5606,0.88,0.194,6,25,31,31,2,Pagi
12147,2012-05-26,1,5,7,0,6,0,2,0.62,0.5606,0.88,0.1642,10,44,54,54,2,Siang
12148,2012-05-26,1,5,8,0,6,0,1,0.64,0.5909,0.78,0.1343,38,103,141,141,2,Siang
12149,2012-05-26,1,5,9,0,6,0,1,0.64,0.5758,0.83,0.194,97,192,289,289,2,Siang
12150,2012-05-26,1,5,10,0,6,0,1,0.68,0.6364,0.79,0.2239,181,256,437,437,2,Siang
12151,2012-05-26,1,5,11,0,6,0,1,0.7,0.6667,0.74,0.194,208,312,520,520,2,Siang
12152,2012-05-26,1,5,12,0,6,0,1,0.74,0.697,0.66,0.2239,236,293,529,529,2,Siang
12153,2012-05-26,1,5,13,0,6,0,1,0.76,0.7273,0.66,0.194,265,274,539,539,2,Sore
12154,2012-05-26,1,5,14,0,6,0,1,0.76,0.7273,0.66,0.2239,307,257,564,564,2,Sore
12155,2012-05-26,1,5,15,0,6,0,1,0.76,0.7273,0.66,0.2836,274,239,513,513,2,Sore
12156,2012-05-26,1,5,16,0,6,0,1,0.78,0.7273,0.55,0.2537,261,243,504,504,2,Sore
12157,2012-05-26,1,5,17,0,6,0,2,0.78,0.7121,0.52,0.2537,235,227,462,462,2,Sore
12158,2012-05-26,1,5,18,0,6,0,2,0.76,0.697,0.52,0.194,199,216,415,415,2,Sore
12159,2012-05-26,1,5,19,0,6,0,2,0.74,0.697,0.66,0.2239,159,214,373,373,2,Malam
12160,2012-05-26,1,5,20,0,6,0,2,0.74,0.6818,0.55,0.194,103,152,255,255,2,Malam
12161,2012-05-26,1,5,21,0,6,0,2,0.72,0.6818,0.62,0.194,100,151,251,251,2,Malam
12162,2012-05-26,1,5,22,0,6,0,1,0.7,0.6667,0.74,0.2537,86,118,204,204,2,Malam
12163,2012-05-26,1,5,23,0,6,0,1,0.7,0.6667,0.74,0.2537,36,114,150,150,2,Malam
12164,2012-05-27,1,5,0,0,0,0,2,0.68,0.6364,0.69,0.1642,48,89,137,137,2,
12165,2012-05-27,1,5,1,0,0,0,1,0.66,0.6212,0.74,0.2239,17,61,78,78,2,Pagi
12166,2012-05-27,1,5,2,0,0,0,1,0.64,0.6061,0.73,0.2239,16,45,61,61,2,Pagi
12167,2012-05-27,1,5,3,0,0,0,1,0.64,0.6061,0.73,0.1642,11,25,36,36,2,Pagi
12168,2012-05-27,1,5,4,0,0,0,1,0.62,0.5758,0.83,0.194,4,7,11,11,2,Pagi
12169,2012-05-27,1,5,5,0,0,0,1,0.62,0.5758,0.83,0.194,2,5,7,7,2,Pagi
12170,2012-05-27,1,5,6,0,0,0,1,0.62,0.5758,0.83,0.1642,8,14,22,22,2,Pagi
12171,2012-05-27,1,5,7,0,0,0,1,0.62,0.5606,0.88,0.1642,22,30,52,52,2,Siang
12172,2012-05-27,1,5,8,0,0,0,1,0.64,0.5758,0.83,0.194,69,82,151,151,2,Siang
12173,2012-05-27,1,5,9,0,0,0,1,0.66,0.6061,0.83,0.2239,130,140,270,270,2,Siang
12174,2012-05-27,1,5,10,0,0,0,1,0.68,0.6364,0.74,0.2537,209,215,424,424,2,Siang
12175,2012-05-27,1,5,11,0,0,0,1,0.72,0.6818,0.66,0.2239,268,251,519,519,2,Siang
12176,2012-05-27,1,5,12,0,0,0,1,0.74,0.697,0.66,0.2537,301,269,570,570,2,Siang
12177,2012-05-27,1,5,13,0,0,0,1,0.76,0.7121,0.58,0.194,270,228,498,498,2,Sore
12178,2012-05-27,1,5,14,0,0,0,1,0.76,0.7121,0.58,0.2537,317,230,547,547,2,Sore
12179,2012-05-27,1,5,15,0,0,0,1,0.78,0.7121,0.52,0.2836,290,245,535,535,2,Sore
12180,2012-05-27,1,5,16,0,0,0,1,0.78,0.7121,0.52,0.2836,258,243,501,501,2,Sore
12181,2012-05-27,1,5,17,0,0,0,1,0.78,0.7121,0.49,0.2985,275,247,522,522,2,Sore
12182,2012-05-27,1,5,18,0,0,0,1,0.76,0.7121,0.58,0.2985,266,252,518,518,2,Sore
12183,2012-05-27,1,5,19,0,0,0,1,0.76,0.7121,0.58,0.194,230,212,442,442,2,Malam
12184,2012-05-27,1,5,20,0,0,0,1,0.74,0.6818,0.55,0.1642,168,224,392,392,2,Malam
12185,2012-05-27,1,5,21,0,0,0,3,0.66,0.6212,0.69,0.4179,64,79,143,143,2,Malam
12186,2012-05-27,1,5,22,0,0,0,3,0.62,0.5758,0.83,0.0,9,50,59,59,2,Malam
12187,2012-05-27,1,5,23,0,0,0,3,0.62,0.5758,0.83,0.1343,31,65,96,96,2,Malam
12188,2012-05-28,1,5,0,1,1,0,1,0.62,0.5758,0.83,0.2239,21,44,65,65,2,
12189,2012-05-28,1,5,1,1,1,0,2,0.62,0.5909,0.78,0.2985,14,45,59,59,2,Pagi
12190,2012-05-28,1,5,2,1,1,0,1,0.6,0.5606,0.83,0.2239,20,28,48,48,2,Pagi
12191,2012-05-28,1,5,3,1,1,0,1,0.62,0.5909,0.73,0.1642,6,12,18,18,2,Pagi
12192,2012-05-28,1,5,4,1,1,0,1,0.6,0.5758,0.78,0.1343,2,4,6,6,2,Pagi
12193,2012-05-28,1,5,5,1,1,0,1,0.6,0.5758,0.78,0.1343,4,5,9,9,2,Pagi
12194,2012-05-28,1,5,6,1,1,0,1,0.62,0.5909,0.73,0.1642,6,14,20,20,2,Pagi
12195,2012-05-28,1,5,7,1,1,0,1,0.62,0.5909,0.78,0.1045,24,43,67,67,2,Siang
12196,2012-05-28,1,5,8,1,1,0,1,0.66,0.6212,0.69,0.0,62,93,155,155,2,Siang
12197,2012-05-28,1,5,9,1,1,0,1,0.7,0.6515,0.61,0.0,121,142,263,263,2,Siang
12198,2012-05-28,1,5,10,1,1,0,1,0.7,0.6515,0.61,0.0,189,175,364,364,2,Siang
12199,2012-05-28,1,5,11,1,1,0,1,0.72,0.6818,0.66,0.1343,254,222,476,476,2,Siang
12200,2012-05-28,1,5,12,1,1,0,1,0.76,0.7121,0.62,0.1343,233,292,525,525,2,Siang
12201,2012-05-28,1,5,13,1,1,0,1,0.8,0.7879,0.63,0.2836,272,284,556,556,2,Sore
12202,2012-05-28,1,5,14,1,1,0,1,0.8,0.7879,0.63,0.2836,238,227,465,465,2,Sore
12203,2012-05-28,1,5,15,1,1,0,1,0.82,0.7879,0.56,0.2985,181,279,460,460,2,Sore
12204,2012-05-28,1,5,16,1,1,0,1,0.82,0.7879,0.56,0.3284,223,278,501,501,2,Sore
12205,2012-05-28,1,5,17,1,1,0,1,0.82,0.7879,0.56,0.2985,158,247,405,405,2,Sore
12206,2012-05-28,1,5,18,1,1,0,1,0.8,0.7727,0.59,0.2985,132,251,383,383,2,Sore
12207,2012-05-28,1,5,19,1,1,0,1,0.8,0.7576,0.55,0.2985,148,247,395,395,2,Malam
12208,2012-05-28,1,5,20,1,1,0,1,0.78,0.7424,0.62,0.2985,114,203,317,317,2,Malam
12209,2012-05-28,1,5,21,1,1,0,1,0.76,0.7273,0.66,0.2836,66,181,247,247,2,Malam
12210,2012-05-28,1,5,22,1,1,0,1,0.74,0.697,0.7,0.1642,47,110,157,157,2,Malam
12211,2012-05-28,1,5,23,1,1,0,1,0.72,0.697,0.74,0.1642,22,60,82,82,2,Malam
12212,2012-05-29,1,5,0,0,2,1,1,0.7,0.6667,0.79,0.194,12,33,45,45,2,
12213,2012-05-29,1,5,1,0,2,1,1,0.7,0.6667,0.79,0.194,1,13,14,14,2,Pagi
12214,2012-05-29,1,5,2,0,2,1,1,0.68,0.6364,0.83,0.1343,0,8,8,8,2,Pagi
12215,2012-05-29,1,5,3,0,2,1,1,0.68,0.6364,0.79,0.2836,1,2,3,3,2,Pagi
12216,2012-05-29,1,5,4,0,2,1,1,0.66,0.6061,0.78,0.2239,0,5,5,5,2,Pagi
12217,2012-05-29,1,5,5,0,2,1,1,0.66,0.6061,0.78,0.2239,1,32,33,33,2,Pagi
12218,2012-05-29,1,5,6,0,2,1,1,0.66,0.6061,0.78,0.2239,9,145,154,154,2,Pagi
12219,2012-05-29,1,5,7,0,2,1,1,0.66,0.6061,0.78,0.2239,19,431,450,450,2,Siang
12220,2012-05-29,1,5,8,0,2,1,1,0.7,0.6667,0.74,0.194,46,588,634,634,2,Siang
12221,2012-05-29,1,5,9,0,2,1,1,0.72,0.6818,0.7,0.2537,26,231,257,257,2,Siang
12222,2012-05-29,1,5,10,0,2,1,1,0.74,0.697,0.7,0.2985,67,116,183,183,2,Siang
12223,2012-05-29,1,5,11,0,2,1,1,0.76,0.7121,0.62,0.2985,50,147,197,197,2,Siang
12224,2012-05-29,1,5,12,0,2,1,1,0.8,0.7576,0.55,0.3284,56,181,237,237,2,Siang
12225,2012-05-29,1,5,13,0,2,1,1,0.82,0.7727,0.52,0.3881,63,176,239,239,2,Sore
12226,2012-05-29,1,5,14,0,2,1,1,0.82,0.7727,0.52,0.4179,80,158,238,238,2,Sore
12227,2012-05-29,1,5,15,0,2,1,1,0.82,0.7727,0.49,0.3881,71,185,256,256,2,Sore
12228,2012-05-29,1,5,16,0,2,1,1,0.82,0.7727,0.49,0.4925,73,320,393,393,2,Sore
12229,2012-05-29,1,5,17,0,2,1,1,0.82,0.7576,0.46,0.4179,107,674,781,781,2,Sore
12230,2012-05-29,1,5,18,0,2,1,1,0.8,0.7424,0.49,0.4925,78,632,710,710,2,Sore
12231,2012-05-29,1,5,19,0,2,1,1,0.78,0.7121,0.52,0.3582,69,457,526,526,2,Malam
12232,2012-05-29,1,5,20,0,2,1,3,0.7,0.6515,0.61,0.5224,36,168,204,204,2,Malam
12233,2012-05-29,1,5,21,0,2,1,3,0.6,0.5455,0.88,0.4478,3,68,71,71,2,Malam
12234,2012-05-29,1,5,22,0,2,1,2,0.62,0.5606,0.88,0.0896,2,53,55,55,2,Malam
12235,2012-05-29,1,5,23,0,2,1,3,0.62,0.5455,0.94,0.0,10,40,50,50,2,Malam
12236,2012-05-30,1,5,0,0,3,1,3,0.64,0.5758,0.89,0.1045,4,32,36,36,2,
12237,2012-05-30,1,5,1,0,3,1,3,0.64,0.5758,0.89,0.194,0,4,4,4,2,Pagi
12238,2012-05-30,1,5,2,0,3,1,3,0.62,0.5455,0.94,0.0896,1,4,5,5,2,Pagi
12239,2012-05-30,1,5,3,0,3,1,3,0.62,0.5606,0.88,0.1343,0,5,5,5,2,Pagi
12240,2012-05-30,1,5,4,0,3,1,2,0.62,0.5606,0.88,0.1343,0,6,6,6,2,Pagi
12241,2012-05-30,1,5,5,0,3,1,2,0.62,0.5909,0.78,0.1343,1,40,41,41,2,Pagi
12242,2012-05-30,1,5,6,0,3,1,2,0.6,0.5758,0.78,0.1045,5,139,144,144,2,Pagi
12243,2012-05-30,1,5,7,0,3,1,3,0.6,0.5758,0.78,0.194,14,469,483,483,2,Siang
12244,2012-05-30,1,5,8,0,3,1,2,0.6,0.5909,0.73,0.1642,29,642,671,671,2,Siang
12245,2012-05-30,1,5,9,0,3,1,2,0.62,0.6061,0.69,0.194,23,282,305,305,2,Siang
12246,2012-05-30,1,5,10,0,3,1,2,0.62,0.6061,0.69,0.2836,39,138,177,177,2,Siang
12247,2012-05-30,1,5,11,0,3,1,2,0.66,0.6212,0.65,0.194,53,155,208,208,2,Siang
12248,2012-05-30,1,5,12,0,3,1,1,0.7,0.6515,0.54,0.0,33,220,253,253,2,Siang
12249,2012-05-30,1,5,13,0,3,1,1,0.7,0.6515,0.51,0.0,53,236,289,289,2,Sore
12250,2012-05-30,1,5,14,0,3,1,1,0.72,0.6515,0.42,0.1343,44,208,252,252,2,Sore
12251,2012-05-30,1,5,15,0,3,1,1,0.72,0.6667,0.51,0.1343,54,221,275,275,2,Sore
12252,2012-05-30,1,5,16,0,3,1,1,0.72,0.6667,0.51,0.1642,46,352,398,398,2,Sore
12253,2012-05-30,1,5,17,0,3,1,1,0.74,0.6667,0.48,0.0896,83,756,839,839,2,Sore
12254,2012-05-30,1,5,18,0,3,1,1,0.74,0.6667,0.48,0.1642,50,746,796,796,2,Sore
12255,2012-05-30,1,5,19,0,3,1,1,0.72,0.6667,0.54,0.1642,50,506,556,556,2,Malam
12256,2012-05-30,1,5,20,0,3,1,2,0.54,0.5152,0.6,0.1343,57,374,431,431,2,Malam
12257,2012-05-30,1,5,21,0,3,1,1,0.68,0.6364,0.57,0.1045,41,263,304,304,2,Malam
12258,2012-05-30,1,5,22,0,3,1,1,0.66,0.6212,0.69,0.1045,26,191,217,217,2,Malam
12259,2012-05-30,1,5,23,0,3,1,1,0.66,0.6212,0.65,0.1045,39,121,160,160,2,Malam
12260,2012-05-31,1,5,0,0,4,1,1,0.64,0.6061,0.69,0.1343,13,48,61,61,2,
12261,2012-05-31,1,5,1,0,4,1,1,0.64,0.6061,0.69,0.0896,4,22,26,26,2,Pagi
12262,2012-05-31,1,5,2,0,4,1,1,0.64,0.6061,0.65,0.0896,6,8,14,14,2,Pagi
12263,2012-05-31,1,5,3,0,4,1,1,0.62,0.6061,0.69,0.0896,0,8,8,8,2,Pagi
12264,2012-05-31,1,5,4,0,4,1,1,0.62,0.6061,0.69,0.0,0,8,8,8,2,Pagi
12265,2012-05-31,1,5,5,0,4,1,1,0.62,0.6061,0.69,0.2537,1,32,33,33,2,Pagi
12266,2012-05-31,1,5,6,0,4,1,1,0.6,0.5909,0.73,0.2239,7,171,178,178,2,Pagi
12267,2012-05-31,1,5,7,0,4,1,1,0.6,0.6061,0.64,0.2836,18,489,507,507,2,Siang
12268,2012-05-31,1,5,8,0,4,1,1,0.62,0.6212,0.57,0.2537,18,675,693,693,2,Siang
12269,2012-05-31,1,5,9,0,4,1,1,0.66,0.6212,0.47,0.2537,47,264,311,311,2,Siang
12270,2012-05-31,1,5,10,0,4,1,1,0.7,0.6364,0.39,0.3881,65,155,220,220,2,Siang
12271,2012-05-31,1,5,11,0,4,1,1,0.72,0.6515,0.37,0.2836,65,153,218,218,2,Siang
12272,2012-05-31,1,5,12,0,4,1,1,0.72,0.6515,0.37,0.194,62,230,292,292,2,Siang
12273,2012-05-31,1,5,13,0,4,1,1,0.74,0.6515,0.35,0.1343,77,216,293,293,2,Sore
12274,2012-05-31,1,5,14,0,4,1,1,0.76,0.6667,0.31,0.194,61,193,254,254,2,Sore
12275,2012-05-31,1,5,15,0,4,1,1,0.76,0.6667,0.33,0.2985,81,209,290,290,2,Sore
12276,2012-05-31,1,5,16,0,4,1,1,0.76,0.6667,0.33,0.2836,103,384,487,487,2,Sore
12277,2012-05-31,1,5,17,0,4,1,1,0.76,0.6667,0.31,0.1642,85,742,827,827,2,Sore
12278,2012-05-31,1,5,18,0,4,1,1,0.74,0.6515,0.3,0.194,85,700,785,785,2,Sore
12279,2012-05-31,1,5,19,0,4,1,1,0.72,0.6515,0.34,0.1642,104,487,591,591,2,Malam
12280,2012-05-31,1,5,20,0,4,1,1,0.68,0.6364,0.44,0.1642,88,391,479,479,2,Malam
12281,2012-05-31,1,5,21,0,4,1,1,0.68,0.6364,0.44,0.1642,41,318,359,359,2,Malam
12282,2012-05-31,1,5,22,0,4,1,1,0.66,0.6212,0.5,0.1642,43,221,264,264,2,Malam
12283,2012-05-31,1,5,23,0,4,1,1,0.66,0.6212,0.54,0.2239,26,114,140,140,2,Malam
12284,2012-06-01,1,6,0,0,5,1,1,0.66,0.6212,0.5,0.2537,10,76,86,86,2,
12285,2012-06-01,1,6,1,0,5,1,1,0.64,0.6212,0.53,0.2239,0,34,34,34,2,Pagi
12286,2012-06-01,1,6,2,0,5,1,1,0.64,0.6212,0.57,0.2239,3,13,16,16,2,Pagi
12287,2012-06-01,1,6,3,0,5,1,2,0.62,0.5909,0.73,0.0896,0,4,4,4,2,Pagi
12288,2012-06-01,1,6,4,0,5,1,2,0.62,0.5909,0.73,0.0896,1,5,6,6,2,Pagi
12289,2012-06-01,1,6,5,0,5,1,2,0.62,0.5909,0.78,0.0896,4,41,45,45,2,Pagi
12290,2012-06-01,1,6,6,0,5,1,3,0.62,0.5606,0.88,0.1343,5,136,141,141,2,Pagi
12291,2012-06-01,1,6,7,0,5,1,2,0.64,0.5758,0.89,0.194,33,369,402,402,2,Siang
12292,2012-06-01,1,6,8,0,5,1,2,0.64,0.5758,0.89,0.194,19,675,694,694,2,Siang
12293,2012-06-01,1,6,9,0,5,1,2,0.64,0.5758,0.83,0.2239,24,274,298,298,2,Siang
12294,2012-06-01,1,6,10,0,5,1,2,0.66,0.6061,0.78,0.2836,49,155,204,204,2,Siang
12295,2012-06-01,1,6,11,0,5,1,2,0.7,0.6667,0.74,0.2836,42,193,235,235,2,Siang
12296,2012-06-01,1,6,12,0,5,1,2,0.7,0.6667,0.74,0.3582,72,238,310,310,2,Siang
12297,2012-06-01,1,6,13,0,5,1,1,0.72,0.6818,0.7,0.2985,76,240,316,316,2,Sore
12298,2012-06-01,1,6,14,0,5,1,3,0.72,0.6818,0.66,0.2836,55,199,254,254,2,Sore
12299,2012-06-01,1,6,15,0,5,1,3,0.72,0.6818,0.66,0.2836,45,213,258,258,2,Sore
12300,2012-06-01,1,6,16,0,5,1,3,0.74,0.6818,0.58,0.4478,36,186,222,222,2,Sore
12301,2012-06-01,1,6,17,0,5,1,3,0.7,0.6515,0.7,0.2537,25,202,227,227,2,Sore
12302,2012-06-01,1,6,18,0,5,1,3,0.62,0.5606,0.88,0.3582,10,100,110,110,2,Sore
12303,2012-06-01,1,6,19,0,5,1,3,0.62,0.5606,0.88,0.3582,4,41,45,45,2,Malam
12304,2012-06-01,1,6,20,0,5,1,3,0.62,0.5455,0.94,0.2537,1,38,39,39,2,Malam
12305,2012-06-01,1,6,21,0,5,1,3,0.64,0.5909,0.78,0.2537,12,73,85,85,2,Malam
12306,2012-06-01,1,6,22,0,5,1,3,0.6,0.5455,0.88,0.1343,1,22,23,23,2,Malam
12307,2012-06-01,1,6,23,0,5,1,3,0.6,0.5455,0.88,0.1343,6,67,73,73,2,Malam
12308,2012-06-02,1,6,0,0,6,0,2,0.56,0.5303,0.83,0.1343,5,81,86,86,2,
12309,2012-06-02,1,6,1,0,6,0,2,0.56,0.5303,0.83,0.1045,15,61,76,76,2,Pagi
12310,2012-06-02,1,6,2,0,6,0,2,0.54,0.5152,0.88,0.0,3,38,41,41,2,Pagi
12311,2012-06-02,1,6,3,0,6,0,1,0.56,0.5303,0.73,0.2537,8,18,26,26,2,Pagi
12312,2012-06-02,1,6,4,0,6,0,1,0.54,0.5152,0.68,0.2836,2,11,13,13,2,Pagi
12313,2012-06-02,1,6,5,0,6,0,1,0.5,0.4848,0.72,0.194,1,11,12,12,2,Pagi
12314,2012-06-02,1,6,6,0,6,0,2,0.5,0.4848,0.77,0.194,5,31,36,36,2,Pagi
12315,2012-06-02,1,6,7,0,6,0,1,0.52,0.5,0.72,0.1045,9,77,86,86,2,Siang
12316,2012-06-02,1,6,8,0,6,0,1,0.54,0.5152,0.64,0.1642,30,180,210,210,2,Siang
12317,2012-06-02,1,6,9,0,6,0,1,0.56,0.5303,0.6,0.2537,89,243,332,332,2,Siang
12318,2012-06-02,1,6,10,0,6,0,1,0.6,0.6212,0.53,0.2985,145,348,493,493,2,Siang
12319,2012-06-02,1,6,11,0,6,0,1,0.58,0.5455,0.46,0.2836,179,357,536,536,2,Siang
12320,2012-06-02,1,6,12,0,6,0,1,0.62,0.6212,0.43,0.3582,250,418,668,668,2,Siang
12321,2012-06-02,1,6,13,0,6,0,1,0.62,0.6212,0.41,0.2537,279,400,679,679,2,Sore
12322,2012-06-02,1,6,14,0,6,0,1,0.64,0.6212,0.38,0.2985,259,388,647,647,2,Sore
12323,2012-06-02,1,6,15,0,6,0,1,0.64,0.6212,0.38,0.2537,297,405,702,702,2,Sore
12324,2012-06-02,1,6,16,0,6,0,1,0.64,0.6212,0.38,0.2537,275,369,644,644,2,Sore
12325,2012-06-02,1,6,17,0,6,0,1,0.64,0.6212,0.36,0.0,248,338,586,586,2,Sore
12326,2012-06-02,1,6,18,0,6,0,1,0.64,0.6212,0.36,0.0,171,341,512,512,2,Sore
12327,2012-06-02,1,6,19,0,6,0,1,0.64,0.6212,0.36,0.1642,185,369,554,554,2,Malam
12328,2012-06-02,1,6,20,0,6,0,1,0.62,0.6212,0.35,0.2836,139,260,399,399,2,Malam
12329,2012-06-02,1,6,21,0,6,0,1,0.6,0.6212,0.4,0.1045,96,220,316,316,2,Malam
12330,2012-06-02,1,6,22,0,6,0,1,0.58,0.5455,0.46,0.1343,52,176,228,228,2,Malam
12331,2012-06-02,1,6,23,0,6,0,1,0.56,0.5303,0.52,0.1045,53,185,238,238,2,Malam
12332,2012-06-03,1,6,0,0,0,0,1,0.54,0.5152,0.6,0.1642,27,142,169,169,2,
12333,2012-06-03,1,6,1,0,0,0,1,0.54,0.5152,0.56,0.1343,21,100,121,121,2,Pagi
12334,2012-06-03,1,6,2,0,0,0,1,0.52,0.5,0.59,0.1045,22,67,89,89,2,Pagi
12335,2012-06-03,1,6,3,0,0,0,1,0.52,0.5,0.63,0.1045,16,34,50,50,2,Pagi
12336,2012-06-03,1,6,4,0,0,0,1,0.5,0.4848,0.72,0.0896,1,12,13,13,2,Pagi
12337,2012-06-03,1,6,5,0,0,0,1,0.5,0.4848,0.68,0.0,1,11,12,12,2,Pagi
12338,2012-06-03,1,6,6,0,0,0,1,0.46,0.4545,0.82,0.1045,6,16,22,22,2,Pagi
12339,2012-06-03,1,6,7,0,0,0,1,0.5,0.4848,0.68,0.1045,6,29,35,35,2,Siang
12340,2012-06-03,1,6,8,0,0,0,1,0.54,0.5152,0.6,0.0896,30,110,140,140,2,Siang
12341,2012-06-03,1,6,9,0,0,0,1,0.6,0.6212,0.46,0.194,70,230,300,300,2,Siang
12342,2012-06-03,1,6,10,0,0,0,1,0.62,0.6212,0.43,0.2239,127,277,404,404,2,Siang
12343,2012-06-03,1,6,11,0,0,0,1,0.64,0.6212,0.41,0.2537,199,312,511,511,2,Siang
12344,2012-06-03,1,6,12,0,0,0,1,0.66,0.6212,0.39,0.2985,276,408,684,684,2,Siang
12345,2012-06-03,1,6,13,0,0,0,1,0.68,0.6364,0.36,0.2836,265,421,686,686,2,Sore
12346,2012-06-03,1,6,14,0,0,0,1,0.68,0.6364,0.36,0.3284,267,411,678,678,2,Sore
12347,2012-06-03,1,6,15,0,0,0,1,0.7,0.6364,0.34,0.0,236,408,644,644,2,Sore
12348,2012-06-03,1,6,16,0,0,0,1,0.7,0.6364,0.34,0.2985,226,436,662,662,2,Sore
12349,2012-06-03,1,6,17,0,0,0,1,0.7,0.6364,0.34,0.2537,192,386,578,578,2,Sore
12350,2012-06-03,1,6,18,0,0,0,1,0.7,0.6364,0.34,0.2537,153,343,496,496,2,Sore
12351,2012-06-03,1,6,19,0,0,0,1,0.68,0.6364,0.34,0.2836,116,337,453,453,2,Malam
12352,2012-06-03,1,6,20,0,0,0,1,0.66,0.6212,0.39,0.194,84,230,314,314,2,Malam
12353,2012-06-03,1,6,21,0,0,0,1,0.62,0.6212,0.43,0.1642,66,180,246,246,2,Malam
12354,2012-06-03,1,6,22,0,0,0,1,0.62,0.6212,0.5,0.3881,61,165,226,226,2,Malam
12355,2012-06-03,1,6,23,0,0,0,1,0.58,0.5455,0.53,0.1045,26,82,108,108,2,Malam
12356,2012-06-04,1,6,0,0,1,1,1,0.58,0.5455,0.53,0.0,11,38,49,49,2,
12357,2012-06-04,1,6,1,0,1,1,3,0.56,0.5303,0.6,0.1642,4,10,14,14,2,Pagi
12358,2012-06-04,1,6,2,0,1,1,1,0.56,0.5303,0.6,0.2239,1,10,11,11,2,Pagi
12359,2012-06-04,1,6,3,0,1,1,2,0.56,0.5303,0.6,0.1642,0,5,5,5,2,Pagi
12360,2012-06-04,1,6,4,0,1,1,1,0.54,0.5152,0.64,0.0896,2,6,8,8,2,Pagi
12361,2012-06-04,1,6,5,0,1,1,1,0.52,0.5,0.68,0.0,2,33,35,35,2,Pagi
12362,2012-06-04,1,6,6,0,1,1,1,0.52,0.5,0.68,0.0,4,135,139,139,2,Pagi
12363,2012-06-04,1,6,7,0,1,1,1,0.56,0.5303,0.6,0.2239,13,504,517,517,2,Siang
12364,2012-06-04,1,6,8,0,1,1,1,0.6,0.6212,0.49,0.2239,22,643,665,665,2,Siang
12365,2012-06-04,1,6,9,0,1,1,1,0.62,0.6212,0.43,0.2836,38,244,282,282,2,Siang
12366,2012-06-04,1,6,10,0,1,1,1,0.64,0.6212,0.41,0.4627,67,120,187,187,2,Siang
12367,2012-06-04,1,6,11,0,1,1,1,0.64,0.6212,0.38,0.4925,71,168,239,239,2,Siang
12368,2012-06-04,1,6,12,0,1,1,1,0.64,0.6212,0.41,0.4478,62,220,282,282,2,Siang
12369,2012-06-04,1,6,13,0,1,1,1,0.64,0.6212,0.41,0.3582,85,189,274,274,2,Sore
12370,2012-06-04,1,6,14,0,1,1,1,0.62,0.6212,0.41,0.4925,84,186,270,270,2,Sore
12371,2012-06-04,1,6,15,0,1,1,1,0.66,0.6212,0.39,0.2985,77,215,292,292,2,Sore
12372,2012-06-04,1,6,16,0,1,1,1,0.66,0.6212,0.39,0.4627,73,375,448,448,2,Sore
12373,2012-06-04,1,6,17,0,1,1,1,0.64,0.6212,0.38,0.4478,101,733,834,834,2,Sore
12374,2012-06-04,1,6,18,0,1,1,1,0.64,0.6212,0.38,0.3881,103,719,822,822,2,Sore
12375,2012-06-04,1,6,19,0,1,1,1,0.62,0.6212,0.38,0.4179,91,554,645,645,2,Malam
12376,2012-06-04,1,6,20,0,1,1,1,0.6,0.6212,0.4,0.3582,71,390,461,461,2,Malam
12377,2012-06-04,1,6,21,0,1,1,1,0.58,0.5455,0.49,0.2537,40,225,265,265,2,Malam
12378,2012-06-04,1,6,22,0,1,1,1,0.56,0.5303,0.52,0.2836,41,127,168,168,2,Malam
12379,2012-06-04,1,6,23,0,1,1,1,0.58,0.5455,0.49,0.2985,8,78,86,86,2,Malam
12380,2012-06-05,1,6,0,0,2,1,1,0.54,0.5152,0.68,0.4179,6,28,34,34,2,
12381,2012-06-05,1,6,1,0,2,1,2,0.52,0.5,0.77,0.3284,2,18,20,20,2,Pagi
12382,2012-06-05,1,6,2,0,2,1,3,0.52,0.5,0.72,0.2985,0,8,8,8,2,Pagi
12383,2012-06-05,1,6,3,0,2,1,3,0.5,0.4848,0.82,0.194,0,5,5,5,2,Pagi
12384,2012-06-05,1,6,4,0,2,1,3,0.5,0.4848,0.82,0.194,1,4,5,5,2,Pagi
12385,2012-06-05,1,6,5,0,2,1,3,0.48,0.4697,0.82,0.1642,1,35,36,36,2,Pagi
12386,2012-06-05,1,6,6,0,2,1,1,0.48,0.4697,0.82,0.2537,7,177,184,184,2,Pagi
12387,2012-06-05,1,6,7,0,2,1,1,0.48,0.4697,0.77,0.2985,29,540,569,569,2,Siang
12388,2012-06-05,1,6,8,0,2,1,2,0.48,0.4697,0.77,0.2239,30,680,710,710,2,Siang
12389,2012-06-05,1,6,9,0,2,1,2,0.52,0.5,0.72,0.2537,50,285,335,335,2,Siang
12390,2012-06-05,1,6,10,0,2,1,2,0.52,0.5,0.63,0.2985,58,118,176,176,2,Siang
12391,2012-06-05,1,6,11,0,2,1,2,0.56,0.5303,0.56,0.194,65,162,227,227,2,Siang
12392,2012-06-05,1,6,12,0,2,1,2,0.54,0.5152,0.56,0.2239,45,202,247,247,2,Siang
12393,2012-06-05,1,6,13,0,2,1,2,0.6,0.6212,0.46,0.1642,66,201,267,267,2,Sore
12394,2012-06-05,1,6,14,0,2,1,2,0.58,0.5455,0.46,0.1642,82,194,276,276,2,Sore
12395,2012-06-05,1,6,15,0,2,1,2,0.58,0.5455,0.46,0.1343,54,218,272,272,2,Sore
12396,2012-06-05,1,6,16,0,2,1,1,0.6,0.6212,0.43,0.194,91,382,473,473,2,Sore
12397,2012-06-05,1,6,17,0,2,1,1,0.6,0.6212,0.43,0.0,86,764,850,850,2,Sore
12398,2012-06-05,1,6,18,0,2,1,1,0.6,0.6212,0.43,0.194,111,679,790,790,2,Sore
12399,2012-06-05,1,6,19,0,2,1,1,0.58,0.5455,0.46,0.2537,68,445,513,513,2,Malam
12400,2012-06-05,1,6,20,0,2,1,1,0.56,0.5303,0.49,0.2239,44,371,415,415,2,Malam
12401,2012-06-05,1,6,21,0,2,1,1,0.54,0.5152,0.56,0.1642,30,253,283,283,2,Malam
12402,2012-06-05,1,6,22,0,2,1,1,0.56,0.5303,0.52,0.1045,22,171,193,193,2,Malam
12403,2012-06-05,1,6,23,0,2,1,1,0.54,0.5152,0.56,0.0896,20,93,113,113,2,Malam
12404,2012-06-06,1,6,0,0,3,1,1,0.52,0.5,0.59,0.0896,3,46,49,49,2,
12405,2012-06-06,1,6,1,0,3,1,1,0.52,0.5,0.68,0.0,6,21,27,27,2,Pagi
12406,2012-06-06,1,6,2,0,3,1,1,0.5,0.4848,0.68,0.0,4,7,11,11,2,Pagi
12407,2012-06-06,1,6,3,0,3,1,1,0.46,0.4545,0.82,0.0,0,8,8,8,2,Pagi
12408,2012-06-06,1,6,4,0,3,1,1,0.46,0.4545,0.82,0.1045,3,7,10,10,2,Pagi
12409,2012-06-06,1,6,5,0,3,1,1,0.48,0.4697,0.77,0.0,1,37,38,38,2,Pagi
12410,2012-06-06,1,6,6,0,3,1,1,0.48,0.4697,0.77,0.0,7,165,172,172,2,Pagi
12411,2012-06-06,1,6,7,0,3,1,1,0.5,0.4848,0.72,0.0,16,531,547,547,2,Siang
12412,2012-06-06,1,6,8,0,3,1,1,0.54,0.5152,0.68,0.0,31,637,668,668,2,Siang
12413,2012-06-06,1,6,9,0,3,1,1,0.56,0.5303,0.6,0.0896,35,268,303,303,2,Siang
12414,2012-06-06,1,6,10,0,3,1,1,0.6,0.6212,0.46,0.0896,55,148,203,203,2,Siang
12415,2012-06-06,1,6,11,0,3,1,1,0.62,0.6212,0.43,0.0896,65,161,226,226,2,Siang
12416,2012-06-06,1,6,12,0,3,1,1,0.62,0.6212,0.38,0.0,80,235,315,315,2,Siang
12417,2012-06-06,1,6,13,0,3,1,1,0.62,0.6212,0.41,0.0896,73,230,303,303,2,Sore
12418,2012-06-06,1,6,14,0,3,1,1,0.64,0.6212,0.38,0.0,111,191,302,302,2,Sore
12419,2012-06-06,1,6,15,0,3,1,1,0.64,0.6212,0.38,0.0,75,225,300,300,2,Sore
12420,2012-06-06,1,6,16,0,3,1,1,0.64,0.6212,0.41,0.1343,107,345,452,452,2,Sore
12421,2012-06-06,1,6,17,0,3,1,1,0.62,0.6212,0.43,0.1343,72,652,724,724,2,Sore
12422,2012-06-06,1,6,18,0,3,1,3,0.6,0.6212,0.53,0.194,94,688,782,782,2,Sore
12423,2012-06-06,1,6,19,0,3,1,1,0.56,0.5303,0.73,0.2985,52,486,538,538,2,Malam
12424,2012-06-06,1,6,20,0,3,1,1,0.54,0.5152,0.73,0.2836,59,349,408,408,2,Malam
12425,2012-06-06,1,6,21,0,3,1,1,0.54,0.5152,0.73,0.1642,38,260,298,298,2,Malam
12426,2012-06-06,1,6,22,0,3,1,1,0.52,0.5,0.77,0.0896,27,221,248,248,2,Malam
12427,2012-06-06,1,6,23,0,3,1,1,0.52,0.5,0.77,0.0,13,110,123,123,2,Malam
12428,2012-06-07,1,6,0,0,4,1,1,0.52,0.5,0.77,0.1343,9,50,59,59,2,
12429,2012-06-07,1,6,1,0,4,1,1,0.52,0.5,0.77,0.1642,5,17,22,22,2,Pagi
12430,2012-06-07,1,6,2,0,4,1,1,0.52,0.5,0.77,0.0896,0,12,12,12,2,Pagi
12431,2012-06-07,1,6,3,0,4,1,1,0.5,0.4848,0.77,0.1045,0,5,5,5,2,Pagi
12432,2012-06-07,1,6,4,0,4,1,1,0.46,0.4545,0.88,0.1045,0,6,6,6,2,Pagi
12433,2012-06-07,1,6,5,0,4,1,1,0.48,0.4697,0.82,0.0896,0,34,34,34,2,Pagi
12434,2012-06-07,1,6,6,0,4,1,1,0.46,0.4545,0.88,0.1045,5,165,170,170,2,Pagi
12435,2012-06-07,1,6,7,0,4,1,1,0.5,0.4848,0.82,0.1642,20,506,526,526,2,Siang
12436,2012-06-07,1,6,8,0,4,1,1,0.52,0.5,0.77,0.0,20,661,681,681,2,Siang
12437,2012-06-07,1,6,9,0,4,1,1,0.58,0.5455,0.68,0.0,37,300,337,337,2,Siang
12438,2012-06-07,1,6,10,0,4,1,1,0.6,0.6061,0.64,0.0896,56,154,210,210,2,Siang
12439,2012-06-07,1,6,11,0,4,1,1,0.66,0.6212,0.47,0.2239,67,170,237,237,2,Siang
12440,2012-06-07,1,6,12,0,4,1,1,0.7,0.6364,0.42,0.0,62,274,336,336,2,Siang
12441,2012-06-07,1,6,13,0,4,1,1,0.7,0.6364,0.37,0.2836,65,250,315,315,2,Sore
12442,2012-06-07,1,6,14,0,4,1,1,0.72,0.6515,0.37,0.2537,67,198,265,265,2,Sore
12443,2012-06-07,1,6,15,0,4,1,1,0.74,0.6515,0.3,0.0,99,234,333,333,2,Sore
12444,2012-06-07,1,6,16,0,4,1,1,0.72,0.6515,0.34,0.2239,77,389,466,466,2,Sore
12445,2012-06-07,1,6,17,0,4,1,1,0.72,0.6515,0.34,0.2537,91,778,869,869,2,Sore
12446,2012-06-07,1,6,18,0,4,1,1,0.7,0.6364,0.34,0.2836,110,703,813,813,2,Sore
12447,2012-06-07,1,6,19,0,4,1,1,0.7,0.6364,0.34,0.2836,65,537,602,602,2,Malam
12448,2012-06-07,1,6,20,0,4,1,1,0.66,0.6212,0.36,0.2985,76,402,478,478,2,Malam
12449,2012-06-07,1,6,21,0,4,1,1,0.62,0.6212,0.41,0.3284,30,283,313,313,2,Malam
12450,2012-06-07,1,6,22,0,4,1,1,0.6,0.6212,0.46,0.1642,35,193,228,228,2,Malam
12451,2012-06-07,1,6,23,0,4,1,1,0.56,0.5303,0.52,0.1343,42,135,177,177,2,Malam
12452,2012-06-08,1,6,0,0,5,1,1,0.56,0.5303,0.56,0.1642,18,59,77,77,2,
12453,2012-06-08,1,6,1,0,5,1,1,0.56,0.5303,0.56,0.1642,4,25,29,29,2,Pagi
12454,2012-06-08,1,6,2,0,5,1,1,0.56,0.5303,0.56,0.0,2,17,19,19,2,Pagi
12455,2012-06-08,1,6,3,0,5,1,1,0.54,0.5152,0.6,0.0896,0,8,8,8,2,Pagi
12456,2012-06-08,1,6,4,0,5,1,1,0.52,0.5,0.63,0.0,1,9,10,10,2,Pagi
12457,2012-06-08,1,6,5,0,5,1,1,0.5,0.4848,0.72,0.1045,1,28,29,29,2,Pagi
12458,2012-06-08,1,6,6,0,5,1,1,0.52,0.5,0.68,0.0896,8,131,139,139,2,Pagi
12459,2012-06-08,1,6,7,0,5,1,1,0.52,0.5,0.72,0.1045,19,409,428,428,2,Siang
12460,2012-06-08,1,6,8,0,5,1,1,0.58,0.5455,0.6,0.0896,37,663,700,700,2,Siang
12461,2012-06-08,1,6,9,0,5,1,1,0.62,0.6212,0.53,0.1642,47,335,382,382,2,Siang
12462,2012-06-08,1,6,10,0,5,1,1,0.66,0.6212,0.47,0.2537,62,187,249,249,2,Siang
12463,2012-06-08,1,6,11,0,5,1,1,0.7,0.6364,0.42,0.2537,65,199,264,264,2,Siang
12464,2012-06-08,1,6,12,0,5,1,1,0.72,0.6515,0.39,0.3284,89,280,369,369,2,Siang
12465,2012-06-08,1,6,13,0,5,1,1,0.74,0.6515,0.37,0.2537,129,287,416,416,2,Sore
12466,2012-06-08,1,6,14,0,5,1,1,0.76,0.6667,0.31,0.3881,128,245,373,373,2,Sore
12467,2012-06-08,1,6,15,0,5,1,1,0.76,0.6667,0.29,0.2836,98,299,397,397,2,Sore
12468,2012-06-08,1,6,16,0,5,1,1,0.76,0.6667,0.29,0.2985,111,412,523,523,2,Sore
12469,2012-06-08,1,6,17,0,5,1,1,0.76,0.6667,0.29,0.194,114,679,793,793,2,Sore
12470,2012-06-08,1,6,18,0,5,1,1,0.76,0.6667,0.27,0.2239,147,576,723,723,2,Sore
12471,2012-06-08,1,6,19,0,5,1,1,0.74,0.6515,0.3,0.2239,95,460,555,555,2,Malam
12472,2012-06-08,1,6,20,0,5,1,1,0.72,0.6515,0.32,0.1343,117,291,408,408,2,Malam
12473,2012-06-08,1,6,21,0,5,1,1,0.7,0.6364,0.37,0.1343,83,256,339,339,2,Malam
12474,2012-06-08,1,6,22,0,5,1,1,0.68,0.6364,0.41,0.1045,61,230,291,291,2,Malam
12475,2012-06-08,1,6,23,0,5,1,1,0.64,0.6212,0.57,0.1642,52,163,215,215,2,Malam
12476,2012-06-09,1,6,0,0,6,0,1,0.64,0.6212,0.53,0.1045,54,152,206,206,2,
12477,2012-06-09,1,6,1,0,6,0,1,0.64,0.6212,0.53,0.0896,34,89,123,123,2,Pagi
12478,2012-06-09,1,6,2,0,6,0,1,0.64,0.6212,0.5,0.2239,21,68,89,89,2,Pagi
12479,2012-06-09,1,6,3,0,6,0,1,0.62,0.6212,0.57,0.0,12,28,40,40,2,Pagi
12480,2012-06-09,1,6,4,0,6,0,1,0.62,0.6212,0.57,0.0,2,6,8,8,2,Pagi
12481,2012-06-09,1,6,5,0,6,0,1,0.6,0.6212,0.56,0.1045,4,15,19,19,2,Pagi
12482,2012-06-09,1,6,6,0,6,0,1,0.56,0.5303,0.64,0.1045,17,63,80,80,2,Pagi
12483,2012-06-09,1,6,7,0,6,0,1,0.58,0.5455,0.64,0.1045,26,61,87,87,2,Siang
12484,2012-06-09,1,6,8,0,6,0,1,0.62,0.6061,0.61,0.1045,42,202,244,244,2,Siang
12485,2012-06-09,1,6,9,0,6,0,1,0.64,0.6212,0.57,0.1642,99,241,340,340,2,Siang
12486,2012-06-09,1,6,10,0,6,0,1,0.7,0.6515,0.51,0.1045,168,298,466,466,2,Siang
12487,2012-06-09,1,6,11,0,6,0,1,0.76,0.6667,0.35,0.0,218,351,569,569,2,Siang
12488,2012-06-09,1,6,12,0,6,0,1,0.8,0.697,0.29,0.2537,196,335,531,531,2,Siang
12489,2012-06-09,1,6,13,0,6,0,1,0.82,0.697,0.24,0.2836,236,349,585,585,2,Sore
12490,2012-06-09,1,6,14,0,6,0,1,0.82,0.697,0.23,0.194,239,354,593,593,2,Sore
12491,2012-06-09,1,6,15,0,6,0,1,0.84,0.7121,0.2,0.2985,218,337,555,555,2,Sore
12492,2012-06-09,1,6,16,0,6,0,1,0.82,0.697,0.24,0.194,219,315,534,534,2,Sore
12493,2012-06-09,1,6,17,0,6,0,1,0.84,0.7121,0.24,0.0,238,257,495,495,2,Sore
12494,2012-06-09,1,6,18,0,6,0,1,0.82,0.697,0.24,0.2239,175,276,451,451,2,Sore
12495,2012-06-09,1,6,19,0,6,0,1,0.8,0.697,0.29,0.1642,128,232,360,360,2,Malam
12496,2012-06-09,1,6,20,0,6,0,1,0.76,0.6667,0.35,0.2239,125,238,363,363,2,Malam
12497,2012-06-09,1,6,21,0,6,0,1,0.74,0.6515,0.4,0.194,105,211,316,316,2,Malam
12498,2012-06-09,1,6,22,0,6,0,1,0.7,0.6515,0.58,0.1642,63,151,214,214,2,Malam
12499,2012-06-09,1,6,23,0,6,0,1,0.68,0.6364,0.61,0.1642,69,161,230,230,2,Malam
12500,2012-06-10,1,6,0,0,0,0,1,0.66,0.6212,0.69,0.1045,33,125,158,158,2,
12501,2012-06-10,1,6,1,0,0,0,1,0.64,0.6061,0.73,0.1343,32,84,116,116,2,Pagi
12502,2012-06-10,1,6,2,0,0,0,1,0.64,0.6061,0.69,0.1343,17,56,73,73,2,Pagi
12503,2012-06-10,1,6,3,0,0,0,1,0.64,0.6061,0.73,0.1045,6,23,29,29,2,Pagi
12504,2012-06-10,1,6,4,0,0,0,1,0.62,0.5909,0.78,0.0896,1,9,10,10,2,Pagi
12505,2012-06-10,1,6,5,0,0,0,1,0.62,0.6061,0.69,0.0896,3,10,13,13,2,Pagi
12506,2012-06-10,1,6,6,0,0,0,1,0.62,0.5909,0.73,0.0,3,27,30,30,2,Pagi
12507,2012-06-10,1,6,7,0,0,0,1,0.6,0.5758,0.78,0.1045,21,41,62,62,2,Siang
12508,2012-06-10,1,6,8,0,0,0,1,0.64,0.6061,0.73,0.0896,59,122,181,181,2,Siang
12509,2012-06-10,1,6,9,0,0,0,1,0.7,0.6515,0.58,0.0,91,175,266,266,2,Siang
12510,2012-06-10,1,6,10,0,0,0,1,0.76,0.6818,0.4,0.1045,148,265,413,413,2,Siang
12511,2012-06-10,1,6,11,0,0,0,1,0.76,0.6818,0.45,0.0896,184,315,499,499,2,Siang
12512,2012-06-10,1,6,12,0,0,0,1,0.82,0.7121,0.3,0.0,173,329,502,502,2,Siang
12513,2012-06-10,1,6,13,0,0,0,1,0.84,0.7273,0.28,0.1343,204,288,492,492,2,Sore
12514,2012-06-10,1,6,14,0,0,0,1,0.84,0.7273,0.3,0.1343,186,314,500,500,2,Sore
12515,2012-06-10,1,6,15,0,0,0,1,0.84,0.7273,0.3,0.2239,159,316,475,475,2,Sore
12516,2012-06-10,1,6,16,0,0,0,1,0.84,0.7424,0.36,0.2836,173,335,508,508,2,Sore
12517,2012-06-10,1,6,17,0,0,0,1,0.82,0.7424,0.41,0.2836,184,337,521,521,2,Sore
12518,2012-06-10,1,6,18,0,0,0,1,0.82,0.7273,0.38,0.2239,164,326,490,490,2,Sore
12519,2012-06-10,1,6,19,0,0,0,1,0.82,0.7121,0.28,0.2836,115,260,375,375,2,Malam
12520,2012-06-10,1,6,20,0,0,0,1,0.76,0.6818,0.48,0.1642,113,250,363,363,2,Malam
12521,2012-06-10,1,6,21,0,0,0,1,0.72,0.6818,0.62,0.1642,83,170,253,253,2,Malam
12522,2012-06-10,1,6,22,0,0,0,1,0.7,0.6515,0.65,0.1642,42,117,159,159,2,Malam
12523,2012-06-10,1,6,23,0,0,0,1,0.72,0.6667,0.58,0.1045,30,80,110,110,2,Malam
12524,2012-06-11,1,6,0,0,1,1,1,0.7,0.6515,0.65,0.1045,8,33,41,41,2,
12525,2012-06-11,1,6,1,0,1,1,1,0.66,0.6212,0.74,0.1642,9,15,24,24,2,Pagi
12526,2012-06-11,1,6,2,0,1,1,1,0.66,0.6212,0.74,0.1045,5,12,17,17,2,Pagi
12527,2012-06-11,1,6,3,0,1,1,1,0.64,0.5909,0.78,0.1045,2,4,6,6,2,Pagi
12528,2012-06-11,1,6,4,0,1,1,1,0.64,0.5909,0.78,0.1343,0,7,7,7,2,Pagi
12529,2012-06-11,1,6,5,0,1,1,1,0.64,0.5909,0.78,0.1343,1,36,37,37,2,Pagi
12530,2012-06-11,1,6,6,0,1,1,1,0.62,0.5758,0.83,0.1045,8,136,144,144,2,Pagi
12531,2012-06-11,1,6,7,0,1,1,1,0.64,0.5909,0.78,0.1045,25,478,503,503,2,Siang
12532,2012-06-11,1,6,8,0,1,1,1,0.66,0.6212,0.74,0.1343,38,613,651,651,2,Siang
12533,2012-06-11,1,6,9,0,1,1,1,0.7,0.6515,0.65,0.1343,57,259,316,316,2,Siang
12534,2012-06-11,1,6,10,0,1,1,1,0.72,0.6818,0.62,0.1642,52,95,147,147,2,Siang
12535,2012-06-11,1,6,11,0,1,1,2,0.76,0.6818,0.48,0.2239,59,143,202,202,2,Siang
12536,2012-06-11,1,6,12,0,1,1,2,0.8,0.7273,0.43,0.194,63,198,261,261,2,Siang
12537,2012-06-11,1,6,13,0,1,1,2,0.8,0.7121,0.41,0.2985,63,185,248,248,2,Sore
12538,2012-06-11,1,6,14,0,1,1,2,0.82,0.7273,0.34,0.2836,66,193,259,259,2,Sore
12539,2012-06-11,1,6,15,0,1,1,1,0.8,0.7121,0.41,0.3582,72,187,259,259,2,Sore
12540,2012-06-11,1,6,16,0,1,1,2,0.8,0.7121,0.41,0.4179,87,340,427,427,2,Sore
12541,2012-06-11,1,6,17,0,1,1,2,0.8,0.7121,0.41,0.3582,85,715,800,800,2,Sore
12542,2012-06-11,1,6,18,0,1,1,2,0.8,0.7273,0.43,0.2985,105,726,831,831,2,Sore
12543,2012-06-11,1,6,19,0,1,1,2,0.76,0.6818,0.48,0.3284,89,507,596,596,2,Malam
12544,2012-06-11,1,6,20,0,1,1,2,0.74,0.6667,0.48,0.2239,61,333,394,394,2,Malam
12545,2012-06-11,1,6,21,0,1,1,2,0.72,0.6667,0.58,0.194,32,218,250,250,2,Malam
12546,2012-06-11,1,6,22,0,1,1,2,0.72,0.6667,0.58,0.194,22,142,164,164,2,Malam
12547,2012-06-11,1,6,23,0,1,1,2,0.7,0.6515,0.58,0.2239,8,72,80,80,2,Malam
12548,2012-06-12,1,6,0,0,2,1,2,0.7,0.6515,0.58,0.2239,2,26,28,28,2,
12549,2012-06-12,1,6,1,0,2,1,2,0.68,0.6364,0.65,0.1642,5,11,16,16,2,Pagi
12550,2012-06-12,1,6,2,0,2,1,2,0.68,0.6364,0.65,0.194,0,6,6,6,2,Pagi
12551,2012-06-12,1,6,3,0,2,1,2,0.66,0.6212,0.69,0.2537,3,9,12,12,2,Pagi
12552,2012-06-12,1,6,4,0,2,1,3,0.6,0.5455,0.88,0.1642,0,4,4,4,2,Pagi
12553,2012-06-12,1,6,5,0,2,1,3,0.6,0.5455,0.88,0.1343,1,28,29,29,2,Pagi
12554,2012-06-12,1,6,6,0,2,1,2,0.6,0.5455,0.88,0.1343,6,130,136,136,2,Pagi
12555,2012-06-12,1,6,7,0,2,1,3,0.62,0.5606,0.88,0.2537,16,287,303,303,2,Siang
12556,2012-06-12,1,6,8,0,2,1,2,0.62,0.5606,0.88,0.2239,15,598,613,613,2,Siang
12557,2012-06-12,1,6,9,0,2,1,2,0.64,0.5758,0.89,0.2836,31,254,285,285,2,Siang
12558,2012-06-12,1,6,10,0,2,1,3,0.64,0.5758,0.89,0.2836,29,96,125,125,2,Siang
12559,2012-06-12,1,6,11,0,2,1,3,0.66,0.6061,0.83,0.3582,8,57,65,65,2,Siang
12560,2012-06-12,1,6,12,0,2,1,3,0.66,0.6061,0.83,0.2537,19,76,95,95,2,Siang
12561,2012-06-12,1,6,13,0,2,1,3,0.66,0.6061,0.83,0.194,11,48,59,59,2,Sore
12562,2012-06-12,1,6,14,0,2,1,3,0.64,0.5758,0.89,0.2537,12,48,60,60,2,Sore
12563,2012-06-12,1,6,15,0,2,1,3,0.66,0.5909,0.89,0.194,22,94,116,116,2,Sore
12564,2012-06-12,1,6,16,0,2,1,2,0.66,0.5909,0.89,0.2836,30,209,239,239,2,Sore
12565,2012-06-12,1,6,17,0,2,1,2,0.66,0.5909,0.89,0.2836,56,625,681,681,2,Sore
12566,2012-06-12,1,6,18,0,2,1,1,0.68,0.6364,0.83,0.194,57,596,653,653,2,Sore
12567,2012-06-12,1,6,19,0,2,1,1,0.68,0.6364,0.83,0.194,47,444,491,491,2,Malam
12568,2012-06-12,1,6,20,0,2,1,1,0.68,0.6364,0.83,0.194,36,350,386,386,2,Malam
12569,2012-06-12,1,6,21,0,2,1,1,0.68,0.6364,0.83,0.1045,41,233,274,274,2,Malam
12570,2012-06-12,1,6,22,0,2,1,1,0.66,0.5909,0.94,0.1045,19,188,207,207,2,Malam
12571,2012-06-12,1,6,23,0,2,1,3,0.66,0.5909,0.94,0.2239,11,78,89,89,2,Malam
12572,2012-06-13,1,6,0,0,3,1,2,0.66,0.5909,0.94,0.194,7,27,34,34,2,
12573,2012-06-13,1,6,1,0,3,1,1,0.64,0.5909,0.78,0.0,7,21,28,28,2,Pagi
12574,2012-06-13,1,6,2,0,3,1,1,0.62,0.5758,0.83,0.1343,0,4,4,4,2,Pagi
12575,2012-06-13,1,6,3,0,3,1,1,0.62,0.5758,0.83,0.194,1,7,8,8,2,Pagi
12576,2012-06-13,1,6,4,0,3,1,1,0.6,0.5606,0.83,0.1343,1,9,10,10,2,Pagi
12577,2012-06-13,1,6,5,0,3,1,1,0.6,0.5606,0.83,0.194,2,38,40,40,2,Pagi
12578,2012-06-13,1,6,6,0,3,1,1,0.6,0.5606,0.83,0.2239,6,188,194,194,2,Pagi
12579,2012-06-13,1,6,7,0,3,1,1,0.6,0.5606,0.83,0.2985,25,480,505,505,2,Siang
12580,2012-06-13,1,6,8,0,3,1,2,0.62,0.5909,0.73,0.5224,41,672,713,713,2,Siang
12581,2012-06-13,1,6,9,0,3,1,2,0.64,0.6061,0.69,0.5821,54,298,352,352,2,Siang
12582,2012-06-13,1,6,10,0,3,1,2,0.64,0.6061,0.65,0.4179,64,134,198,198,2,Siang
12583,2012-06-13,1,6,11,0,3,1,2,0.66,0.6212,0.54,0.4478,64,182,246,246,2,Siang
12584,2012-06-13,1,6,12,0,3,1,2,0.68,0.6364,0.44,0.4179,93,241,334,334,2,Siang
12585,2012-06-13,1,6,13,0,3,1,2,0.7,0.6364,0.45,0.3881,52,203,255,255,2,Sore
12586,2012-06-13,1,6,14,0,3,1,2,0.72,0.6515,0.37,0.4179,98,222,320,320,2,Sore
12587,2012-06-13,1,6,15,0,3,1,1,0.72,0.6515,0.32,0.4925,65,216,281,281,2,Sore
12588,2012-06-13,1,6,16,0,3,1,1,0.72,0.6515,0.3,0.4925,72,320,392,392,2,Sore
12589,2012-06-13,1,6,17,0,3,1,1,0.72,0.6515,0.32,0.4925,75,782,857,857,2,Sore
12590,2012-06-13,1,6,18,0,3,1,1,0.72,0.6515,0.32,0.4478,104,640,744,744,2,Sore
12591,2012-06-13,1,6,19,0,3,1,1,0.7,0.6364,0.34,0.3881,123,548,671,671,2,Malam
12592,2012-06-13,1,6,20,0,3,1,1,0.68,0.6364,0.36,0.4179,86,362,448,448,2,Malam
12593,2012-06-13,1,6,21,0,3,1,1,0.64,0.6212,0.44,0.3582,79,317,396,396,2,Malam
12594,2012-06-13,1,6,22,0,3,1,1,0.62,0.6212,0.5,0.2985,29,209,238,238,2,Malam
12595,2012-06-13,1,6,23,0,3,1,1,0.62,0.6212,0.5,0.2836,25,128,153,153,2,Malam
12596,2012-06-14,1,6,0,0,4,1,1,0.6,0.6212,0.53,0.2985,3,45,48,48,2,
12597,2012-06-14,1,6,1,0,4,1,1,0.6,0.6212,0.56,0.2239,4,17,21,21,2,Pagi
12598,2012-06-14,1,6,2,0,4,1,2,0.62,0.6212,0.53,0.2537,1,8,9,9,2,Pagi
12599,2012-06-14,1,6,3,0,4,1,2,0.62,0.6212,0.53,0.2836,1,4,5,5,2,Pagi
12600,2012-06-14,1,6,4,0,4,1,2,0.6,0.6212,0.56,0.2537,0,6,6,6,2,Pagi
12601,2012-06-14,1,6,5,0,4,1,2,0.6,0.6212,0.56,0.2537,0,40,40,40,2,Pagi
12602,2012-06-14,1,6,6,0,4,1,1,0.58,0.5455,0.6,0.2836,12,169,181,181,2,Pagi
12603,2012-06-14,1,6,7,0,4,1,1,0.6,0.6061,0.6,0.2836,26,480,506,506,2,Siang
12604,2012-06-14,1,6,8,0,4,1,1,0.6,0.6061,0.64,0.3284,37,682,719,719,2,Siang
12605,2012-06-14,1,6,9,0,4,1,1,0.62,0.6061,0.61,0.2239,45,312,357,357,2,Siang
12606,2012-06-14,1,6,10,0,4,1,1,0.64,0.6061,0.65,0.4179,47,132,179,179,2,Siang
12607,2012-06-14,1,6,11,0,4,1,1,0.66,0.6212,0.57,0.2537,60,168,228,228,2,Siang
12608,2012-06-14,1,6,12,0,4,1,2,0.66,0.6212,0.61,0.2239,55,210,265,265,2,Siang
12609,2012-06-14,1,6,13,0,4,1,1,0.68,0.6364,0.57,0.1642,71,213,284,284,2,Sore
12610,2012-06-14,1,6,14,0,4,1,1,0.7,0.6515,0.54,0.2836,84,214,298,298,2,Sore
12611,2012-06-14,1,6,15,0,4,1,1,0.74,0.6667,0.48,0.2985,111,213,324,324,2,Sore
12612,2012-06-14,1,6,16,0,4,1,1,0.72,0.6667,0.51,0.2836,70,368,438,438,2,Sore
12613,2012-06-14,1,6,17,0,4,1,1,0.72,0.6667,0.48,0.2239,117,750,867,867,2,Sore
12614,2012-06-14,1,6,18,0,4,1,1,0.74,0.6667,0.42,0.194,107,716,823,823,2,Sore
12615,2012-06-14,1,6,19,0,4,1,1,0.7,0.6515,0.48,0.2537,96,483,579,579,2,Malam
12616,2012-06-14,1,6,20,0,4,1,1,0.66,0.6212,0.65,0.2537,84,351,435,435,2,Malam
12617,2012-06-14,1,6,21,0,4,1,1,0.64,0.6061,0.65,0.1642,67,270,337,337,2,Malam
12618,2012-06-14,1,6,22,0,4,1,2,0.64,0.6061,0.65,0.2239,46,196,242,242,2,Malam
12619,2012-06-14,1,6,23,0,4,1,2,0.62,0.6061,0.69,0.1642,36,136,172,172,2,Malam
12620,2012-06-15,1,6,0,0,5,1,1,0.6,0.5909,0.73,0.1642,26,68,94,94,2,
12621,2012-06-15,1,6,1,0,5,1,1,0.58,0.5455,0.78,0.194,9,42,51,51,2,Pagi
12622,2012-06-15,1,6,2,0,5,1,1,0.56,0.5303,0.83,0.1045,0,15,15,15,2,Pagi
12623,2012-06-15,1,6,3,0,5,1,1,0.56,0.5303,0.83,0.1642,2,3,5,5,2,Pagi
12624,2012-06-15,1,6,4,0,5,1,1,0.56,0.5303,0.83,0.1642,1,13,14,14,2,Pagi
12625,2012-06-15,1,6,5,0,5,1,1,0.54,0.5152,0.88,0.1045,2,31,33,33,2,Pagi
12626,2012-06-15,1,6,6,0,5,1,1,0.54,0.5152,0.83,0.1343,9,142,151,151,2,Pagi
12627,2012-06-15,1,6,7,0,5,1,1,0.56,0.5303,0.83,0.1642,17,413,430,430,2,Siang
12628,2012-06-15,1,6,8,0,5,1,1,0.6,0.5909,0.69,0.1642,44,609,653,653,2,Siang
12629,2012-06-15,1,6,9,0,5,1,1,0.62,0.6061,0.65,0.1642,58,308,366,366,2,Siang
12630,2012-06-15,1,6,10,0,5,1,1,0.64,0.6212,0.57,0.1642,56,160,216,216,2,Siang
12631,2012-06-15,1,6,11,0,5,1,1,0.66,0.6212,0.5,0.194,106,180,286,286,2,Siang
12632,2012-06-15,1,6,12,0,5,1,1,0.7,0.6364,0.45,0.1642,111,292,403,403,2,Siang
12633,2012-06-15,1,6,13,0,5,1,1,0.7,0.6364,0.42,0.2537,121,272,393,393,2,Sore
12634,2012-06-15,1,6,14,0,5,1,1,0.72,0.6515,0.39,0.194,121,255,376,376,2,Sore
12635,2012-06-15,1,6,15,0,5,1,1,0.72,0.6515,0.39,0.194,107,270,377,377,2,Sore
12636,2012-06-15,1,6,16,0,5,1,1,0.72,0.6515,0.37,0.194,132,426,558,558,2,Sore
12637,2012-06-15,1,6,17,0,5,1,1,0.74,0.6515,0.37,0.2836,125,698,823,823,2,Sore
12638,2012-06-15,1,6,18,0,5,1,1,0.72,0.6515,0.39,0.2239,121,572,693,693,2,Sore
12639,2012-06-15,1,6,19,0,5,1,1,0.7,0.6364,0.42,0.1642,98,369,467,467,2,Malam
12640,2012-06-15,1,6,20,0,5,1,1,0.68,0.6364,0.44,0.194,89,296,385,385,2,Malam
12641,2012-06-15,1,6,21,0,5,1,1,0.66,0.6212,0.5,0.1045,83,250,333,333,2,Malam
12642,2012-06-15,1,6,22,0,5,1,1,0.64,0.6212,0.53,0.1343,79,242,321,321,2,Malam
12643,2012-06-15,1,6,23,0,5,1,1,0.62,0.6212,0.53,0.2537,46,176,222,222,2,Malam
12644,2012-06-16,1,6,0,0,6,0,1,0.58,0.5455,0.56,0.1343,25,112,137,137,2,
12645,2012-06-16,1,6,1,0,6,0,1,0.56,0.5303,0.56,0.0,16,79,95,95,2,Pagi
12646,2012-06-16,1,6,2,0,6,0,1,0.58,0.5455,0.53,0.0,12,55,67,67,2,Pagi
12647,2012-06-16,1,6,3,0,6,0,1,0.56,0.5303,0.6,0.0896,8,19,27,27,2,Pagi
12648,2012-06-16,1,6,4,0,6,0,1,0.54,0.5152,0.68,0.1343,3,5,8,8,2,Pagi
12649,2012-06-16,1,6,5,0,6,0,1,0.54,0.5152,0.68,0.1045,2,21,23,23,2,Pagi
12650,2012-06-16,1,6,6,0,6,0,1,0.54,0.5152,0.68,0.194,11,36,47,47,2,Pagi
12651,2012-06-16,1,6,7,0,6,0,1,0.54,0.5152,0.68,0.194,10,68,78,78,2,Siang
12652,2012-06-16,1,6,8,0,6,0,1,0.58,0.5455,0.64,0.1642,47,157,204,204,2,Siang
12653,2012-06-16,1,6,9,0,6,0,1,0.6,0.6061,0.6,0.0896,88,279,367,367,2,Siang
12654,2012-06-16,1,6,10,0,6,0,1,0.64,0.6212,0.47,0.194,139,296,435,435,2,Siang
12655,2012-06-16,1,6,11,0,6,0,1,0.66,0.6212,0.39,0.1642,213,353,566,566,2,Siang
12656,2012-06-16,1,6,12,0,6,0,1,0.68,0.6364,0.41,0.1045,254,349,603,603,2,Siang
12657,2012-06-16,1,6,13,0,6,0,1,0.72,0.6515,0.34,0.1642,293,324,617,617,2,Sore
12658,2012-06-16,1,6,14,0,6,0,1,0.72,0.6515,0.37,0.2239,264,309,573,573,2,Sore
12659,2012-06-16,1,6,15,0,6,0,1,0.74,0.6515,0.35,0.2537,295,288,583,583,2,Sore
12660,2012-06-16,1,6,16,0,6,0,2,0.72,0.6515,0.37,0.1045,238,304,542,542,2,Sore
12661,2012-06-16,1,6,17,0,6,0,2,0.72,0.6515,0.37,0.2537,244,349,593,593,2,Sore
12662,2012-06-16,1,6,18,0,6,0,2,0.72,0.6515,0.37,0.2239,256,315,571,571,2,Sore
12663,2012-06-16,1,6,19,0,6,0,2,0.7,0.6364,0.42,0.194,184,277,461,461,2,Malam
12664,2012-06-16,1,6,20,0,6,0,2,0.66,0.6212,0.47,0.194,123,229,352,352,2,Malam
12665,2012-06-16,1,6,21,0,6,0,2,0.64,0.6212,0.5,0.2239,98,192,290,290,2,Malam
12666,2012-06-16,1,6,22,0,6,0,1,0.62,0.6212,0.53,0.2985,91,189,280,280,2,Malam
12667,2012-06-16,1,6,23,0,6,0,1,0.6,0.6212,0.53,0.2985,49,134,183,183,2,Malam
12668,2012-06-17,1,6,0,0,0,0,1,0.56,0.5303,0.56,0.1343,31,117,148,148,2,
12669,2012-06-17,1,6,1,0,0,0,1,0.56,0.5303,0.6,0.1642,21,67,88,88,2,Pagi
12670,2012-06-17,1,6,2,0,0,0,1,0.56,0.5303,0.56,0.0896,19,55,74,74,2,Pagi
12671,2012-06-17,1,6,3,0,0,0,1,0.54,0.5152,0.64,0.1045,6,22,28,28,2,Pagi
12672,2012-06-17,1,6,4,0,0,0,1,0.54,0.5152,0.64,0.0896,2,16,18,18,2,Pagi
12673,2012-06-17,1,6,5,0,0,0,1,0.54,0.5152,0.68,0.1343,4,13,17,17,2,Pagi
12674,2012-06-17,1,6,6,0,0,0,1,0.52,0.5,0.72,0.1045,7,16,23,23,2,Pagi
12675,2012-06-17,1,6,7,0,0,0,1,0.52,0.5,0.72,0.0896,18,30,48,48,2,Siang
12676,2012-06-17,1,6,8,0,0,0,1,0.56,0.5303,0.68,0.2537,24,95,119,119,2,Siang
12677,2012-06-17,1,6,9,0,0,0,1,0.56,0.5303,0.68,0.1642,91,183,274,274,2,Siang
12678,2012-06-17,1,6,10,0,0,0,1,0.58,0.5455,0.64,0.0,148,288,436,436,2,Siang
12679,2012-06-17,1,6,11,0,0,0,1,0.62,0.6212,0.57,0.1045,196,350,546,546,2,Siang
12680,2012-06-17,1,6,12,0,0,0,1,0.62,0.6212,0.57,0.0,260,355,615,615,2,Siang
12681,2012-06-17,1,6,13,0,0,0,1,0.64,0.6212,0.53,0.1642,267,347,614,614,2,Sore
12682,2012-06-17,1,6,14,0,0,0,1,0.64,0.6212,0.53,0.0,255,327,582,582,2,Sore
12683,2012-06-17,1,6,15,0,0,0,1,0.66,0.6212,0.5,0.2239,203,260,463,463,2,Sore
12684,2012-06-17,1,6,16,0,0,0,1,0.66,0.6212,0.54,0.2985,240,340,580,580,2,Sore
12685,2012-06-17,1,6,17,0,0,0,1,0.64,0.6212,0.57,0.2239,232,361,593,593,2,Sore
12686,2012-06-17,1,6,18,0,0,0,1,0.64,0.6212,0.53,0.194,203,310,513,513,2,Sore
12687,2012-06-17,1,6,19,0,0,0,1,0.64,0.6212,0.53,0.1642,146,244,390,390,2,Malam
12688,2012-06-17,1,6,20,0,0,0,1,0.62,0.6212,0.57,0.194,101,201,302,302,2,Malam
12689,2012-06-17,1,6,21,0,0,0,1,0.62,0.6212,0.57,0.194,76,170,246,246,2,Malam
12690,2012-06-17,1,6,22,0,0,0,1,0.6,0.6061,0.6,0.194,55,98,153,153,2,Malam
12691,2012-06-17,1,6,23,0,0,0,1,0.58,0.5455,0.64,0.194,29,79,108,108,2,Malam
12692,2012-06-18,1,6,0,0,1,1,1,0.56,0.5303,0.73,0.2537,12,28,40,40,2,
12693,2012-06-18,1,6,1,0,1,1,1,0.54,0.5152,0.77,0.2239,9,5,14,14,2,Pagi
12694,2012-06-18,1,6,2,0,1,1,1,0.54,0.5152,0.77,0.2239,3,6,9,9,2,Pagi
12695,2012-06-18,1,6,3,0,1,1,2,0.52,0.5,0.83,0.2239,1,3,4,4,2,Pagi
12696,2012-06-18,1,6,4,0,1,1,2,0.54,0.5152,0.77,0.194,0,9,9,9,2,Pagi
12697,2012-06-18,1,6,5,0,1,1,3,0.52,0.5,0.83,0.1343,1,22,23,23,2,Pagi
12698,2012-06-18,1,6,6,0,1,1,3,0.52,0.5,0.88,0.1343,0,37,37,37,2,Pagi
12699,2012-06-18,1,6,7,0,1,1,3,0.52,0.5,0.94,0.2239,10,135,145,145,2,Siang
12700,2012-06-18,1,6,8,0,1,1,2,0.54,0.5152,0.83,0.194,27,447,474,474,2,Siang
12701,2012-06-18,1,6,9,0,1,1,2,0.54,0.5152,0.83,0.2239,28,222,250,250,2,Siang
12702,2012-06-18,1,6,10,0,1,1,3,0.54,0.5152,0.88,0.1045,13,78,91,91,2,Siang
12703,2012-06-18,1,6,11,0,1,1,2,0.54,0.5152,0.88,0.1642,25,96,121,121,2,Siang
12704,2012-06-18,1,6,12,0,1,1,3,0.56,0.5303,0.78,0.1343,29,139,168,168,2,Siang
12705,2012-06-18,1,6,13,0,1,1,2,0.58,0.5455,0.73,0.1343,51,174,225,225,2,Sore
12706,2012-06-18,1,6,14,0,1,1,2,0.58,0.5455,0.68,0.194,59,160,219,219,2,Sore
12707,2012-06-18,1,6,15,0,1,1,2,0.6,0.5909,0.69,0.194,61,176,237,237,2,Sore
12708,2012-06-18,1,6,16,0,1,1,2,0.6,0.5909,0.73,0.194,53,279,332,332,2,Sore
12709,2012-06-18,1,6,17,0,1,1,2,0.6,0.5909,0.73,0.194,54,669,723,723,2,Sore
12710,2012-06-18,1,6,18,0,1,1,2,0.62,0.6061,0.69,0.1642,47,595,642,642,2,Sore
12711,2012-06-18,1,6,19,0,1,1,2,0.62,0.5909,0.73,0.0896,52,411,463,463,2,Malam
12712,2012-06-18,1,6,20,0,1,1,2,0.62,0.5909,0.73,0.1343,45,317,362,362,2,Malam
12713,2012-06-18,1,6,21,0,1,1,2,0.62,0.5909,0.73,0.1045,35,238,273,273,2,Malam
12714,2012-06-18,1,6,22,0,1,1,2,0.62,0.5909,0.73,0.1642,21,143,164,164,2,Malam
12715,2012-06-18,1,6,23,0,1,1,3,0.6,0.5758,0.78,0.194,17,57,74,74,2,Malam
12716,2012-06-19,1,6,0,0,2,1,2,0.6,0.5758,0.78,0.1642,5,30,35,35,2,
12717,2012-06-19,1,6,1,0,2,1,2,0.6,0.5758,0.78,0.1642,1,13,14,14,2,Pagi
12718,2012-06-19,1,6,2,0,2,1,2,0.6,0.5758,0.78,0.1343,1,14,15,15,2,Pagi
12719,2012-06-19,1,6,3,0,2,1,2,0.6,0.5758,0.78,0.1045,1,7,8,8,2,Pagi
12720,2012-06-19,1,6,4,0,2,1,2,0.6,0.5758,0.78,0.1343,1,9,10,10,2,Pagi
12721,2012-06-19,1,6,5,0,2,1,2,0.6,0.5758,0.78,0.194,3,34,37,37,2,Pagi
12722,2012-06-19,1,6,6,0,2,1,2,0.6,0.5758,0.78,0.1045,9,152,161,161,2,Pagi
12723,2012-06-19,1,6,7,0,2,1,2,0.6,0.5758,0.78,0.1343,18,462,480,480,2,Siang
12724,2012-06-19,1,6,8,0,2,1,2,0.6,0.5758,0.78,0.1642,40,633,673,673,2,Siang
12725,2012-06-19,1,6,9,0,2,1,1,0.64,0.6061,0.73,0.0896,40,288,328,328,2,Siang
12726,2012-06-19,1,6,10,0,2,1,1,0.64,0.6061,0.73,0.0896,44,136,180,180,2,Siang
12727,2012-06-19,1,6,11,0,2,1,1,0.66,0.6212,0.69,0.1343,56,174,230,230,2,Siang
12728,2012-06-19,1,6,12,0,2,1,1,0.7,0.6515,0.65,0.0896,70,222,292,292,2,Siang
12729,2012-06-19,1,6,13,0,2,1,1,0.74,0.6818,0.58,0.1343,69,203,272,272,2,Sore
12730,2012-06-19,1,6,14,0,2,1,1,0.76,0.7121,0.58,0.1045,61,166,227,227,2,Sore
12731,2012-06-19,1,6,15,0,2,1,1,0.78,0.7424,0.59,0.1642,72,187,259,259,2,Sore
12732,2012-06-19,1,6,16,0,2,1,1,0.8,0.7576,0.55,0.2239,48,286,334,334,2,Sore
12733,2012-06-19,1,6,17,0,2,1,1,0.8,0.7576,0.55,0.194,86,725,811,811,2,Sore
12734,2012-06-19,1,6,18,0,2,1,1,0.8,0.7576,0.55,0.1642,91,704,795,795,2,Sore
12735,2012-06-19,1,6,19,0,2,1,1,0.8,0.7727,0.59,0.2239,82,432,514,514,2,Malam
12736,2012-06-19,1,6,20,0,2,1,1,0.8,0.7576,0.55,0.2537,59,399,458,458,2,Malam
12737,2012-06-19,1,6,21,0,2,1,1,0.76,0.7121,0.62,0.1642,37,239,276,276,2,Malam
12738,2012-06-19,1,6,22,0,2,1,1,0.72,0.697,0.79,0.0896,51,240,291,291,2,Malam
12739,2012-06-19,1,6,23,0,2,1,1,0.72,0.697,0.79,0.1343,23,102,125,125,2,Malam
12740,2012-06-20,1,6,0,0,3,1,1,0.7,0.6667,0.79,0.194,5,48,53,53,2,
12741,2012-06-20,1,6,1,0,3,1,1,0.68,0.6364,0.79,0.194,7,20,27,27,2,Pagi
12742,2012-06-20,1,6,2,0,3,1,1,0.66,0.6061,0.83,0.1642,1,5,6,6,2,Pagi
12743,2012-06-20,1,6,3,0,3,1,1,0.66,0.6061,0.83,0.1343,2,6,8,8,2,Pagi
12744,2012-06-20,1,6,4,0,3,1,1,0.66,0.6061,0.83,0.0896,1,6,7,7,2,Pagi
12745,2012-06-20,1,6,5,0,3,1,1,0.66,0.6061,0.83,0.0896,2,37,39,39,2,Pagi
12746,2012-06-20,1,6,6,0,3,1,2,0.64,0.5758,0.89,0.0896,9,156,165,165,2,Pagi
12747,2012-06-20,1,6,7,0,3,1,2,0.66,0.5909,0.89,0.0,20,444,464,464,2,Siang
12748,2012-06-20,1,6,8,0,3,1,2,0.7,0.6667,0.79,0.1045,43,600,643,643,2,Siang
12749,2012-06-20,1,6,9,0,3,1,2,0.72,0.697,0.74,0.0,40,276,316,316,2,Siang
12750,2012-06-20,1,6,10,0,3,1,1,0.82,0.7727,0.52,0.1343,41,126,167,167,2,Siang
12751,2012-06-20,1,6,11,0,3,1,1,0.84,0.7879,0.49,0.194,54,134,188,188,2,Siang
12752,2012-06-20,1,6,12,0,3,1,1,0.86,0.803,0.47,0.1642,30,150,180,180,2,Siang
12753,2012-06-20,1,6,13,0,3,1,1,0.86,0.7879,0.44,0.1045,48,163,211,211,2,Sore
12754,2012-06-20,1,6,14,0,3,1,1,0.88,0.803,0.39,0.194,56,134,190,190,2,Sore
12755,2012-06-20,1,6,15,0,3,1,1,0.9,0.8182,0.35,0.0,36,143,179,179,2,Sore
12756,2012-06-20,1,6,16,0,3,1,1,0.9,0.8182,0.35,0.1045,51,284,335,335,2,Sore
12757,2012-06-20,1,6,17,0,3,1,1,0.9,0.8182,0.37,0.0,80,611,691,691,2,Sore
12758,2012-06-20,1,6,18,0,3,1,1,0.9,0.8182,0.37,0.0,81,591,672,672,2,Sore
12759,2012-06-20,1,6,19,0,3,1,1,0.88,0.7879,0.37,0.2537,90,449,539,539,2,Malam
12760,2012-06-20,1,6,20,0,3,1,1,0.86,0.7727,0.39,0.2239,81,326,407,407,2,Malam
12761,2012-06-20,1,6,21,0,3,1,1,0.84,0.7576,0.44,0.0896,42,302,344,344,2,Malam
12762,2012-06-20,1,6,22,0,3,1,1,0.82,0.7576,0.46,0.1045,31,226,257,257,2,Malam
12763,2012-06-20,1,6,23,0,3,1,1,0.78,0.7424,0.59,0.1045,21,102,123,123,2,Malam
12764,2012-06-21,1,6,0,0,4,1,1,0.74,0.697,0.7,0.0896,16,53,69,69,3,
12765,2012-06-21,1,6,1,0,4,1,1,0.72,0.697,0.79,0.1343,2,16,18,18,3,Pagi
12766,2012-06-21,1,6,2,0,4,1,1,0.72,0.697,0.79,0.1045,11,7,18,18,3,Pagi
12767,2012-06-21,1,6,3,0,4,1,1,0.72,0.697,0.74,0.0,3,8,11,11,3,Pagi
12768,2012-06-21,1,6,4,0,4,1,1,0.7,0.6667,0.84,0.0896,1,11,12,12,3,Pagi
12769,2012-06-21,1,6,5,0,4,1,1,0.7,0.6667,0.84,0.1045,3,37,40,40,3,Pagi
12770,2012-06-21,1,6,6,0,4,1,2,0.7,0.6667,0.84,0.0896,3,147,150,150,3,Pagi
12771,2012-06-21,1,6,7,0,4,1,2,0.7,0.6667,0.84,0.0896,26,437,463,463,3,Siang
12772,2012-06-21,1,6,8,0,4,1,1,0.74,0.697,0.7,0.0,27,563,590,590,3,Siang
12773,2012-06-21,1,6,9,0,4,1,1,0.8,0.7576,0.55,0.194,32,224,256,256,3,Siang
12774,2012-06-21,1,6,10,0,4,1,1,0.84,0.7879,0.49,0.1045,36,114,150,150,3,Siang
12775,2012-06-21,1,6,11,0,4,1,1,0.86,0.7879,0.41,0.1343,40,121,161,161,3,Siang
12776,2012-06-21,1,6,12,0,4,1,1,0.9,0.8182,0.35,0.194,33,182,215,215,3,Siang
12777,2012-06-21,1,6,13,0,4,1,1,0.9,0.8182,0.35,0.0,31,141,172,172,3,Sore
12778,2012-06-21,1,6,14,0,4,1,1,0.88,0.7879,0.37,0.1642,27,149,176,176,3,Sore
12779,2012-06-21,1,6,15,0,4,1,1,0.92,0.8333,0.33,0.1642,40,154,194,194,3,Sore
12780,2012-06-21,1,6,16,0,4,1,1,0.9,0.8182,0.35,0.1343,37,283,320,320,3,Sore
12781,2012-06-21,1,6,17,0,4,1,1,0.88,0.7879,0.37,0.0,80,535,615,615,3,Sore
12782,2012-06-21,1,6,18,0,4,1,1,0.86,0.7879,0.41,0.194,78,562,640,640,3,Sore
12783,2012-06-21,1,6,19,0,4,1,1,0.88,0.803,0.39,0.2239,84,415,499,499,3,Malam
12784,2012-06-21,1,6,20,0,4,1,1,0.86,0.7879,0.44,0.194,79,357,436,436,3,Malam
12785,2012-06-21,1,6,21,0,4,1,1,0.82,0.7727,0.52,0.194,55,256,311,311,3,Malam
12786,2012-06-21,1,6,22,0,4,1,1,0.8,0.7879,0.63,0.1642,22,221,243,243,3,Malam
12787,2012-06-21,1,6,23,0,4,1,1,0.8,0.7727,0.59,0.0896,12,134,146,146,3,Malam
12788,2012-06-22,1,6,0,0,5,1,2,0.76,0.7273,0.7,0.1045,16,77,93,93,3,
12789,2012-06-22,1,6,1,0,5,1,1,0.76,0.7424,0.75,0.1642,3,28,31,31,3,Pagi
12790,2012-06-22,1,6,2,0,5,1,1,0.74,0.7121,0.79,0.0,0,12,12,12,3,Pagi
12791,2012-06-22,1,6,3,0,5,1,1,0.74,0.7121,0.79,0.0,1,6,7,7,3,Pagi
12792,2012-06-22,1,6,4,0,5,1,2,0.76,0.7273,0.66,0.0,3,7,10,10,3,Pagi
12793,2012-06-22,1,6,5,0,5,1,2,0.74,0.697,0.66,0.0896,3,35,38,38,3,Pagi
12794,2012-06-22,1,6,6,0,5,1,2,0.74,0.697,0.66,0.0,4,118,122,122,3,Pagi
12795,2012-06-22,1,6,7,0,5,1,1,0.74,0.6818,0.58,0.1642,19,340,359,359,3,Siang
12796,2012-06-22,1,6,8,0,5,1,1,0.76,0.697,0.55,0.1343,49,564,613,613,3,Siang
12797,2012-06-22,1,6,9,0,5,1,1,0.76,0.7121,0.58,0.2239,55,278,333,333,3,Siang
12798,2012-06-22,1,6,10,0,5,1,1,0.8,0.7424,0.52,0.3582,52,133,185,185,3,Siang
12799,2012-06-22,1,6,11,0,5,1,1,0.8,0.7424,0.49,0.1642,76,160,236,236,3,Siang
12800,2012-06-22,1,6,12,0,5,1,1,0.84,0.7879,0.49,0.1343,63,191,254,254,3,Siang
12801,2012-06-22,1,6,13,0,5,1,1,0.88,0.803,0.39,0.2239,72,228,300,300,3,Sore
12802,2012-06-22,1,6,14,0,5,1,1,0.88,0.803,0.39,0.2239,65,198,263,263,3,Sore
12803,2012-06-22,1,6,15,0,5,1,1,0.9,0.8182,0.35,0.3582,72,212,284,284,3,Sore
12804,2012-06-22,1,6,16,0,5,1,1,0.9,0.803,0.31,0.2239,67,313,380,380,3,Sore
12805,2012-06-22,1,6,17,0,5,1,2,0.82,0.7273,0.38,0.1642,95,551,646,646,3,Sore
12806,2012-06-22,1,6,18,0,5,1,2,0.8,0.7576,0.55,0.194,62,443,505,505,3,Sore
12807,2012-06-22,1,6,19,0,5,1,2,0.76,0.697,0.55,0.5224,45,317,362,362,3,Malam
12808,2012-06-22,1,6,20,0,5,1,2,0.76,0.697,0.55,0.5224,31,171,202,202,3,Malam
12809,2012-06-22,1,6,21,0,5,1,3,0.68,0.6364,0.65,0.2836,40,177,217,217,3,Malam
12810,2012-06-22,1,6,22,0,5,1,1,0.68,0.6364,0.69,0.1343,42,155,197,197,3,Malam
12811,2012-06-22,1,6,23,0,5,1,2,0.66,0.6212,0.74,0.0,29,145,174,174,3,Malam
12812,2012-06-23,1,6,0,0,6,0,1,0.64,0.5758,0.83,0.0,14,102,116,116,3,
12813,2012-06-23,1,6,1,0,6,0,1,0.66,0.6061,0.78,0.1343,16,107,123,123,3,Pagi
12814,2012-06-23,1,6,2,0,6,0,2,0.64,0.5758,0.83,0.194,18,75,93,93,3,Pagi
12815,2012-06-23,1,6,3,0,6,0,2,0.64,0.5758,0.83,0.0896,10,32,42,42,3,Pagi
12816,2012-06-23,1,6,4,0,6,0,2,0.64,0.5758,0.83,0.1642,6,13,19,19,3,Pagi
12817,2012-06-23,1,6,5,0,6,0,2,0.64,0.5758,0.83,0.194,1,11,12,12,3,Pagi
12818,2012-06-23,1,6,6,0,6,0,1,0.64,0.5758,0.83,0.0896,10,37,47,47,3,Pagi
12819,2012-06-23,1,6,7,0,6,0,1,0.64,0.5758,0.83,0.1642,19,59,78,78,3,Siang
12820,2012-06-23,1,6,8,0,6,0,1,0.68,0.6364,0.69,0.2239,34,133,167,167,3,Siang
12821,2012-06-23,1,6,9,0,6,0,1,0.72,0.6818,0.62,0.194,85,247,332,332,3,Siang
12822,2012-06-23,1,6,10,0,6,0,1,0.74,0.6818,0.55,0.194,177,317,494,494,3,Siang
12823,2012-06-23,1,6,11,0,6,0,1,0.76,0.6818,0.48,0.2239,167,349,516,516,3,Siang
12824,2012-06-23,1,6,12,0,6,0,1,0.8,0.7273,0.43,0.194,203,399,602,602,3,Siang
12825,2012-06-23,1,6,13,0,6,0,1,0.82,0.7273,0.34,0.194,226,338,564,564,3,Sore
12826,2012-06-23,1,6,14,0,6,0,1,0.78,0.6818,0.33,0.2537,238,371,609,609,3,Sore
12827,2012-06-23,1,6,15,0,6,0,1,0.84,0.7273,0.3,0.3284,217,266,483,483,3,Sore
12828,2012-06-23,1,6,16,0,6,0,1,0.84,0.7121,0.26,0.2985,196,317,513,513,3,Sore
12829,2012-06-23,1,6,17,0,6,0,1,0.82,0.7121,0.26,0.2537,214,316,530,530,3,Sore
12830,2012-06-23,1,6,18,0,6,0,1,0.82,0.7121,0.26,0.2985,194,287,481,481,3,Sore
12831,2012-06-23,1,6,19,0,6,0,1,0.8,0.697,0.27,0.194,185,240,425,425,3,Malam
12832,2012-06-23,1,6,20,0,6,0,1,0.78,0.6818,0.31,0.194,158,228,386,386,3,Malam
12833,2012-06-23,1,6,21,0,6,0,1,0.76,0.6667,0.33,0.1343,99,223,322,322,3,Malam
12834,2012-06-23,1,6,22,0,6,0,1,0.74,0.6515,0.37,0.1045,101,178,279,279,3,Malam
12835,2012-06-23,1,6,23,0,6,0,1,0.72,0.6515,0.44,0.0,69,156,225,225,3,Malam
12836,2012-06-24,1,6,0,0,0,0,1,0.7,0.6515,0.51,0.0,31,132,163,163,3,
12837,2012-06-24,1,6,1,0,0,0,2,0.68,0.6364,0.54,0.0896,39,88,127,127,3,Pagi
12838,2012-06-24,1,6,2,0,0,0,2,0.68,0.6364,0.51,0.0,34,80,114,114,3,Pagi
12839,2012-06-24,1,6,3,0,0,0,2,0.66,0.6212,0.65,0.0896,19,41,60,60,3,Pagi
12840,2012-06-24,1,6,4,0,0,0,2,0.66,0.6212,0.65,0.0,4,9,13,13,3,Pagi
12841,2012-06-24,1,6,5,0,0,0,1,0.62,0.6061,0.69,0.1343,1,7,8,8,3,Pagi
12842,2012-06-24,1,6,6,0,0,0,1,0.64,0.6061,0.65,0.1642,6,19,25,25,3,Pagi
12843,2012-06-24,1,6,7,0,0,0,1,0.64,0.6061,0.69,0.1045,23,48,71,71,3,Siang
12844,2012-06-24,1,6,8,0,0,0,1,0.7,0.6515,0.58,0.0,38,103,141,141,3,Siang
12845,2012-06-24,1,6,9,0,0,0,1,0.72,0.6667,0.51,0.0,63,169,232,232,3,Siang
12846,2012-06-24,1,6,10,0,0,0,1,0.76,0.6818,0.4,0.0,161,291,452,452,3,Siang
12847,2012-06-24,1,6,11,0,0,0,1,0.76,0.6818,0.4,0.1343,215,291,506,506,3,Siang
12848,2012-06-24,1,6,12,0,0,0,1,0.8,0.697,0.33,0.2239,227,329,556,556,3,Siang
12849,2012-06-24,1,6,13,0,0,0,1,0.8,0.697,0.33,0.2836,237,348,585,585,3,Sore
12850,2012-06-24,1,6,14,0,0,0,1,0.84,0.7273,0.3,0.2985,253,298,551,551,3,Sore
12851,2012-06-24,1,6,15,0,0,0,1,0.86,0.7424,0.28,0.2239,197,290,487,487,3,Sore
12852,2012-06-24,1,6,16,0,0,0,1,0.84,0.7273,0.3,0.2537,181,280,461,461,3,Sore
12853,2012-06-24,1,6,17,0,0,0,1,0.84,0.7273,0.32,0.2537,203,329,532,532,3,Sore
12854,2012-06-24,1,6,18,0,0,0,1,0.82,0.7273,0.34,0.2537,186,348,534,534,3,Sore
12855,2012-06-24,1,6,19,0,0,0,1,0.8,0.7121,0.38,0.2985,176,247,423,423,3,Malam
12856,2012-06-24,1,6,20,0,0,0,1,0.78,0.697,0.46,0.2537,108,224,332,332,3,Malam
12857,2012-06-24,1,6,21,0,0,0,1,0.76,0.697,0.55,0.2239,76,177,253,253,3,Malam
12858,2012-06-24,1,6,22,0,0,0,1,0.74,0.6818,0.55,0.1045,53,125,178,178,3,Malam
12859,2012-06-24,1,6,23,0,0,0,1,0.74,0.6818,0.58,0.1045,20,67,87,87,3,Malam
12860,2012-06-25,1,6,0,0,1,1,1,0.72,0.6818,0.62,0.2537,31,37,68,68,3,
12861,2012-06-25,1,6,1,0,1,1,1,0.7,0.6515,0.65,0.2239,11,20,31,31,3,Pagi
12862,2012-06-25,1,6,2,0,1,1,1,0.7,0.6515,0.7,0.2239,4,10,14,14,3,Pagi
12863,2012-06-25,1,6,3,0,1,1,1,0.68,0.6364,0.69,0.2537,1,4,5,5,3,Pagi
12864,2012-06-25,1,6,4,0,1,1,1,0.66,0.6061,0.78,0.2537,0,4,4,4,3,Pagi
12865,2012-06-25,1,6,5,0,1,1,1,0.66,0.6212,0.74,0.1642,1,42,43,43,3,Pagi
12866,2012-06-25,1,6,6,0,1,1,1,0.64,0.5909,0.78,0.1642,11,147,158,158,3,Pagi
12867,2012-06-25,1,6,7,0,1,1,1,0.66,0.6212,0.74,0.2239,30,455,485,485,3,Siang
12868,2012-06-25,1,6,8,0,1,1,1,0.66,0.6212,0.69,0.194,53,555,608,608,3,Siang
12869,2012-06-25,1,6,9,0,1,1,1,0.7,0.6515,0.65,0.194,37,231,268,268,3,Siang
12870,2012-06-25,1,6,10,0,1,1,1,0.76,0.697,0.55,0.1642,58,126,184,184,3,Siang
12871,2012-06-25,1,6,11,0,1,1,1,0.8,0.7273,0.43,0.3284,54,127,181,181,3,Siang
12872,2012-06-25,1,6,12,0,1,1,2,0.76,0.6818,0.45,0.2985,74,196,270,270,3,Siang
12873,2012-06-25,1,6,13,0,1,1,1,0.72,0.6667,0.51,0.2985,79,181,260,260,3,Sore
12874,2012-06-25,1,6,14,0,1,1,1,0.78,0.697,0.43,0.2537,90,161,251,251,3,Sore
12875,2012-06-25,1,6,15,0,1,1,1,0.78,0.6818,0.38,0.4627,65,168,233,233,3,Sore
12876,2012-06-25,1,6,16,0,1,1,1,0.8,0.697,0.31,0.3881,104,310,414,414,3,Sore
12877,2012-06-25,1,6,17,0,1,1,1,0.8,0.6818,0.24,0.4627,76,757,833,833,3,Sore
12878,2012-06-25,1,6,18,0,1,1,1,0.76,0.6667,0.27,0.4478,100,691,791,791,3,Sore
12879,2012-06-25,1,6,19,0,1,1,1,0.74,0.6515,0.27,0.4627,74,508,582,582,3,Malam
12880,2012-06-25,1,6,20,0,1,1,1,0.72,0.6515,0.3,0.4478,100,375,475,475,3,Malam
12881,2012-06-25,1,6,21,0,1,1,1,0.68,0.6212,0.3,0.3284,50,281,331,331,3,Malam
12882,2012-06-25,1,6,22,0,1,1,1,0.66,0.6212,0.29,0.3881,21,166,187,187,3,Malam
12883,2012-06-25,1,6,23,0,1,1,1,0.64,0.6212,0.33,0.3284,15,88,103,103,3,Malam
12884,2012-06-26,1,6,0,0,2,1,1,0.62,0.6212,0.33,0.3284,8,29,37,37,3,
12885,2012-06-26,1,6,1,0,2,1,1,0.6,0.6212,0.35,0.3881,11,19,30,30,3,Pagi
12886,2012-06-26,1,6,2,0,2,1,1,0.56,0.5303,0.43,0.2836,2,7,9,9,3,Pagi
12887,2012-06-26,1,6,3,0,2,1,1,0.54,0.5152,0.45,0.2836,2,7,9,9,3,Pagi
12888,2012-06-26,1,6,4,0,2,1,1,0.54,0.5152,0.45,0.2985,1,9,10,10,3,Pagi
12889,2012-06-26,1,6,5,0,2,1,1,0.52,0.5,0.48,0.3881,3,36,39,39,3,Pagi
12890,2012-06-26,1,6,6,0,2,1,1,0.52,0.5,0.52,0.2985,12,176,188,188,3,Pagi
12891,2012-06-26,1,6,7,0,2,1,1,0.52,0.5,0.52,0.3582,21,531,552,552,3,Siang
12892,2012-06-26,1,6,8,0,2,1,1,0.56,0.5303,0.49,0.3284,34,622,656,656,3,Siang
12893,2012-06-26,1,6,9,0,2,1,1,0.58,0.5455,0.46,0.4179,30,298,328,328,3,Siang
12894,2012-06-26,1,6,10,0,2,1,1,0.62,0.6212,0.41,0.3582,37,153,190,190,3,Siang
12895,2012-06-26,1,6,11,0,2,1,1,0.64,0.6212,0.36,0.4179,46,189,235,235,3,Siang
12896,2012-06-26,1,6,12,0,2,1,1,0.66,0.6212,0.34,0.4478,80,228,308,308,3,Siang
12897,2012-06-26,1,6,13,0,2,1,1,0.7,0.6364,0.3,0.4627,74,232,306,306,3,Sore
12898,2012-06-26,1,6,14,0,2,1,1,0.7,0.6364,0.3,0.4627,81,186,267,267,3,Sore
12899,2012-06-26,1,6,15,0,2,1,1,0.72,0.6515,0.28,0.4627,88,229,317,317,3,Sore
12900,2012-06-26,1,6,16,0,2,1,1,0.72,0.6364,0.26,0.4925,67,349,416,416,3,Sore
12901,2012-06-26,1,6,17,0,2,1,1,0.72,0.6515,0.28,0.4179,104,796,900,900,3,Sore
12902,2012-06-26,1,6,18,0,2,1,1,0.72,0.6515,0.28,0.3582,105,719,824,824,3,Sore
12903,2012-06-26,1,6,19,0,2,1,1,0.72,0.6515,0.28,0.2239,83,529,612,612,3,Malam
12904,2012-06-26,1,6,20,0,2,1,1,0.7,0.6364,0.3,0.2836,88,417,505,505,3,Malam
12905,2012-06-26,1,6,21,0,2,1,1,0.68,0.6364,0.34,0.194,61,267,328,328,3,Malam
12906,2012-06-26,1,6,22,0,2,1,1,0.66,0.6212,0.34,0.2537,26,219,245,245,3,Malam
12907,2012-06-26,1,6,23,0,2,1,1,0.62,0.6212,0.41,0.1343,13,118,131,131,3,Malam
12908,2012-06-27,1,6,0,0,3,1,1,0.62,0.6212,0.41,0.194,15,39,54,54,3,
12909,2012-06-27,1,6,1,0,3,1,1,0.6,0.6212,0.43,0.1642,5,18,23,23,3,Pagi
12910,2012-06-27,1,6,2,0,3,1,1,0.56,0.5303,0.49,0.1343,2,12,14,14,3,Pagi
12911,2012-06-27,1,6,3,0,3,1,1,0.58,0.5455,0.46,0.0896,1,7,8,8,3,Pagi
12912,2012-06-27,1,6,4,0,3,1,1,0.6,0.6212,0.4,0.2537,0,11,11,11,3,Pagi
12913,2012-06-27,1,6,5,0,3,1,1,0.6,0.6212,0.43,0.2836,2,34,36,36,3,Pagi
12914,2012-06-27,1,6,6,0,3,1,1,0.58,0.5455,0.46,0.2836,7,193,200,200,3,Pagi
12915,2012-06-27,1,6,7,0,3,1,1,0.6,0.6212,0.43,0.3582,29,498,527,527,3,Siang
12916,2012-06-27,1,6,8,0,3,1,1,0.62,0.6212,0.43,0.3284,49,638,687,687,3,Siang
12917,2012-06-27,1,6,9,0,3,1,1,0.66,0.6212,0.41,0.3582,29,253,282,282,3,Siang
12918,2012-06-27,1,6,10,0,3,1,1,0.7,0.6364,0.37,0.2537,34,138,172,172,3,Siang
12919,2012-06-27,1,6,11,0,3,1,1,0.74,0.6515,0.3,0.3284,64,145,209,209,3,Siang
12920,2012-06-27,1,6,12,0,3,1,1,0.76,0.6667,0.29,0.2985,77,245,322,322,3,Siang
12921,2012-06-27,1,6,13,0,3,1,1,0.8,0.697,0.27,0.3284,77,244,321,321,3,Sore
12922,2012-06-27,1,6,14,0,3,1,1,0.8,0.6818,0.24,0.3582,78,192,270,270,3,Sore
12923,2012-06-27,1,6,15,0,3,1,1,0.8,0.697,0.26,0.4627,61,188,249,249,3,Sore
12924,2012-06-27,1,6,16,0,3,1,1,0.82,0.697,0.24,0.4478,55,337,392,392,3,Sore
12925,2012-06-27,1,6,17,0,3,1,1,0.82,0.697,0.24,0.3881,113,730,843,843,3,Sore
12926,2012-06-27,1,6,18,0,3,1,1,0.8,0.697,0.27,0.3284,85,719,804,804,3,Sore
12927,2012-06-27,1,6,19,0,3,1,1,0.78,0.6818,0.29,0.3284,101,542,643,643,3,Malam
12928,2012-06-27,1,6,20,0,3,1,1,0.76,0.6667,0.31,0.194,76,369,445,445,3,Malam
12929,2012-06-27,1,6,21,0,3,1,1,0.74,0.6515,0.35,0.1343,54,313,367,367,3,Malam
12930,2012-06-27,1,6,22,0,3,1,1,0.72,0.6515,0.39,0.0896,52,245,297,297,3,Malam
12931,2012-06-27,1,6,23,0,3,1,1,0.68,0.6364,0.47,0.1343,11,148,159,159,3,Malam
12932,2012-06-28,1,6,0,0,4,1,1,0.66,0.6212,0.5,0.1045,2,52,54,54,3,
12933,2012-06-28,1,6,1,0,4,1,1,0.66,0.6212,0.54,0.0,11,14,25,25,3,Pagi
12934,2012-06-28,1,6,2,0,4,1,1,0.66,0.6212,0.5,0.0896,1,12,13,13,3,Pagi
12935,2012-06-28,1,6,3,0,4,1,1,0.66,0.6212,0.5,0.0896,1,6,7,7,3,Pagi
12936,2012-06-28,1,6,4,0,4,1,1,0.62,0.6061,0.61,0.1045,0,11,11,11,3,Pagi
12937,2012-06-28,1,6,5,0,4,1,1,0.62,0.6212,0.57,0.0896,8,39,47,47,3,Pagi
12938,2012-06-28,1,6,6,0,4,1,1,0.62,0.6212,0.57,0.0896,8,185,193,193,3,Pagi
12939,2012-06-28,1,6,7,0,4,1,1,0.62,0.6061,0.61,0.1045,24,484,508,508,3,Siang
12940,2012-06-28,1,6,8,0,4,1,1,0.66,0.6212,0.5,0.1343,40,577,617,617,3,Siang
12941,2012-06-28,1,6,9,0,4,1,1,0.7,0.6515,0.54,0.1642,33,318,351,351,3,Siang
12942,2012-06-28,1,6,10,0,4,1,1,0.74,0.6667,0.48,0.194,40,144,184,184,3,Siang
12943,2012-06-28,1,6,11,0,4,1,1,0.8,0.697,0.31,0.194,41,170,211,211,3,Siang
12944,2012-06-28,1,6,12,0,4,1,1,0.84,0.7121,0.26,0.2836,49,227,276,276,3,Siang
12945,2012-06-28,1,6,13,0,4,1,1,0.86,0.7424,0.26,0.2239,31,205,236,236,3,Sore
12946,2012-06-28,1,6,14,0,4,1,1,0.86,0.7273,0.25,0.3284,66,188,254,254,3,Sore
12947,2012-06-28,1,6,15,0,4,1,1,0.86,0.7273,0.25,0.3284,24,195,219,219,3,Sore
12948,2012-06-28,1,6,16,0,4,1,1,0.88,0.7424,0.23,0.194,56,331,387,387,3,Sore
12949,2012-06-28,1,6,17,0,4,1,1,0.88,0.7424,0.22,0.194,71,634,705,705,3,Sore
12950,2012-06-28,1,6,18,0,4,1,1,0.86,0.7273,0.25,0.2239,100,597,697,697,3,Sore
12951,2012-06-28,1,6,19,0,4,1,1,0.84,0.7273,0.3,0.2985,79,492,571,571,3,Malam
12952,2012-06-28,1,6,20,0,4,1,1,0.82,0.7273,0.34,0.194,71,399,470,470,3,Malam
12953,2012-06-28,1,6,21,0,4,1,1,0.76,0.697,0.55,0.194,89,309,398,398,3,Malam
12954,2012-06-28,1,6,22,0,4,1,1,0.76,0.697,0.52,0.1642,50,224,274,274,3,Malam
12955,2012-06-28,1,6,23,0,4,1,1,0.74,0.6667,0.48,0.1343,26,145,171,171,3,Malam
12956,2012-06-29,1,6,0,0,5,1,1,0.74,0.6667,0.48,0.1343,24,90,114,114,3,
12957,2012-06-29,1,6,1,0,5,1,1,0.74,0.6667,0.51,0.1642,9,33,42,42,3,Pagi
12958,2012-06-29,1,6,2,0,5,1,1,0.72,0.6667,0.58,0.194,3,15,18,18,3,Pagi
12959,2012-06-29,1,6,3,0,5,1,1,0.72,0.6667,0.58,0.194,3,5,8,8,3,Pagi
12960,2012-06-29,1,6,4,0,5,1,1,0.7,0.6515,0.65,0.1642,1,9,10,10,3,Pagi
12961,2012-06-29,1,6,5,0,5,1,1,0.7,0.6515,0.61,0.1045,6,39,45,45,3,Pagi
12962,2012-06-29,1,6,6,0,5,1,2,0.7,0.6515,0.61,0.1642,15,148,163,163,3,Pagi
12963,2012-06-29,1,6,7,0,5,1,1,0.7,0.6515,0.61,0.1045,19,361,380,380,3,Siang
12964,2012-06-29,1,6,8,0,5,1,2,0.74,0.6818,0.55,0.1045,48,576,624,624,3,Siang
12965,2012-06-29,1,6,9,0,5,1,1,0.76,0.697,0.55,0.1642,39,261,300,300,3,Siang
12966,2012-06-29,1,6,10,0,5,1,1,0.9,0.8333,0.39,0.2985,32,139,171,171,3,Siang
12967,2012-06-29,1,6,11,0,5,1,2,0.9,0.8485,0.42,0.2836,51,137,188,188,3,Siang
12968,2012-06-29,1,6,12,0,5,1,2,0.92,0.8788,0.4,0.2537,53,173,226,226,3,Siang
12969,2012-06-29,1,6,13,0,5,1,1,0.94,0.8788,0.38,0.194,45,194,239,239,3,Sore
12970,2012-06-29,1,6,14,0,5,1,1,0.96,0.9091,0.36,0.2239,49,184,233,233,3,Sore
12971,2012-06-29,1,6,15,0,5,1,1,0.96,0.9091,0.36,0.0,47,183,230,230,3,Sore
12972,2012-06-29,1,6,16,0,5,1,1,0.96,0.9091,0.36,0.0,59,292,351,351,3,Sore
12973,2012-06-29,1,6,17,0,5,1,1,0.98,0.9242,0.34,0.194,82,457,539,539,3,Sore
12974,2012-06-29,1,6,18,0,5,1,1,0.96,0.8636,0.31,0.0,50,414,464,464,3,Sore
12975,2012-06-29,1,6,19,0,5,1,1,0.9,0.8788,0.47,0.194,60,303,363,363,3,Malam
12976,2012-06-29,1,6,20,0,5,1,1,0.92,0.8939,0.42,0.2537,53,255,308,308,3,Malam
12977,2012-06-29,1,6,21,0,5,1,2,0.86,0.8333,0.53,0.194,41,195,236,236,3,Malam
12978,2012-06-29,1,6,22,0,5,1,3,0.82,0.8333,0.63,0.194,34,129,163,163,3,Malam
12979,2012-06-29,1,6,23,0,5,1,3,0.82,0.8333,0.63,0.194,6,42,48,48,3,Malam
12980,2012-06-30,1,6,0,0,6,0,3,0.64,0.5758,0.89,0.1642,4,65,69,69,3,
12981,2012-06-30,1,6,1,0,6,0,3,0.64,0.5758,0.89,0.2239,3,55,58,58,3,Pagi
12982,2012-06-30,1,6,2,0,6,0,2,0.64,0.5758,0.89,0.0,7,54,61,61,3,Pagi
12983,2012-06-30,1,6,3,0,6,0,2,0.64,0.5758,0.89,0.0,3,20,23,23,3,Pagi
12984,2012-06-30,1,6,4,0,6,0,2,0.62,0.5455,0.94,0.0,3,15,18,18,3,Pagi
12985,2012-06-30,1,6,5,0,6,0,1,0.64,0.5758,0.89,0.1642,3,7,10,10,3,Pagi
12986,2012-06-30,1,6,6,0,6,0,1,0.64,0.5758,0.89,0.1642,6,36,42,42,3,Pagi
12987,2012-06-30,1,6,7,0,6,0,1,0.64,0.5758,0.89,0.1642,10,82,92,92,3,Siang
12988,2012-06-30,1,6,8,0,6,0,1,0.64,0.5758,0.89,0.1642,26,168,194,194,3,Siang
12989,2012-06-30,1,6,9,0,6,0,1,0.64,0.5758,0.89,0.1642,41,234,275,275,3,Siang
12990,2012-06-30,1,6,10,0,6,0,1,0.88,0.7727,0.3,0.2537,96,308,404,404,3,Siang
12991,2012-06-30,1,6,11,0,6,0,1,0.88,0.7727,0.3,0.2537,102,350,452,452,3,Siang
12992,2012-06-30,1,6,12,0,6,0,1,0.88,0.7727,0.3,0.2537,143,328,471,471,3,Siang
12993,2012-06-30,1,6,13,0,6,0,1,0.88,0.7727,0.3,0.2537,105,323,428,428,3,Sore
12994,2012-06-30,1,6,14,0,6,0,1,0.88,0.7727,0.3,0.2537,114,295,409,409,3,Sore
12995,2012-06-30,1,6,15,0,6,0,1,0.88,0.7727,0.3,0.2537,117,287,404,404,3,Sore
12996,2012-06-30,1,6,16,0,6,0,1,0.9,0.7879,0.29,0.1642,109,264,373,373,3,Sore
12997,2012-06-30,1,6,17,0,6,0,1,0.88,0.7727,0.32,0.1343,131,231,362,362,3,Sore
12998,2012-06-30,1,6,18,0,6,0,1,0.88,0.7879,0.35,0.0,91,248,339,339,3,Sore
12999,2012-06-30,1,6,19,0,6,0,1,0.84,0.7576,0.44,0.2537,134,240,374,374,3,Malam
13000,2012-06-30,1,6,20,0,6,0,1,0.82,0.7727,0.52,0.1642,88,204,292,292,3,Malam
13001,2012-06-30,1,6,21,0,6,0,1,0.82,0.7727,0.52,0.1642,48,165,213,213,3,Malam
13002,2012-06-30,1,6,22,0,6,0,1,0.78,0.7424,0.62,0.1642,38,134,172,172,3,Malam
13003,2012-06-30,1,6,23,0,6,0,1,0.78,0.7424,0.62,0.0896,33,119,152,152,3,Malam
13004,2012-07-01,1,7,0,0,0,0,1,0.76,0.7273,0.66,0.0,27,122,149,149,3,
13005,2012-07-01,1,7,1,0,0,0,1,0.74,0.697,0.7,0.1343,12,81,93,93,3,Pagi
13006,2012-07-01,1,7,2,0,0,0,1,0.72,0.697,0.74,0.0896,21,69,90,90,3,Pagi
13007,2012-07-01,1,7,3,0,0,0,1,0.72,0.7121,0.84,0.1343,6,27,33,33,3,Pagi
13008,2012-07-01,1,7,4,0,0,0,1,0.7,0.6667,0.79,0.194,0,4,4,4,3,Pagi
13009,2012-07-01,1,7,5,0,0,0,1,0.68,0.6364,0.79,0.1045,3,7,10,10,3,Pagi
13010,2012-07-01,1,7,6,0,0,0,1,0.7,0.6667,0.79,0.0896,8,19,27,27,3,Pagi
13011,2012-07-01,1,7,7,0,0,0,1,0.74,0.697,0.7,0.0,13,37,50,50,3,Siang
13012,2012-07-01,1,7,8,0,0,0,1,0.78,0.7424,0.62,0.1045,36,106,142,142,3,Siang
13013,2012-07-01,1,7,9,0,0,0,1,0.82,0.7879,0.56,0.0,51,168,219,219,3,Siang
13014,2012-07-01,1,7,10,0,0,0,1,0.86,0.7879,0.44,0.2985,98,268,366,366,3,Siang
13015,2012-07-01,1,7,11,0,0,0,1,0.88,0.803,0.39,0.2239,121,256,377,377,3,Siang
13016,2012-07-01,1,7,12,0,0,0,1,0.9,0.8182,0.37,0.2239,114,319,433,433,3,Siang
13017,2012-07-01,1,7,13,0,0,0,1,0.92,0.8333,0.33,0.2537,111,309,420,420,3,Sore
13018,2012-07-01,1,7,14,0,0,0,1,0.92,0.8333,0.33,0.2537,98,346,444,444,3,Sore
13019,2012-07-01,1,7,15,0,0,0,1,0.9,0.8182,0.37,0.2836,101,244,345,345,3,Sore
13020,2012-07-01,1,7,16,0,0,0,1,0.92,0.8333,0.33,0.2985,85,228,313,313,3,Sore
13021,2012-07-01,1,7,17,0,0,0,1,0.92,0.803,0.26,0.2985,90,323,413,413,3,Sore
13022,2012-07-01,1,7,18,0,0,0,1,0.88,0.7727,0.32,0.3582,95,275,370,370,3,Sore
13023,2012-07-01,1,7,19,0,0,0,1,0.84,0.7424,0.39,0.1343,103,279,382,382,3,Malam
13024,2012-07-01,1,7,20,0,0,0,1,0.84,0.7424,0.39,0.1343,88,244,332,332,3,Malam
13025,2012-07-01,1,7,21,0,0,0,1,0.84,0.7424,0.39,0.1343,77,181,258,258,3,Malam
13026,2012-07-01,1,7,22,0,0,0,1,0.82,0.7424,0.43,0.1343,41,110,151,151,3,Malam
13027,2012-07-01,1,7,23,0,0,0,3,0.78,0.7121,0.52,0.1642,22,88,110,110,3,Malam
13028,2012-07-02,1,7,0,0,1,1,2,0.76,0.7121,0.58,0.2239,12,31,43,43,3,
13029,2012-07-02,1,7,1,0,1,1,2,0.76,0.7121,0.58,0.194,3,14,17,17,3,Pagi
13030,2012-07-02,1,7,2,0,1,1,2,0.74,0.6667,0.51,0.2537,1,14,15,15,3,Pagi
13031,2012-07-02,1,7,3,0,1,1,2,0.72,0.6667,0.54,0.4179,0,5,5,5,3,Pagi
13032,2012-07-02,1,7,4,0,1,1,2,0.72,0.6667,0.54,0.2985,2,10,12,12,3,Pagi
13033,2012-07-02,1,7,5,0,1,1,2,0.72,0.6667,0.51,0.0,3,37,40,40,3,Pagi
13034,2012-07-02,1,7,6,0,1,1,1,0.7,0.6515,0.58,0.1045,4,132,136,136,3,Pagi
13035,2012-07-02,1,7,7,0,1,1,1,0.74,0.6667,0.51,0.1045,8,390,398,398,3,Siang
13036,2012-07-02,1,7,8,0,1,1,1,0.76,0.697,0.52,0.194,20,548,568,568,3,Siang
13037,2012-07-02,1,7,9,0,1,1,1,0.78,0.697,0.46,0.2537,56,239,295,295,3,Siang
13038,2012-07-02,1,7,10,0,1,1,1,0.8,0.7273,0.43,0.2537,70,104,174,174,3,Siang
13039,2012-07-02,1,7,11,0,1,1,1,0.84,0.7273,0.28,0.2985,67,134,201,201,3,Siang
13040,2012-07-02,1,7,12,0,1,1,1,0.84,0.7273,0.32,0.194,74,183,257,257,3,Siang
13041,2012-07-02,1,7,13,0,1,1,1,0.86,0.7576,0.34,0.2239,74,162,236,236,3,Sore
13042,2012-07-02,1,7,14,0,1,1,1,0.86,0.7576,0.34,0.2239,79,151,230,230,3,Sore
13043,2012-07-02,1,7,15,0,1,1,1,0.84,0.7424,0.36,0.194,59,175,234,234,3,Sore
13044,2012-07-02,1,7,16,0,1,1,1,0.84,0.7424,0.36,0.2836,61,304,365,365,3,Sore
13045,2012-07-02,1,7,17,0,1,1,1,0.84,0.7273,0.32,0.1343,82,665,747,747,3,Sore
13046,2012-07-02,1,7,18,0,1,1,1,0.84,0.7273,0.32,0.1642,72,658,730,730,3,Sore
13047,2012-07-02,1,7,19,0,1,1,1,0.78,0.697,0.43,0.1343,71,510,581,581,3,Malam
13048,2012-07-02,1,7,20,0,1,1,1,0.78,0.697,0.43,0.1343,38,357,395,395,3,Malam
13049,2012-07-02,1,7,21,0,1,1,1,0.76,0.6818,0.45,0.1343,17,241,258,258,3,Malam
13050,2012-07-02,1,7,22,0,1,1,1,0.74,0.6667,0.51,0.1642,19,169,188,188,3,Malam
13051,2012-07-02,1,7,23,0,1,1,1,0.74,0.6667,0.51,0.1045,12,90,102,102,3,Malam
13052,2012-07-03,1,7,0,0,2,1,1,0.72,0.6667,0.54,0.0,9,44,53,53,3,
13053,2012-07-03,1,7,1,0,2,1,1,0.72,0.6667,0.58,0.0,5,9,14,14,3,Pagi
13054,2012-07-03,1,7,2,0,2,1,1,0.72,0.6667,0.58,0.0,2,8,10,10,3,Pagi
13055,2012-07-03,1,7,3,0,2,1,1,0.7,0.6515,0.65,0.1343,0,2,2,2,3,Pagi
13056,2012-07-03,1,7,4,0,2,1,1,0.68,0.6364,0.65,0.1045,0,6,6,6,3,Pagi
13057,2012-07-03,1,7,5,0,2,1,1,0.7,0.6515,0.61,0.0,2,33,35,35,3,Pagi
13058,2012-07-03,1,7,6,0,2,1,1,0.7,0.6515,0.65,0.1343,5,149,154,154,3,Pagi
13059,2012-07-03,1,7,7,0,2,1,1,0.74,0.6818,0.58,0.0,21,462,483,483,3,Siang
13060,2012-07-03,1,7,8,0,2,1,1,0.74,0.6818,0.62,0.0896,42,604,646,646,3,Siang
13061,2012-07-03,1,7,9,0,2,1,1,0.8,0.7424,0.49,0.1642,46,226,272,272,3,Siang
13062,2012-07-03,1,7,10,0,2,1,1,0.82,0.7424,0.43,0.2239,56,153,209,209,3,Siang
13063,2012-07-03,1,7,11,0,2,1,1,0.86,0.7576,0.34,0.194,66,151,217,217,3,Siang
13064,2012-07-03,1,7,12,0,2,1,1,0.88,0.7576,0.28,0.194,74,198,272,272,3,Siang
13065,2012-07-03,1,7,13,0,2,1,1,0.9,0.7727,0.25,0.1343,80,203,283,283,3,Sore
13066,2012-07-03,1,7,14,0,2,1,1,0.9,0.7727,0.25,0.194,69,241,310,310,3,Sore
13067,2012-07-03,1,7,15,0,2,1,2,0.9,0.7727,0.24,0.0,71,330,401,401,3,Sore
13068,2012-07-03,1,7,16,0,2,1,2,0.9,0.7727,0.24,0.194,90,437,527,527,3,Sore
13069,2012-07-03,1,7,17,0,2,1,2,0.86,0.7424,0.3,0.1642,102,620,722,722,3,Sore
13070,2012-07-03,1,7,18,0,2,1,2,0.86,0.7424,0.3,0.0,85,542,627,627,3,Sore
13071,2012-07-03,1,7,19,0,2,1,2,0.84,0.7424,0.36,0.1343,66,431,497,497,3,Malam
13072,2012-07-03,1,7,20,0,2,1,3,0.76,0.697,0.55,0.4925,80,296,376,376,3,Malam
13073,2012-07-03,1,7,21,0,2,1,2,0.7,0.6515,0.7,0.2836,36,160,196,196,3,Malam
13074,2012-07-03,1,7,22,0,2,1,1,0.68,0.6364,0.79,0.194,26,151,177,177,3,Malam
13075,2012-07-03,1,7,23,0,2,1,1,0.66,0.6061,0.83,0.0,19,152,171,171,3,Malam
13076,2012-07-04,1,7,0,1,3,0,1,0.68,0.6364,0.79,0.0896,19,140,159,159,3,
13077,2012-07-04,1,7,1,1,3,0,1,0.68,0.6364,0.74,0.0,27,96,123,123,3,Pagi
13078,2012-07-04,1,7,2,1,3,0,1,0.66,0.6061,0.83,0.1343,27,66,93,93,3,Pagi
13079,2012-07-04,1,7,3,1,3,0,1,0.68,0.6364,0.74,0.194,9,23,32,32,3,Pagi
13080,2012-07-04,1,7,4,1,3,0,1,0.68,0.6364,0.69,0.2537,5,11,16,16,3,Pagi
13081,2012-07-04,1,7,5,1,3,0,1,0.66,0.6212,0.69,0.0,5,14,19,19,3,Pagi
13082,2012-07-04,1,7,6,1,3,0,1,0.66,0.6212,0.69,0.0,9,23,32,32,3,Pagi
13083,2012-07-04,1,7,7,1,3,0,1,0.68,0.6364,0.65,0.0,10,62,72,72,3,Siang
13084,2012-07-04,1,7,8,1,3,0,1,0.7,0.6515,0.61,0.1045,43,110,153,153,3,Siang
13085,2012-07-04,1,7,9,1,3,0,1,0.76,0.697,0.52,0.0,90,203,293,293,3,Siang
13086,2012-07-04,1,7,10,1,3,0,1,0.8,0.7273,0.46,0.0,143,304,447,447,3,Siang
13087,2012-07-04,1,7,11,1,3,0,1,0.82,0.7576,0.46,0.1343,164,321,485,485,3,Siang
13088,2012-07-04,1,7,12,1,3,0,1,0.86,0.7879,0.41,0.2239,164,330,494,494,3,Siang
13089,2012-07-04,1,7,13,1,3,0,1,0.9,0.8182,0.35,0.0,177,322,499,499,3,Sore
13090,2012-07-04,1,7,14,1,3,0,1,0.9,0.8182,0.37,0.1642,190,357,547,547,3,Sore
13091,2012-07-04,1,7,15,1,3,0,1,0.92,0.8485,0.35,0.2985,155,299,454,454,3,Sore
13092,2012-07-04,1,7,16,1,3,0,1,0.92,0.8485,0.35,0.2537,163,226,389,389,3,Sore
13093,2012-07-04,1,7,17,1,3,0,1,0.92,0.8485,0.35,0.2985,161,253,414,414,3,Sore
13094,2012-07-04,1,7,18,1,3,0,1,0.9,0.8485,0.42,0.194,159,271,430,430,3,Sore
13095,2012-07-04,1,7,19,1,3,0,1,0.86,0.803,0.47,0.2239,177,255,432,432,3,Malam
13096,2012-07-04,1,7,20,1,3,0,1,0.86,0.803,0.47,0.2239,237,314,551,551,3,Malam
13097,2012-07-04,1,7,21,1,3,0,1,0.84,0.803,0.53,0.1343,222,362,584,584,3,Malam
13098,2012-07-04,1,7,22,1,3,0,1,0.82,0.7879,0.56,0.2239,175,327,502,502,3,Malam
13099,2012-07-04,1,7,23,1,3,0,2,0.78,0.697,0.43,0.0896,31,152,183,183,3,Malam
13100,2012-07-05,1,7,0,0,4,1,1,0.74,0.6667,0.51,0.1045,17,71,88,88,3,
13101,2012-07-05,1,7,1,0,4,1,1,0.74,0.6667,0.51,0.2836,6,24,30,30,3,Pagi
13102,2012-07-05,1,7,2,0,4,1,1,0.74,0.6667,0.51,0.0,4,14,18,18,3,Pagi
13103,2012-07-05,1,7,3,0,4,1,1,0.72,0.6667,0.54,0.194,2,5,7,7,3,Pagi
13104,2012-07-05,1,7,4,0,4,1,1,0.72,0.6667,0.58,0.0,0,7,7,7,3,Pagi
13105,2012-07-05,1,7,5,0,4,1,1,0.72,0.6818,0.62,0.0,1,28,29,29,3,Pagi
13106,2012-07-05,1,7,6,0,4,1,1,0.72,0.6667,0.58,0.0,3,130,133,133,3,Pagi
13107,2012-07-05,1,7,7,0,4,1,1,0.76,0.697,0.55,0.0,27,316,343,343,3,Siang
13108,2012-07-05,1,7,8,0,4,1,1,0.8,0.7424,0.49,0.1343,36,514,550,550,3,Siang
13109,2012-07-05,1,7,9,0,4,1,1,0.84,0.7879,0.49,0.2985,47,246,293,293,3,Siang
13110,2012-07-05,1,7,10,0,4,1,1,0.86,0.7879,0.44,0.3582,69,117,186,186,3,Siang
13111,2012-07-05,1,7,11,0,4,1,1,0.9,0.8182,0.35,0.2985,107,137,244,244,3,Siang
13112,2012-07-05,1,7,12,0,4,1,1,0.9,0.8182,0.35,0.3582,88,188,276,276,3,Siang
13113,2012-07-05,1,7,13,0,4,1,1,0.92,0.8333,0.33,0.2239,129,181,310,310,3,Sore
13114,2012-07-05,1,7,14,0,4,1,1,0.92,0.8333,0.33,0.3284,87,154,241,241,3,Sore
13115,2012-07-05,1,7,15,0,4,1,1,0.92,0.8333,0.33,0.3582,71,183,254,254,3,Sore
13116,2012-07-05,1,7,16,0,4,1,1,0.92,0.8333,0.33,0.2537,109,324,433,433,3,Sore
13117,2012-07-05,1,7,17,0,4,1,1,0.92,0.8485,0.35,0.1642,114,575,689,689,3,Sore
13118,2012-07-05,1,7,18,0,4,1,2,0.9,0.8333,0.39,0.3284,96,511,607,607,3,Sore
13119,2012-07-05,1,7,19,0,4,1,2,0.88,0.803,0.39,0.2537,128,375,503,503,3,Malam
13120,2012-07-05,1,7,20,0,4,1,2,0.86,0.7879,0.41,0.2239,78,243,321,321,3,Malam
13121,2012-07-05,1,7,21,0,4,1,1,0.84,0.7727,0.47,0.194,91,232,323,323,3,Malam
13122,2012-07-05,1,7,22,0,4,1,1,0.82,0.803,0.59,0.1343,63,162,225,225,3,Malam
13123,2012-07-05,1,7,23,0,4,1,1,0.8,0.7576,0.55,0.1642,32,99,131,131,3,Malam
13124,2012-07-06,1,7,0,0,5,1,1,0.78,0.7424,0.62,0.1343,39,63,102,102,3,
13125,2012-07-06,1,7,1,0,5,1,1,0.78,0.7273,0.55,0.2239,7,22,29,29,3,Pagi
13126,2012-07-06,1,7,2,0,5,1,1,0.76,0.7121,0.62,0.1343,4,13,17,17,3,Pagi
13127,2012-07-06,1,7,3,0,5,1,2,0.74,0.697,0.7,0.194,1,6,7,7,3,Pagi
13128,2012-07-06,1,7,4,0,5,1,1,0.74,0.697,0.66,0.2239,2,4,6,6,3,Pagi
13129,2012-07-06,1,7,5,0,5,1,1,0.74,0.697,0.66,0.194,4,31,35,35,3,Pagi
13130,2012-07-06,1,7,6,0,5,1,1,0.74,0.697,0.66,0.194,4,127,131,131,3,Pagi
13131,2012-07-06,1,7,7,0,5,1,1,0.78,0.697,0.46,0.1343,20,333,353,353,3,Siang
13132,2012-07-06,1,7,8,0,5,1,1,0.8,0.7121,0.41,0.1642,28,557,585,585,3,Siang
13133,2012-07-06,1,7,9,0,5,1,1,0.82,0.7273,0.36,0.1343,55,249,304,304,3,Siang
13134,2012-07-06,1,7,10,0,5,1,1,0.86,0.7424,0.3,0.0,80,130,210,210,3,Siang
13135,2012-07-06,1,7,11,0,5,1,1,0.84,0.7273,0.32,0.0896,92,141,233,233,3,Siang
13136,2012-07-06,1,7,12,0,5,1,1,0.88,0.7576,0.28,0.1045,111,220,331,331,3,Siang
13137,2012-07-06,1,7,13,0,5,1,1,0.9,0.7879,0.27,0.1045,99,194,293,293,3,Sore
13138,2012-07-06,1,7,14,0,5,1,1,0.9,0.803,0.31,0.1642,91,184,275,275,3,Sore
13139,2012-07-06,1,7,15,0,5,1,1,0.92,0.8182,0.29,0.194,79,206,285,285,3,Sore
13140,2012-07-06,1,7,16,0,5,1,1,0.92,0.8182,0.29,0.1045,69,300,369,369,3,Sore
13141,2012-07-06,1,7,17,0,5,1,1,0.92,0.8182,0.29,0.0,90,486,576,576,3,Sore
13142,2012-07-06,1,7,18,0,5,1,1,0.9,0.803,0.33,0.2537,106,454,560,560,3,Sore
13143,2012-07-06,1,7,19,0,5,1,1,0.88,0.7879,0.35,0.2239,112,306,418,418,3,Malam
13144,2012-07-06,1,7,20,0,5,1,1,0.86,0.7727,0.39,0.1045,91,245,336,336,3,Malam
13145,2012-07-06,1,7,21,0,5,1,1,0.82,0.7727,0.52,0.1343,77,223,300,300,3,Malam
13146,2012-07-06,1,7,22,0,5,1,1,0.8,0.7576,0.55,0.194,78,210,288,288,3,Malam
13147,2012-07-06,1,7,23,0,5,1,1,0.8,0.7879,0.63,0.1045,27,137,164,164,3,Malam
13148,2012-07-07,1,7,0,0,6,0,1,0.78,0.7576,0.66,0.1343,35,115,150,150,3,
13149,2012-07-07,1,7,1,0,6,0,1,0.76,0.7273,0.7,0.1642,16,55,71,71,3,Pagi
13150,2012-07-07,1,7,2,0,6,0,1,0.76,0.7424,0.72,0.1642,11,47,58,58,3,Pagi
13151,2012-07-07,1,7,3,0,6,0,1,0.74,0.7121,0.74,0.1343,12,19,31,31,3,Pagi
13152,2012-07-07,1,7,4,0,6,0,1,0.74,0.7121,0.74,0.1642,3,13,16,16,3,Pagi
13153,2012-07-07,1,7,5,0,6,0,1,0.74,0.7121,0.74,0.194,2,12,14,14,3,Pagi
13154,2012-07-07,1,7,6,0,6,0,1,0.74,0.7121,0.74,0.1045,4,27,31,31,3,Pagi
13155,2012-07-07,1,7,7,0,6,0,1,0.78,0.7576,0.66,0.1045,8,63,71,71,3,Siang
13156,2012-07-07,1,7,8,0,6,0,1,0.82,0.8333,0.63,0.194,32,120,152,152,3,Siang
13157,2012-07-07,1,7,9,0,6,0,1,0.84,0.8333,0.59,0.1642,69,187,256,256,3,Siang
13158,2012-07-07,1,7,10,0,6,0,1,0.92,0.8636,0.37,0.2239,100,225,325,325,3,Siang
13159,2012-07-07,1,7,11,0,6,0,1,0.94,0.8788,0.38,0.194,122,245,367,367,3,Siang
13160,2012-07-07,1,7,12,0,6,0,1,0.96,0.8636,0.31,0.3582,124,218,342,342,3,Siang
13161,2012-07-07,1,7,13,0,6,0,2,0.96,0.8636,0.31,0.2537,116,244,360,360,3,Sore
13162,2012-07-07,1,7,14,0,6,0,2,0.96,0.8636,0.3,0.1343,105,203,308,308,3,Sore
13163,2012-07-07,1,7,15,0,6,0,1,0.96,0.8485,0.26,0.0,113,193,306,306,3,Sore
13164,2012-07-07,1,7,16,0,6,0,1,1.0,0.8636,0.19,0.1642,102,192,294,294,3,Sore
13165,2012-07-07,1,7,17,0,6,0,1,0.96,0.8485,0.26,0.1343,103,176,279,279,3,Sore
13166,2012-07-07,1,7,18,0,6,0,1,0.94,0.8333,0.29,0.0896,83,194,277,277,3,Sore
13167,2012-07-07,1,7,19,0,6,0,1,0.92,0.8333,0.33,0.1343,68,219,287,287,3,Malam
13168,2012-07-07,1,7,20,0,6,0,1,0.9,0.8182,0.37,0.1642,79,197,276,276,3,Malam
13169,2012-07-07,1,7,21,0,6,0,1,0.88,0.7879,0.37,0.194,51,150,201,201,3,Malam
13170,2012-07-07,1,7,22,0,6,0,1,0.84,0.8333,0.59,0.194,56,164,220,220,3,Malam
13171,2012-07-07,1,7,23,0,6,0,1,0.84,0.8182,0.56,0.1642,34,114,148,148,3,Malam
13172,2012-07-08,1,7,0,0,0,0,1,0.82,0.7879,0.56,0.1343,22,125,147,147,3,
13173,2012-07-08,1,7,1,0,0,0,1,0.82,0.7879,0.56,0.1045,25,99,124,124,3,Pagi
13174,2012-07-08,1,7,2,0,0,0,1,0.82,0.7727,0.52,0.1045,11,59,70,70,3,Pagi
13175,2012-07-08,1,7,3,0,0,0,1,0.8,0.7727,0.59,0.1045,1,34,35,35,3,Pagi
13176,2012-07-08,1,7,4,0,0,0,1,0.78,0.7576,0.66,0.1045,2,11,13,13,3,Pagi
13177,2012-07-08,1,7,5,0,0,0,1,0.78,0.7424,0.62,0.0,1,5,6,6,3,Pagi
13178,2012-07-08,1,7,6,0,0,0,1,0.78,0.7727,0.7,0.1343,5,16,21,21,3,Pagi
13179,2012-07-08,1,7,7,0,0,0,1,0.8,0.803,0.66,0.0,19,33,52,52,3,Siang
13180,2012-07-08,1,7,8,0,0,0,1,0.84,0.803,0.53,0.1343,35,95,130,130,3,Siang
13181,2012-07-08,1,7,9,0,0,0,1,0.86,0.8182,0.5,0.1045,70,172,242,242,3,Siang
13182,2012-07-08,1,7,10,0,0,0,1,0.9,0.8636,0.45,0.0,85,234,319,319,3,Siang
13183,2012-07-08,1,7,11,0,0,0,1,0.92,0.8939,0.42,0.2985,120,269,389,389,3,Siang
13184,2012-07-08,1,7,12,0,0,0,1,0.92,0.8939,0.42,0.194,105,271,376,376,3,Siang
13185,2012-07-08,1,7,13,0,0,0,1,0.94,0.8788,0.38,0.2537,118,219,337,337,3,Sore
13186,2012-07-08,1,7,14,0,0,0,1,0.96,0.9091,0.36,0.1642,77,235,312,312,3,Sore
13187,2012-07-08,1,7,15,0,0,0,3,0.92,0.8939,0.42,0.2836,80,218,298,298,3,Sore
13188,2012-07-08,1,7,16,0,0,0,2,0.8,0.803,0.66,0.2239,65,226,291,291,3,Sore
13189,2012-07-08,1,7,17,0,0,0,1,0.78,0.7424,0.59,0.0,68,202,270,270,3,Sore
13190,2012-07-08,1,7,18,0,0,0,1,0.78,0.7424,0.62,0.1045,54,199,253,253,3,Sore
13191,2012-07-08,1,7,19,0,0,0,1,0.78,0.7424,0.62,0.1642,66,184,250,250,3,Malam
13192,2012-07-08,1,7,20,0,0,0,1,0.76,0.7273,0.7,0.0896,79,206,285,285,3,Malam
13193,2012-07-08,1,7,21,0,0,0,1,0.76,0.7273,0.7,0.1343,58,149,207,207,3,Malam
13194,2012-07-08,1,7,22,0,0,0,3,0.74,0.697,0.7,0.0896,12,110,122,122,3,Malam
13195,2012-07-08,1,7,23,0,0,0,3,0.68,0.6364,0.83,0.0896,25,98,123,123,3,Malam
13196,2012-07-09,1,7,0,0,1,1,2,0.68,0.6364,0.89,0.0896,6,33,39,39,3,
13197,2012-07-09,1,7,1,0,1,1,3,0.7,0.6667,0.89,0.1045,5,13,18,18,3,Pagi
13198,2012-07-09,1,7,2,0,1,1,3,0.7,0.6667,0.89,0.194,1,4,5,5,3,Pagi
13199,2012-07-09,1,7,3,0,1,1,3,0.7,0.6667,0.89,0.194,0,5,5,5,3,Pagi
13200,2012-07-09,1,7,4,0,1,1,3,0.66,0.5909,0.89,0.3881,1,1,2,2,3,Pagi
13201,2012-07-09,1,7,5,0,1,1,2,0.66,0.6061,0.83,0.2239,1,27,28,28,3,Pagi
13202,2012-07-09,1,7,6,0,1,1,3,0.64,0.5758,0.89,0.2537,6,86,92,92,3,Pagi
13203,2012-07-09,1,7,7,0,1,1,3,0.66,0.6061,0.83,0.2239,7,223,230,230,3,Siang
13204,2012-07-09,1,7,8,0,1,1,2,0.66,0.6061,0.83,0.1642,26,429,455,455,3,Siang
13205,2012-07-09,1,7,9,0,1,1,2,0.66,0.6061,0.83,0.1642,38,325,363,363,3,Siang
13206,2012-07-09,1,7,10,0,1,1,2,0.66,0.6061,0.83,0.194,58,117,175,175,3,Siang
13207,2012-07-09,1,7,11,0,1,1,2,0.72,0.6818,0.62,0.1343,72,144,216,216,3,Siang
13208,2012-07-09,1,7,12,0,1,1,2,0.74,0.6818,0.58,0.1343,61,205,266,266,3,Siang
13209,2012-07-09,1,7,13,0,1,1,2,0.76,0.697,0.55,0.2537,67,188,255,255,3,Sore
13210,2012-07-09,1,7,14,0,1,1,2,0.74,0.6818,0.55,0.2537,58,184,242,242,3,Sore
13211,2012-07-09,1,7,15,0,1,1,2,0.76,0.6818,0.45,0.2239,66,214,280,280,3,Sore
13212,2012-07-09,1,7,16,0,1,1,1,0.78,0.697,0.4,0.2836,88,325,413,413,3,Sore
13213,2012-07-09,1,7,17,0,1,1,1,0.78,0.697,0.4,0.1642,108,741,849,849,3,Sore
13214,2012-07-09,1,7,18,0,1,1,1,0.76,0.6818,0.48,0.1343,82,790,872,872,3,Sore
13215,2012-07-09,1,7,19,0,1,1,1,0.74,0.6818,0.55,0.1642,88,543,631,631,3,Malam
13216,2012-07-09,1,7,20,0,1,1,2,0.74,0.6818,0.55,0.1045,69,378,447,447,3,Malam
13217,2012-07-09,1,7,21,0,1,1,2,0.74,0.6818,0.55,0.0896,33,298,331,331,3,Malam
13218,2012-07-09,1,7,22,0,1,1,2,0.72,0.6667,0.58,0.1045,35,189,224,224,3,Malam
13219,2012-07-09,1,7,23,0,1,1,2,0.7,0.6515,0.65,0.1045,22,109,131,131,3,Malam
13220,2012-07-10,1,7,0,0,2,1,1,0.7,0.6515,0.7,0.0896,16,53,69,69,3,
13221,2012-07-10,1,7,1,0,2,1,1,0.7,0.6667,0.74,0.1343,0,15,15,15,3,Pagi
13222,2012-07-10,1,7,2,0,2,1,1,0.7,0.6667,0.74,0.1343,1,15,16,16,3,Pagi
13223,2012-07-10,1,7,3,0,2,1,1,0.68,0.6364,0.79,0.0,0,3,3,3,3,Pagi
13224,2012-07-10,1,7,4,0,2,1,1,0.68,0.6364,0.79,0.1343,0,4,4,4,3,Pagi
13225,2012-07-10,1,7,5,0,2,1,1,0.66,0.6061,0.83,0.1343,3,39,42,42,3,Pagi
13226,2012-07-10,1,7,6,0,2,1,2,0.68,0.6364,0.79,0.1045,4,183,187,187,3,Pagi
13227,2012-07-10,1,7,7,0,2,1,2,0.7,0.6667,0.74,0.1045,31,489,520,520,3,Siang
13228,2012-07-10,1,7,8,0,2,1,1,0.72,0.697,0.74,0.1343,34,615,649,649,3,Siang
13229,2012-07-10,1,7,9,0,2,1,1,0.74,0.697,0.66,0.1343,47,284,331,331,3,Siang
13230,2012-07-10,1,7,10,0,2,1,1,0.76,0.7121,0.62,0.194,56,134,190,190,3,Siang
13231,2012-07-10,1,7,11,0,2,1,1,0.8,0.7273,0.46,0.194,92,157,249,249,3,Siang
13232,2012-07-10,1,7,12,0,2,1,1,0.8,0.7121,0.41,0.1343,69,203,272,272,3,Siang
13233,2012-07-10,1,7,13,0,2,1,1,0.82,0.7273,0.38,0.194,77,203,280,280,3,Sore
13234,2012-07-10,1,7,14,0,2,1,1,0.82,0.7273,0.38,0.1642,71,171,242,242,3,Sore
13235,2012-07-10,1,7,15,0,2,1,1,0.8,0.7121,0.41,0.2239,77,188,265,265,3,Sore
13236,2012-07-10,1,7,16,0,2,1,1,0.8,0.7273,0.43,0.2239,89,346,435,435,3,Sore
13237,2012-07-10,1,7,17,0,2,1,1,0.78,0.7121,0.49,0.194,103,769,872,872,3,Sore
13238,2012-07-10,1,7,18,0,2,1,3,0.7,0.6667,0.74,0.2239,70,749,819,819,3,Sore
13239,2012-07-10,1,7,19,0,2,1,3,0.7,0.6667,0.74,0.2239,55,359,414,414,3,Malam
13240,2012-07-10,1,7,20,0,2,1,3,0.64,0.5758,0.83,0.2239,9,75,84,84,3,Malam
13241,2012-07-10,1,7,21,0,2,1,3,0.64,0.5758,0.89,0.1045,7,83,90,90,3,Malam
13242,2012-07-10,1,7,22,0,2,1,2,0.64,0.5758,0.83,0.1343,14,125,139,139,3,Malam
13243,2012-07-10,1,7,23,0,2,1,2,0.64,0.5758,0.89,0.1045,29,74,103,103,3,Malam
13244,2012-07-11,1,7,0,0,3,1,2,0.66,0.6061,0.83,0.1343,6,38,44,44,3,
13245,2012-07-11,1,7,1,0,3,1,1,0.64,0.5758,0.89,0.0,3,11,14,14,3,Pagi
13246,2012-07-11,1,7,2,0,3,1,1,0.64,0.5758,0.89,0.0,0,5,5,5,3,Pagi
13247,2012-07-11,1,7,3,0,3,1,1,0.64,0.5758,0.89,0.1343,0,5,5,5,3,Pagi
13248,2012-07-11,1,7,4,0,3,1,1,0.64,0.5758,0.89,0.1343,1,6,7,7,3,Pagi
13249,2012-07-11,1,7,5,0,3,1,1,0.64,0.5758,0.89,0.0,5,36,41,41,3,Pagi
13250,2012-07-11,1,7,6,0,3,1,1,0.64,0.5758,0.89,0.1343,17,168,185,185,3,Pagi
13251,2012-07-11,1,7,7,0,3,1,2,0.66,0.6061,0.83,0.1045,26,471,497,497,3,Siang
13252,2012-07-11,1,7,8,0,3,1,2,0.68,0.6364,0.79,0.1642,30,644,674,674,3,Siang
13253,2012-07-11,1,7,9,0,3,1,2,0.7,0.6667,0.74,0.1343,30,298,328,328,3,Siang
13254,2012-07-11,1,7,10,0,3,1,2,0.72,0.6818,0.62,0.1343,47,148,195,195,3,Siang
13255,2012-07-11,1,7,11,0,3,1,2,0.76,0.7121,0.58,0.1343,56,173,229,229,3,Siang
13256,2012-07-11,1,7,12,0,3,1,2,0.78,0.697,0.43,0.0,69,223,292,292,3,Siang
13257,2012-07-11,1,7,13,0,3,1,2,0.8,0.7121,0.42,0.1642,65,208,273,273,3,Sore
13258,2012-07-11,1,7,14,0,3,1,1,0.8,0.7121,0.41,0.2239,66,175,241,241,3,Sore
13259,2012-07-11,1,7,15,0,3,1,1,0.8,0.7121,0.41,0.2537,56,220,276,276,3,Sore
13260,2012-07-11,1,7,16,0,3,1,1,0.8,0.7121,0.38,0.194,53,358,411,411,3,Sore
13261,2012-07-11,1,7,17,0,3,1,1,0.8,0.697,0.31,0.2239,90,740,830,830,3,Sore
13262,2012-07-11,1,7,18,0,3,1,1,0.78,0.6818,0.38,0.2537,79,735,814,814,3,Sore
13263,2012-07-11,1,7,19,0,3,1,1,0.74,0.6667,0.48,0.2239,73,560,633,633,3,Malam
13264,2012-07-11,1,7,20,0,3,1,1,0.74,0.6667,0.51,0.1642,73,410,483,483,3,Malam
13265,2012-07-11,1,7,21,0,3,1,1,0.72,0.6667,0.58,0.2239,69,322,391,391,3,Malam
13266,2012-07-11,1,7,22,0,3,1,1,0.72,0.6667,0.58,0.2537,41,203,244,244,3,Malam
13267,2012-07-11,1,7,23,0,3,1,2,0.7,0.6515,0.58,0.2537,20,132,152,152,3,Malam
13268,2012-07-12,1,7,0,0,4,1,2,0.68,0.6364,0.61,0.0,1,55,56,56,3,
13269,2012-07-12,1,7,1,0,4,1,2,0.66,0.6212,0.61,0.0,0,21,21,21,3,Pagi
13270,2012-07-12,1,7,2,0,4,1,2,0.66,0.6212,0.65,0.0896,0,9,9,9,3,Pagi
13271,2012-07-12,1,7,3,0,4,1,1,0.64,0.6061,0.69,0.1045,0,10,10,10,3,Pagi
13272,2012-07-12,1,7,4,0,4,1,1,0.64,0.6061,0.73,0.1045,0,5,5,5,3,Pagi
13273,2012-07-12,1,7,5,0,4,1,1,0.62,0.5909,0.73,0.1045,4,40,44,44,3,Pagi
13274,2012-07-12,1,7,6,0,4,1,1,0.64,0.6061,0.73,0.0896,7,171,178,178,3,Pagi
13275,2012-07-12,1,7,7,0,4,1,1,0.64,0.6061,0.73,0.1343,32,480,512,512,3,Siang
13276,2012-07-12,1,7,8,0,4,1,1,0.68,0.6364,0.65,0.1343,49,653,702,702,3,Siang
13277,2012-07-12,1,7,9,0,4,1,1,0.72,0.6667,0.58,0.1045,42,285,327,327,3,Siang
13278,2012-07-12,1,7,10,0,4,1,1,0.74,0.6667,0.48,0.1642,69,145,214,214,3,Siang
13279,2012-07-12,1,7,11,0,4,1,1,0.76,0.6818,0.45,0.1045,49,166,215,215,3,Siang
13280,2012-07-12,1,7,12,0,4,1,1,0.78,0.6818,0.35,0.1343,71,221,292,292,3,Siang
13281,2012-07-12,1,7,13,0,4,1,1,0.8,0.697,0.33,0.2239,52,225,277,277,3,Sore
13282,2012-07-12,1,7,14,0,4,1,1,0.78,0.6818,0.33,0.2239,42,167,209,209,3,Sore
13283,2012-07-12,1,7,15,0,4,1,1,0.8,0.7121,0.36,0.194,63,208,271,271,3,Sore
13284,2012-07-12,1,7,16,0,4,1,1,0.8,0.7121,0.36,0.194,69,370,439,439,3,Sore
13285,2012-07-12,1,7,17,0,4,1,1,0.76,0.6818,0.43,0.2239,91,704,795,795,3,Sore
13286,2012-07-12,1,7,18,0,4,1,1,0.76,0.6818,0.45,0.1343,86,739,825,825,3,Sore
13287,2012-07-12,1,7,19,0,4,1,1,0.74,0.6667,0.48,0.2239,97,532,629,629,3,Malam
13288,2012-07-12,1,7,20,0,4,1,1,0.74,0.6667,0.48,0.2239,75,439,514,514,3,Malam
13289,2012-07-12,1,7,21,0,4,1,1,0.72,0.6667,0.48,0.2239,44,329,373,373,3,Malam
13290,2012-07-12,1,7,22,0,4,1,1,0.72,0.6667,0.51,0.1642,56,262,318,318,3,Malam
13291,2012-07-12,1,7,23,0,4,1,2,0.7,0.6515,0.51,0.2239,33,178,211,211,3,Malam
13292,2012-07-13,1,7,0,0,5,1,2,0.7,0.6515,0.54,0.1642,19,76,95,95,3,
13293,2012-07-13,1,7,1,0,5,1,2,0.68,0.6364,0.54,0.1045,17,42,59,59,3,Pagi
13294,2012-07-13,1,7,2,0,5,1,2,0.66,0.6212,0.61,0.0896,2,15,17,17,3,Pagi
13295,2012-07-13,1,7,3,0,5,1,2,0.68,0.6364,0.61,0.0,2,7,9,9,3,Pagi
13296,2012-07-13,1,7,4,0,5,1,2,0.66,0.6212,0.61,0.0,0,11,11,11,3,Pagi
13297,2012-07-13,1,7,5,0,5,1,2,0.66,0.6364,0.56,0.0896,4,30,34,34,3,Pagi
13298,2012-07-13,1,7,6,0,5,1,2,0.7,0.6515,0.54,0.0,7,120,127,127,3,Pagi
13299,2012-07-13,1,7,7,0,5,1,2,0.7,0.6515,0.54,0.0,27,353,380,380,3,Siang
13300,2012-07-13,1,7,8,0,5,1,2,0.7,0.6515,0.54,0.0,53,660,713,713,3,Siang
13301,2012-07-13,1,7,9,0,5,1,2,0.72,0.6667,0.51,0.0,70,344,414,414,3,Siang
13302,2012-07-13,1,7,10,0,5,1,2,0.74,0.6667,0.48,0.0,78,190,268,268,3,Siang
13303,2012-07-13,1,7,11,0,5,1,2,0.76,0.6818,0.45,0.1343,68,220,288,288,3,Siang
13304,2012-07-13,1,7,12,0,5,1,2,0.76,0.6818,0.4,0.1045,125,254,379,379,3,Siang
13305,2012-07-13,1,7,13,0,5,1,2,0.8,0.7121,0.38,0.1343,100,274,374,374,3,Sore
13306,2012-07-13,1,7,14,0,5,1,2,0.8,0.7121,0.38,0.0,120,249,369,369,3,Sore
13307,2012-07-13,1,7,15,0,5,1,2,0.8,0.7121,0.36,0.1045,92,261,353,353,3,Sore
13308,2012-07-13,1,7,16,0,5,1,2,0.8,0.7121,0.36,0.2239,111,381,492,492,3,Sore
13309,2012-07-13,1,7,17,0,5,1,2,0.8,0.7121,0.36,0.1642,138,697,835,835,3,Sore
13310,2012-07-13,1,7,18,0,5,1,1,0.78,0.697,0.46,0.194,108,523,631,631,3,Sore
13311,2012-07-13,1,7,19,0,5,1,1,0.74,0.6667,0.51,0.1642,103,385,488,488,3,Malam
13312,2012-07-13,1,7,20,0,5,1,1,0.74,0.6667,0.48,0.1343,95,294,389,389,3,Malam
13313,2012-07-13,1,7,21,0,5,1,1,0.72,0.6667,0.54,0.0,76,223,299,299,3,Malam
13314,2012-07-13,1,7,22,0,5,1,1,0.74,0.6667,0.45,0.0,59,204,263,263,3,Malam
13315,2012-07-13,1,7,23,0,5,1,2,0.72,0.6515,0.45,0.1343,37,175,212,212,3,Malam
13316,2012-07-14,1,7,0,0,6,0,2,0.72,0.6667,0.48,0.0896,35,156,191,191,3,
13317,2012-07-14,1,7,1,0,6,0,2,0.7,0.6515,0.51,0.1045,13,105,118,118,3,Pagi
13318,2012-07-14,1,7,2,0,6,0,2,0.7,0.6515,0.54,0.1045,10,91,101,101,3,Pagi
13319,2012-07-14,1,7,3,0,6,0,2,0.7,0.6515,0.54,0.1045,9,31,40,40,3,Pagi
13320,2012-07-14,1,7,4,0,6,0,3,0.66,0.6212,0.61,0.1045,3,6,9,9,3,Pagi
13321,2012-07-14,1,7,5,0,6,0,2,0.64,0.6061,0.73,0.1045,0,5,5,5,3,Pagi
13322,2012-07-14,1,7,6,0,6,0,2,0.64,0.5909,0.78,0.0896,6,29,35,35,3,Pagi
13323,2012-07-14,1,7,7,0,6,0,1,0.64,0.5909,0.78,0.2836,7,41,48,48,3,Siang
13324,2012-07-14,1,7,8,0,6,0,1,0.62,0.5909,0.78,0.2836,33,118,151,151,3,Siang
13325,2012-07-14,1,7,9,0,6,0,1,0.66,0.6212,0.74,0.194,82,200,282,282,3,Siang
13326,2012-07-14,1,7,10,0,6,0,2,0.72,0.6818,0.7,0.0896,123,278,401,401,3,Siang
13327,2012-07-14,1,7,11,0,6,0,2,0.72,0.6818,0.7,0.1045,143,296,439,439,3,Siang
13328,2012-07-14,1,7,12,0,6,0,2,0.74,0.697,0.66,0.0896,181,318,499,499,3,Siang
13329,2012-07-14,1,7,13,0,6,0,2,0.76,0.7121,0.62,0.0896,219,372,591,591,3,Sore
13330,2012-07-14,1,7,14,0,6,0,1,0.8,0.7576,0.55,0.1045,269,363,632,632,3,Sore
13331,2012-07-14,1,7,15,0,6,0,1,0.8,0.7576,0.55,0.1642,243,317,560,560,3,Sore
13332,2012-07-14,1,7,16,0,6,0,2,0.72,0.697,0.79,0.3582,226,340,566,566,3,Sore
13333,2012-07-14,1,7,17,0,6,0,3,0.7,0.6667,0.79,0.1642,199,259,458,458,3,Sore
13334,2012-07-14,1,7,18,0,6,0,1,0.72,0.697,0.79,0.1343,108,243,351,351,3,Sore
13335,2012-07-14,1,7,19,0,6,0,1,0.72,0.7121,0.84,0.0896,156,275,431,431,3,Malam
13336,2012-07-14,1,7,20,0,6,0,1,0.72,0.7121,0.84,0.0896,101,255,356,356,3,Malam
13337,2012-07-14,1,7,21,0,6,0,1,0.7,0.6667,0.84,0.2239,69,200,269,269,3,Malam
13338,2012-07-14,1,7,22,0,6,0,1,0.7,0.6667,0.79,0.194,65,160,225,225,3,Malam
13339,2012-07-14,1,7,23,0,6,0,2,0.68,0.6364,0.83,0.0896,55,156,211,211,3,Malam
13340,2012-07-15,1,7,0,0,0,0,1,0.68,0.6364,0.89,0.1642,40,147,187,187,3,
13341,2012-07-15,1,7,1,0,0,0,2,0.68,0.6364,0.89,0.1343,49,119,168,168,3,Pagi
13342,2012-07-15,1,7,2,0,0,0,2,0.68,0.6364,0.89,0.1642,29,86,115,115,3,Pagi
13343,2012-07-15,1,7,3,0,0,0,2,0.68,0.6364,0.89,0.1642,15,42,57,57,3,Pagi
13344,2012-07-15,1,7,4,0,0,0,2,0.68,0.6364,0.89,0.1045,8,11,19,19,3,Pagi
13345,2012-07-15,1,7,5,0,0,0,1,0.68,0.6364,0.89,0.1343,2,7,9,9,3,Pagi
13346,2012-07-15,1,7,6,0,0,0,1,0.68,0.6364,0.83,0.1343,6,9,15,15,3,Pagi
13347,2012-07-15,1,7,7,0,0,0,1,0.7,0.6667,0.79,0.0896,17,30,47,47,3,Siang
13348,2012-07-15,1,7,8,0,0,0,2,0.7,0.6667,0.84,0.1343,37,96,133,133,3,Siang
13349,2012-07-15,1,7,9,0,0,0,2,0.72,0.697,0.79,0.0,58,163,221,221,3,Siang
13350,2012-07-15,1,7,10,0,0,0,1,0.76,0.7273,0.66,0.1343,141,241,382,382,3,Siang
13351,2012-07-15,1,7,11,0,0,0,1,0.82,0.7727,0.52,0.1642,170,281,451,451,3,Siang
13352,2012-07-15,1,7,12,0,0,0,1,0.84,0.7727,0.47,0.1045,153,336,489,489,3,Siang
13353,2012-07-15,1,7,13,0,0,0,1,0.86,0.7879,0.41,0.1045,171,309,480,480,3,Sore
13354,2012-07-15,1,7,14,0,0,0,1,0.9,0.8182,0.37,0.2537,162,314,476,476,3,Sore
13355,2012-07-15,1,7,15,0,0,0,1,0.86,0.803,0.47,0.1343,182,307,489,489,3,Sore
13356,2012-07-15,1,7,16,0,0,0,1,0.86,0.7879,0.41,0.2239,152,343,495,495,3,Sore
13357,2012-07-15,1,7,17,0,0,0,1,0.8,0.7727,0.59,0.4925,122,314,436,436,3,Sore
13358,2012-07-15,1,7,18,0,0,0,3,0.72,0.697,0.79,0.3582,84,228,312,312,3,Sore
13359,2012-07-15,1,7,19,0,0,0,1,0.72,0.7121,0.84,0.2239,109,203,312,312,3,Malam
13360,2012-07-15,1,7,20,0,0,0,1,0.72,0.697,0.79,0.2537,95,199,294,294,3,Malam
13361,2012-07-15,1,7,21,0,0,0,1,0.72,0.697,0.79,0.0896,59,164,223,223,3,Malam
13362,2012-07-15,1,7,22,0,0,0,1,0.72,0.697,0.74,0.1045,34,96,130,130,3,Malam
13363,2012-07-15,1,7,23,0,0,0,1,0.72,0.697,0.79,0.1343,25,66,91,91,3,Malam
13364,2012-07-16,1,7,0,0,1,1,3,0.72,0.697,0.79,0.1045,11,32,43,43,3,
13365,2012-07-16,1,7,1,0,1,1,2,0.7,0.6667,0.74,0.194,1,10,11,11,3,Pagi
13366,2012-07-16,1,7,2,0,1,1,1,0.7,0.6667,0.74,0.1045,4,11,15,15,3,Pagi
13367,2012-07-16,1,7,3,0,1,1,1,0.68,0.6364,0.79,0.0896,2,4,6,6,3,Pagi
13368,2012-07-16,1,7,4,0,1,1,1,0.68,0.6364,0.79,0.1045,1,11,12,12,3,Pagi
13369,2012-07-16,1,7,5,0,1,1,1,0.66,0.6061,0.78,0.1045,10,40,50,50,3,Pagi
13370,2012-07-16,1,7,6,0,1,1,1,0.68,0.6364,0.79,0.1343,8,132,140,140,3,Pagi
13371,2012-07-16,1,7,7,0,1,1,1,0.72,0.6818,0.7,0.0896,24,459,483,483,3,Siang
13372,2012-07-16,1,7,8,0,1,1,1,0.74,0.697,0.66,0.1045,48,619,667,667,3,Siang
13373,2012-07-16,1,7,9,0,1,1,1,0.76,0.7121,0.62,0.1642,51,297,348,348,3,Siang
13374,2012-07-16,1,7,10,0,1,1,1,0.8,0.7727,0.59,0.0,69,117,186,186,3,Siang
13375,2012-07-16,1,7,11,0,1,1,1,0.84,0.803,0.53,0.2239,57,125,182,182,3,Siang
13376,2012-07-16,1,7,12,0,1,1,1,0.84,0.7879,0.49,0.1343,79,158,237,237,3,Siang
13377,2012-07-16,1,7,13,0,1,1,1,0.84,0.7879,0.49,0.2836,63,176,239,239,3,Sore
13378,2012-07-16,1,7,14,0,1,1,1,0.88,0.8182,0.42,0.1045,53,159,212,212,3,Sore
13379,2012-07-16,1,7,15,0,1,1,1,0.86,0.803,0.47,0.2537,61,176,237,237,3,Sore
13380,2012-07-16,1,7,16,0,1,1,3,0.76,0.7273,0.66,0.5821,77,309,386,386,3,Sore
13381,2012-07-16,1,7,17,0,1,1,3,0.76,0.7273,0.66,0.5821,86,669,755,755,3,Sore
13382,2012-07-16,1,7,18,0,1,1,1,0.84,0.803,0.53,0.0,97,697,794,794,3,Sore
13383,2012-07-16,1,7,19,0,1,1,1,0.8,0.7879,0.63,0.1343,92,503,595,595,3,Malam
13384,2012-07-16,1,7,20,0,1,1,1,0.8,0.7727,0.59,0.1343,66,388,454,454,3,Malam
13385,2012-07-16,1,7,21,0,1,1,1,0.76,0.7273,0.66,0.1343,45,283,328,328,3,Malam
13386,2012-07-16,1,7,22,0,1,1,1,0.76,0.7121,0.62,0.0896,56,228,284,284,3,Malam
13387,2012-07-16,1,7,23,0,1,1,1,0.74,0.7121,0.74,0.0896,27,139,166,166,3,Malam
13388,2012-07-17,1,7,0,0,2,1,1,0.72,0.7121,0.84,0.1045,10,43,53,53,3,
13389,2012-07-17,1,7,1,0,2,1,1,0.74,0.697,0.7,0.0,4,21,25,25,3,Pagi
13390,2012-07-17,1,7,2,0,2,1,1,0.72,0.6818,0.7,0.0896,1,6,7,7,3,Pagi
13391,2012-07-17,1,7,3,0,2,1,1,0.72,0.6818,0.66,0.0,0,3,3,3,3,Pagi
13392,2012-07-17,1,7,4,0,2,1,1,0.72,0.6818,0.62,0.0,0,7,7,7,3,Pagi
13393,2012-07-17,1,7,5,0,2,1,1,0.68,0.6364,0.74,0.0896,7,31,38,38,3,Pagi
13394,2012-07-17,1,7,6,0,2,1,1,0.72,0.6818,0.66,0.1045,16,197,213,213,3,Pagi
13395,2012-07-17,1,7,7,0,2,1,2,0.74,0.697,0.7,0.0,26,500,526,526,3,Siang
13396,2012-07-17,1,7,8,0,2,1,2,0.8,0.7576,0.55,0.0,43,618,661,661,3,Siang
13397,2012-07-17,1,7,9,0,2,1,2,0.82,0.7727,0.49,0.2239,32,288,320,320,3,Siang
13398,2012-07-17,1,7,10,0,2,1,2,0.84,0.7879,0.49,0.194,37,122,159,159,3,Siang
13399,2012-07-17,1,7,11,0,2,1,2,0.86,0.803,0.47,0.0,60,146,206,206,3,Siang
13400,2012-07-17,1,7,12,0,2,1,2,0.9,0.8182,0.35,0.0,80,174,254,254,3,Siang
13401,2012-07-17,1,7,13,0,2,1,1,0.92,0.8182,0.31,0.194,53,168,221,221,3,Sore
13402,2012-07-17,1,7,14,0,2,1,1,0.94,0.8333,0.29,0.2537,54,160,214,214,3,Sore
13403,2012-07-17,1,7,15,0,2,1,1,0.92,0.8182,0.31,0.1642,57,187,244,244,3,Sore
13404,2012-07-17,1,7,16,0,2,1,1,0.92,0.8182,0.29,0.1642,64,317,381,381,3,Sore
13405,2012-07-17,1,7,17,0,2,1,1,0.92,0.8182,0.29,0.0,95,675,770,770,3,Sore
13406,2012-07-17,1,7,18,0,2,1,1,0.9,0.803,0.33,0.194,60,712,772,772,3,Sore
13407,2012-07-17,1,7,19,0,2,1,1,0.88,0.7879,0.35,0.2537,69,478,547,547,3,Malam
13408,2012-07-17,1,7,20,0,2,1,1,0.86,0.7576,0.34,0.1642,52,375,427,427,3,Malam
13409,2012-07-17,1,7,21,0,2,1,1,0.82,0.7727,0.52,0.1343,50,283,333,333,3,Malam
13410,2012-07-17,1,7,22,0,2,1,1,0.8,0.7576,0.55,0.2239,29,215,244,244,3,Malam
13411,2012-07-17,1,7,23,0,2,1,1,0.78,0.7424,0.59,0.194,22,139,161,161,3,Malam
13412,2012-07-18,1,7,0,0,3,1,1,0.76,0.7273,0.66,0.1642,8,45,53,53,3,
13413,2012-07-18,1,7,1,0,3,1,1,0.76,0.7273,0.66,0.1045,2,14,16,16,3,Pagi
13414,2012-07-18,1,7,2,0,3,1,1,0.74,0.697,0.66,0.1343,3,5,8,8,3,Pagi
13415,2012-07-18,1,7,3,0,3,1,1,0.74,0.697,0.66,0.1343,2,2,4,4,3,Pagi
13416,2012-07-18,1,7,4,0,3,1,1,0.72,0.6818,0.7,0.1343,0,6,6,6,3,Pagi
13417,2012-07-18,1,7,5,0,3,1,1,0.72,0.6818,0.7,0.1642,5,41,46,46,3,Pagi
13418,2012-07-18,1,7,6,0,3,1,1,0.72,0.6818,0.7,0.1642,10,152,162,162,3,Pagi
13419,2012-07-18,1,7,7,0,3,1,1,0.74,0.697,0.66,0.1642,23,472,495,495,3,Siang
13420,2012-07-18,1,7,8,0,3,1,1,0.78,0.7424,0.62,0.1045,55,624,679,679,3,Siang
13421,2012-07-18,1,7,9,0,3,1,1,0.82,0.7879,0.56,0.0,44,253,297,297,3,Siang
13422,2012-07-18,1,7,10,0,3,1,1,0.9,0.8485,0.42,0.194,39,99,138,138,3,Siang
13423,2012-07-18,1,7,11,0,3,1,1,0.9,0.8485,0.42,0.0,47,136,183,183,3,Siang
13424,2012-07-18,1,7,12,0,3,1,1,0.92,0.8636,0.37,0.1343,36,166,202,202,3,Siang
13425,2012-07-18,1,7,13,0,3,1,1,0.94,0.8485,0.33,0.0,49,154,203,203,3,Sore
13426,2012-07-18,1,7,14,0,3,1,1,0.94,0.8788,0.38,0.3284,54,116,170,170,3,Sore
13427,2012-07-18,1,7,15,0,3,1,3,0.92,0.8485,0.35,0.3582,42,152,194,194,3,Sore
13428,2012-07-18,1,7,16,0,3,1,1,0.74,0.697,0.66,0.2537,34,190,224,224,3,Sore
13429,2012-07-18,1,7,17,0,3,1,1,0.74,0.697,0.7,0.2537,35,335,370,370,3,Sore
13430,2012-07-18,1,7,18,0,3,1,2,0.76,0.7121,0.62,0.1343,63,580,643,643,3,Sore
13431,2012-07-18,1,7,19,0,3,1,2,0.76,0.7121,0.62,0.1045,78,438,516,516,3,Malam
13432,2012-07-18,1,7,20,0,3,1,1,0.74,0.6818,0.62,0.0896,56,310,366,366,3,Malam
13433,2012-07-18,1,7,21,0,3,1,1,0.76,0.7121,0.62,0.0,53,266,319,319,3,Malam
13434,2012-07-18,1,7,22,0,3,1,1,0.76,0.7121,0.58,0.0896,42,246,288,288,3,Malam
13435,2012-07-18,1,7,23,0,3,1,1,0.76,0.7121,0.58,0.0896,19,112,131,131,3,Malam
13436,2012-07-19,1,7,0,0,4,1,1,0.74,0.697,0.66,0.0896,16,50,66,66,3,
13437,2012-07-19,1,7,1,0,4,1,1,0.74,0.697,0.66,0.0896,6,19,25,25,3,Pagi
13438,2012-07-19,1,7,2,0,4,1,1,0.72,0.6818,0.7,0.194,0,7,7,7,3,Pagi
13439,2012-07-19,1,7,3,0,4,1,1,0.72,0.6818,0.7,0.1045,1,4,5,5,3,Pagi
13440,2012-07-19,1,7,4,0,4,1,1,0.72,0.6818,0.7,0.1045,0,8,8,8,3,Pagi
13441,2012-07-19,1,7,5,0,4,1,2,0.72,0.6818,0.7,0.1045,5,35,40,40,3,Pagi
13442,2012-07-19,1,7,6,0,4,1,1,0.72,0.6818,0.66,0.1343,8,144,152,152,3,Pagi
13443,2012-07-19,1,7,7,0,4,1,1,0.74,0.6818,0.58,0.2836,23,450,473,473,3,Siang
13444,2012-07-19,1,7,8,0,4,1,1,0.76,0.7121,0.58,0.2537,32,625,657,657,3,Siang
13445,2012-07-19,1,7,9,0,4,1,2,0.76,0.7121,0.58,0.2836,36,282,318,318,3,Siang
13446,2012-07-19,1,7,10,0,4,1,1,0.76,0.7121,0.58,0.194,41,157,198,198,3,Siang
13447,2012-07-19,1,7,11,0,4,1,1,0.8,0.7576,0.55,0.1045,54,162,216,216,3,Siang
13448,2012-07-19,1,7,12,0,4,1,1,0.84,0.7879,0.49,0.2836,59,215,274,274,3,Siang
13449,2012-07-19,1,7,13,0,4,1,1,0.84,0.7727,0.47,0.1343,74,180,254,254,3,Sore
13450,2012-07-19,1,7,14,0,4,1,1,0.86,0.7879,0.44,0.0896,46,151,197,197,3,Sore
13451,2012-07-19,1,7,15,0,4,1,1,0.84,0.7727,0.47,0.0896,66,226,292,292,3,Sore
13452,2012-07-19,1,7,16,0,4,1,1,0.84,0.7727,0.47,0.0896,70,288,358,358,3,Sore
13453,2012-07-19,1,7,17,0,4,1,1,0.86,0.7879,0.41,0.0,93,678,771,771,3,Sore
13454,2012-07-19,1,7,18,0,4,1,1,0.86,0.7879,0.41,0.194,93,684,777,777,3,Sore
13455,2012-07-19,1,7,19,0,4,1,1,0.84,0.7576,0.44,0.2537,53,480,533,533,3,Malam
13456,2012-07-19,1,7,20,0,4,1,1,0.82,0.7727,0.49,0.1642,65,440,505,505,3,Malam
13457,2012-07-19,1,7,21,0,4,1,3,0.66,0.5909,0.89,0.2537,38,294,332,332,3,Malam
13458,2012-07-19,1,7,22,0,4,1,3,0.66,0.5909,0.89,0.2537,6,62,68,68,3,Malam
13459,2012-07-19,1,7,23,0,4,1,3,0.66,0.5909,0.89,0.2239,3,62,65,65,3,Malam
13460,2012-07-20,1,7,0,0,5,1,3,0.66,0.5909,0.89,0.0896,2,32,34,34,3,
13461,2012-07-20,1,7,1,0,5,1,1,0.66,0.5909,0.89,0.1343,2,9,11,11,3,Pagi
13462,2012-07-20,1,7,2,0,5,1,2,0.66,0.5909,0.89,0.0896,5,14,19,19,3,Pagi
13463,2012-07-20,1,7,3,0,5,1,2,0.66,0.5909,0.89,0.1045,7,29,36,36,3,Pagi
13464,2012-07-20,1,7,4,0,5,1,2,0.66,0.5909,0.89,0.1642,3,6,9,9,3,Pagi
13465,2012-07-20,1,7,5,0,5,1,2,0.66,0.5909,0.89,0.1343,2,40,42,42,3,Pagi
13466,2012-07-20,1,7,6,0,5,1,2,0.66,0.5909,0.89,0.1642,3,123,126,126,3,Pagi
13467,2012-07-20,1,7,7,0,5,1,2,0.66,0.5909,0.89,0.194,14,346,360,360,3,Siang
13468,2012-07-20,1,7,8,0,5,1,2,0.68,0.6364,0.83,0.1642,39,652,691,691,3,Siang
13469,2012-07-20,1,7,9,0,5,1,2,0.7,0.6667,0.79,0.1343,45,328,373,373,3,Siang
13470,2012-07-20,1,7,10,0,5,1,2,0.7,0.6667,0.79,0.1642,51,182,233,233,3,Siang
13471,2012-07-20,1,7,11,0,5,1,3,0.72,0.697,0.74,0.194,51,161,212,212,3,Siang
13472,2012-07-20,1,7,12,0,5,1,3,0.68,0.6364,0.83,0.1642,41,233,274,274,3,Siang
13473,2012-07-20,1,7,13,0,5,1,3,0.68,0.6364,0.83,0.1045,20,136,156,156,3,Sore
13474,2012-07-20,1,7,14,0,5,1,3,0.7,0.6667,0.84,0.1642,53,176,229,229,3,Sore
13475,2012-07-20,1,7,15,0,5,1,2,0.7,0.6667,0.84,0.2985,47,169,216,216,3,Sore
13476,2012-07-20,1,7,16,0,5,1,2,0.68,0.6364,0.83,0.3284,70,366,436,436,3,Sore
13477,2012-07-20,1,7,17,0,5,1,2,0.66,0.5909,0.89,0.4179,95,620,715,715,3,Sore
13478,2012-07-20,1,7,18,0,5,1,2,0.66,0.6061,0.78,0.3284,73,549,622,622,3,Sore
13479,2012-07-20,1,7,19,0,5,1,2,0.64,0.5758,0.83,0.2836,44,358,402,402,3,Malam
13480,2012-07-20,1,7,20,0,5,1,3,0.64,0.5758,0.83,0.3881,35,216,251,251,3,Malam
13481,2012-07-20,1,7,21,0,5,1,3,0.62,0.5758,0.83,0.3284,14,108,122,122,3,Malam
13482,2012-07-20,1,7,22,0,5,1,2,0.62,0.5758,0.83,0.194,13,122,135,135,3,Malam
13483,2012-07-20,1,7,23,0,5,1,2,0.62,0.5758,0.83,0.2836,18,148,166,166,3,Malam
13484,2012-07-21,1,7,0,0,6,0,3,0.62,0.5758,0.83,0.2836,11,92,103,103,3,
13485,2012-07-21,1,7,1,0,6,0,2,0.62,0.5758,0.83,0.2537,10,62,72,72,3,Pagi
13486,2012-07-21,1,7,2,0,6,0,3,0.6,0.5455,0.88,0.2836,5,55,60,60,3,Pagi
13487,2012-07-21,1,7,3,0,6,0,3,0.6,0.5455,0.88,0.2537,7,18,25,25,3,Pagi
13488,2012-07-21,1,7,4,0,6,0,3,0.58,0.5455,0.88,0.2836,11,5,16,16,3,Pagi
13489,2012-07-21,1,7,5,0,6,0,3,0.58,0.5455,0.88,0.2537,7,10,17,17,3,Pagi
13490,2012-07-21,1,7,6,0,6,0,3,0.58,0.5455,0.88,0.2537,3,12,15,15,3,Pagi
13491,2012-07-21,1,7,7,0,6,0,2,0.58,0.5455,0.88,0.2537,8,29,37,37,3,Siang
13492,2012-07-21,1,7,8,0,6,0,2,0.58,0.5455,0.83,0.2537,18,94,112,112,3,Siang
13493,2012-07-21,1,7,9,0,6,0,2,0.58,0.5455,0.83,0.194,32,175,207,207,3,Siang
13494,2012-07-21,1,7,10,0,6,0,3,0.58,0.5455,0.88,0.2537,49,219,268,268,3,Siang
13495,2012-07-21,1,7,11,0,6,0,2,0.6,0.5606,0.83,0.2537,80,225,305,305,3,Siang
13496,2012-07-21,1,7,12,0,6,0,3,0.6,0.5606,0.83,0.2239,156,301,457,457,3,Siang
13497,2012-07-21,1,7,13,0,6,0,3,0.6,0.5606,0.83,0.1642,106,248,354,354,3,Sore
13498,2012-07-21,1,7,14,0,6,0,2,0.6,0.5455,0.88,0.2537,121,222,343,343,3,Sore
13499,2012-07-21,1,7,15,0,6,0,3,0.6,0.5455,0.88,0.2537,148,232,380,380,3,Sore
13500,2012-07-21,1,7,16,0,6,0,3,0.6,0.5455,0.88,0.194,130,196,326,326,3,Sore
13501,2012-07-21,1,7,17,0,6,0,3,0.6,0.5455,0.88,0.1642,92,149,241,241,3,Sore
13502,2012-07-21,1,7,18,0,6,0,2,0.6,0.5455,0.88,0.194,51,126,177,177,3,Sore
13503,2012-07-21,1,7,19,0,6,0,2,0.6,0.5455,0.88,0.1642,67,171,238,238,3,Malam
13504,2012-07-21,1,7,20,0,6,0,3,0.6,0.5455,0.88,0.1642,51,163,214,214,3,Malam
13505,2012-07-21,1,7,21,0,6,0,2,0.6,0.5455,0.88,0.1642,29,134,163,163,3,Malam
13506,2012-07-21,1,7,22,0,6,0,2,0.6,0.5455,0.88,0.1045,40,140,180,180,3,Malam
13507,2012-07-21,1,7,23,0,6,0,2,0.6,0.5455,0.88,0.0,32,117,149,149,3,Malam
13508,2012-07-22,1,7,0,0,0,0,2,0.6,0.5455,0.88,0.1045,17,96,113,113,3,
13509,2012-07-22,1,7,1,0,0,0,2,0.6,0.5455,0.88,0.1642,31,99,130,130,3,Pagi
13510,2012-07-22,1,7,2,0,0,0,2,0.6,0.5455,0.88,0.1045,32,90,122,122,3,Pagi
13511,2012-07-22,1,7,3,0,0,0,2,0.6,0.5455,0.88,0.1045,13,30,43,43,3,Pagi
13512,2012-07-22,1,7,4,0,0,0,1,0.6,0.5455,0.88,0.0,6,10,16,16,3,Pagi
13513,2012-07-22,1,7,5,0,0,0,1,0.6,0.5455,0.88,0.0,0,6,6,6,3,Pagi
13514,2012-07-22,1,7,6,0,0,0,2,0.62,0.5758,0.83,0.0896,5,14,19,19,3,Pagi
13515,2012-07-22,1,7,7,0,0,0,2,0.62,0.5758,0.83,0.0,13,25,38,38,3,Siang
13516,2012-07-22,1,7,8,0,0,0,2,0.64,0.5909,0.78,0.0,31,122,153,153,3,Siang
13517,2012-07-22,1,7,9,0,0,0,2,0.66,0.6212,0.69,0.0,79,179,258,258,3,Siang
13518,2012-07-22,1,7,10,0,0,0,2,0.66,0.6212,0.74,0.0,114,265,379,379,3,Siang
13519,2012-07-22,1,7,11,0,0,0,2,0.66,0.6212,0.74,0.0,191,314,505,505,3,Siang
13520,2012-07-22,1,7,12,0,0,0,2,0.7,0.6515,0.7,0.1045,178,326,504,504,3,Siang
13521,2012-07-22,1,7,13,0,0,0,2,0.7,0.6515,0.65,0.0896,238,388,626,626,3,Sore
13522,2012-07-22,1,7,14,0,0,0,1,0.72,0.6818,0.66,0.1045,256,360,616,616,3,Sore
13523,2012-07-22,1,7,15,0,0,0,1,0.72,0.6818,0.66,0.1045,254,370,624,624,3,Sore
13524,2012-07-22,1,7,16,0,0,0,1,0.74,0.697,0.66,0.1045,245,383,628,628,3,Sore
13525,2012-07-22,1,7,17,0,0,0,1,0.74,0.697,0.66,0.2239,188,368,556,556,3,Sore
13526,2012-07-22,1,7,18,0,0,0,1,0.74,0.697,0.66,0.1642,173,342,515,515,3,Sore
13527,2012-07-22,1,7,19,0,0,0,1,0.72,0.6818,0.7,0.1642,180,342,522,522,3,Malam
13528,2012-07-22,1,7,20,0,0,0,1,0.7,0.6667,0.74,0.1642,124,254,378,378,3,Malam
13529,2012-07-22,1,7,21,0,0,0,1,0.7,0.6667,0.79,0.1045,88,257,345,345,3,Malam
13530,2012-07-22,1,7,22,0,0,0,1,0.7,0.6667,0.74,0.194,55,136,191,191,3,Malam
13531,2012-07-22,1,7,23,0,0,0,1,0.68,0.6364,0.79,0.1642,33,90,123,123,3,Malam
13532,2012-07-23,1,7,0,0,1,1,1,0.66,0.5909,0.89,0.0896,11,36,47,47,3,
13533,2012-07-23,1,7,1,0,1,1,1,0.66,0.5909,0.89,0.194,7,20,27,27,3,Pagi
13534,2012-07-23,1,7,2,0,1,1,2,0.66,0.5909,0.94,0.0896,3,14,17,17,3,Pagi
13535,2012-07-23,1,7,3,0,1,1,2,0.66,0.5909,0.94,0.0896,0,2,2,2,3,Pagi
13536,2012-07-23,1,7,4,0,1,1,2,0.66,0.5909,0.94,0.1343,0,8,8,8,3,Pagi
13537,2012-07-23,1,7,5,0,1,1,2,0.66,0.5909,0.94,0.1343,3,48,51,51,3,Pagi
13538,2012-07-23,1,7,6,0,1,1,2,0.68,0.6364,0.89,0.0896,9,148,157,157,3,Pagi
13539,2012-07-23,1,7,7,0,1,1,1,0.7,0.6667,0.84,0.1343,17,404,421,421,3,Siang
13540,2012-07-23,1,7,8,0,1,1,1,0.72,0.697,0.79,0.1045,47,691,738,738,3,Siang
13541,2012-07-23,1,7,9,0,1,1,2,0.74,0.7121,0.74,0.1343,57,288,345,345,3,Siang
13542,2012-07-23,1,7,10,0,1,1,2,0.78,0.7424,0.62,0.0,63,137,200,200,3,Siang
13543,2012-07-23,1,7,11,0,1,1,2,0.8,0.7424,0.52,0.1642,69,129,198,198,3,Siang
13544,2012-07-23,1,7,12,0,1,1,2,0.8,0.7424,0.52,0.1642,109,205,314,314,3,Siang
13545,2012-07-23,1,7,13,0,1,1,2,0.8,0.7424,0.52,0.1045,64,176,240,240,3,Sore
13546,2012-07-23,1,7,14,0,1,1,2,0.78,0.7424,0.59,0.1642,82,189,271,271,3,Sore
13547,2012-07-23,1,7,15,0,1,1,1,0.8,0.7576,0.55,0.194,76,205,281,281,3,Sore
13548,2012-07-23,1,7,16,0,1,1,1,0.82,0.7727,0.52,0.1343,111,346,457,457,3,Sore
13549,2012-07-23,1,7,17,0,1,1,1,0.82,0.7727,0.52,0.1343,87,760,847,847,3,Sore
13550,2012-07-23,1,7,18,0,1,1,1,0.82,0.7576,0.46,0.1045,69,672,741,741,3,Sore
13551,2012-07-23,1,7,19,0,1,1,1,0.8,0.7424,0.52,0.2537,94,488,582,582,3,Malam
13552,2012-07-23,1,7,20,0,1,1,1,0.76,0.7121,0.62,0.1642,56,347,403,403,3,Malam
13553,2012-07-23,1,7,21,0,1,1,1,0.76,0.7121,0.62,0.194,45,251,296,296,3,Malam
13554,2012-07-23,1,7,22,0,1,1,1,0.74,0.6818,0.62,0.194,40,169,209,209,3,Malam
13555,2012-07-23,1,7,23,0,1,1,1,0.72,0.6818,0.66,0.1642,16,98,114,114,3,Malam
13556,2012-07-24,1,7,0,0,2,1,1,0.7,0.6667,0.74,0.1343,12,52,64,64,3,
13557,2012-07-24,1,7,1,0,2,1,1,0.68,0.6364,0.79,0.1642,7,10,17,17,3,Pagi
13558,2012-07-24,1,7,2,0,2,1,1,0.66,0.6061,0.83,0.1642,6,10,16,16,3,Pagi
13559,2012-07-24,1,7,3,0,2,1,1,0.66,0.6061,0.83,0.1642,1,5,6,6,3,Pagi
13560,2012-07-24,1,7,4,0,2,1,1,0.66,0.6061,0.83,0.0896,0,6,6,6,3,Pagi
13561,2012-07-24,1,7,5,0,2,1,1,0.66,0.6061,0.83,0.1045,5,45,50,50,3,Pagi
13562,2012-07-24,1,7,6,0,2,1,1,0.66,0.6061,0.83,0.1343,17,173,190,190,3,Pagi
13563,2012-07-24,1,7,7,0,2,1,1,0.7,0.6667,0.74,0.1642,24,492,516,516,3,Siang
13564,2012-07-24,1,7,8,0,2,1,1,0.74,0.697,0.7,0.194,49,694,743,743,3,Siang
13565,2012-07-24,1,7,9,0,2,1,1,0.84,0.803,0.53,0.0,40,299,339,339,3,Siang
13566,2012-07-24,1,7,10,0,2,1,1,0.82,0.7879,0.56,0.2985,62,156,218,218,3,Siang
13567,2012-07-24,1,7,11,0,2,1,2,0.84,0.803,0.53,0.3284,45,156,201,201,3,Siang
13568,2012-07-24,1,7,12,0,2,1,2,0.82,0.7879,0.56,0.2239,60,169,229,229,3,Siang
13569,2012-07-24,1,7,13,0,2,1,2,0.84,0.803,0.53,0.2985,73,200,273,273,3,Sore
13570,2012-07-24,1,7,14,0,2,1,2,0.84,0.803,0.53,0.2239,48,196,244,244,3,Sore
13571,2012-07-24,1,7,15,0,2,1,1,0.82,0.7727,0.49,0.2985,73,212,285,285,3,Sore
13572,2012-07-24,1,7,16,0,2,1,1,0.8,0.7576,0.55,0.2985,86,369,455,455,3,Sore
13573,2012-07-24,1,7,17,0,2,1,1,0.8,0.7424,0.52,0.3284,94,775,869,869,3,Sore
13574,2012-07-24,1,7,18,0,2,1,1,0.76,0.7121,0.62,0.3284,110,767,877,877,3,Sore
13575,2012-07-24,1,7,19,0,2,1,1,0.76,0.7121,0.62,0.1642,109,523,632,632,3,Malam
13576,2012-07-24,1,7,20,0,2,1,1,0.74,0.697,0.66,0.1642,85,438,523,523,3,Malam
13577,2012-07-24,1,7,21,0,2,1,1,0.74,0.697,0.66,0.2239,53,325,378,378,3,Malam
13578,2012-07-24,1,7,22,0,2,1,1,0.74,0.697,0.66,0.2537,43,226,269,269,3,Malam
13579,2012-07-24,1,7,23,0,2,1,1,0.74,0.6818,0.58,0.3284,38,154,192,192,3,Malam
13580,2012-07-25,1,7,0,0,3,1,1,0.72,0.6667,0.58,0.2985,9,57,66,66,3,
13581,2012-07-25,1,7,1,0,3,1,1,0.7,0.6515,0.58,0.194,2,26,28,28,3,Pagi
13582,2012-07-25,1,7,2,0,3,1,1,0.68,0.6364,0.61,0.2239,1,11,12,12,3,Pagi
13583,2012-07-25,1,7,3,0,3,1,1,0.66,0.6212,0.65,0.2239,1,11,12,12,3,Pagi
13584,2012-07-25,1,7,4,0,3,1,1,0.64,0.6061,0.65,0.2239,0,4,4,4,3,Pagi
13585,2012-07-25,1,7,5,0,3,1,1,0.64,0.6061,0.65,0.1642,5,54,59,59,3,Pagi
13586,2012-07-25,1,7,6,0,3,1,1,0.64,0.6061,0.65,0.194,11,179,190,190,3,Pagi
13587,2012-07-25,1,7,7,0,3,1,1,0.66,0.6212,0.5,0.3284,34,473,507,507,3,Siang
13588,2012-07-25,1,7,8,0,3,1,1,0.7,0.6364,0.42,0.2537,43,745,788,788,3,Siang
13589,2012-07-25,1,7,9,0,3,1,1,0.72,0.6515,0.37,0.2985,65,277,342,342,3,Siang
13590,2012-07-25,1,7,10,0,3,1,1,0.74,0.6515,0.37,0.0,68,163,231,231,3,Siang
13591,2012-07-25,1,7,11,0,3,1,1,0.76,0.6667,0.33,0.0,79,202,281,281,3,Siang
13592,2012-07-25,1,7,12,0,3,1,1,0.76,0.6667,0.33,0.0,77,233,310,310,3,Siang
13593,2012-07-25,1,7,13,0,3,1,1,0.78,0.6818,0.31,0.1642,81,231,312,312,3,Sore
13594,2012-07-25,1,7,14,0,3,1,1,0.8,0.697,0.29,0.1343,88,159,247,247,3,Sore
13595,2012-07-25,1,7,15,0,3,1,1,0.78,0.6818,0.31,0.0896,94,223,317,317,3,Sore
13596,2012-07-25,1,7,16,0,3,1,1,0.8,0.697,0.29,0.1642,91,393,484,484,3,Sore
13597,2012-07-25,1,7,17,0,3,1,1,0.8,0.697,0.31,0.0,130,783,913,913,3,Sore
13598,2012-07-25,1,7,18,0,3,1,1,0.8,0.697,0.27,0.1343,104,787,891,891,3,Sore
13599,2012-07-25,1,7,19,0,3,1,1,0.76,0.6667,0.33,0.1343,116,582,698,698,3,Malam
13600,2012-07-25,1,7,20,0,3,1,1,0.74,0.6515,0.4,0.1642,106,461,567,567,3,Malam
13601,2012-07-25,1,7,21,0,3,1,1,0.72,0.6515,0.45,0.1343,71,326,397,397,3,Malam
13602,2012-07-25,1,7,22,0,3,1,1,0.7,0.6515,0.58,0.1343,55,223,278,278,3,Malam
13603,2012-07-25,1,7,23,0,3,1,1,0.68,0.6364,0.57,0.2985,52,187,239,239,3,Malam
13604,2012-07-26,1,7,0,0,4,1,1,0.66,0.6212,0.65,0.194,27,65,92,92,3,
13605,2012-07-26,1,7,1,0,4,1,1,0.66,0.6212,0.65,0.2239,6,23,29,29,3,Pagi
13606,2012-07-26,1,7,2,0,4,1,1,0.66,0.6212,0.69,0.2537,5,16,21,21,3,Pagi
13607,2012-07-26,1,7,3,0,4,1,1,0.66,0.6212,0.69,0.2239,0,8,8,8,3,Pagi
13608,2012-07-26,1,7,4,0,4,1,1,0.66,0.6212,0.74,0.194,0,4,4,4,3,Pagi
13609,2012-07-26,1,7,5,0,4,1,1,0.66,0.6212,0.74,0.194,2,40,42,42,3,Pagi
13610,2012-07-26,1,7,6,0,4,1,1,0.66,0.6061,0.78,0.2537,16,165,181,181,3,Pagi
13611,2012-07-26,1,7,7,0,4,1,1,0.7,0.6667,0.74,0.2537,17,478,495,495,3,Siang
13612,2012-07-26,1,7,8,0,4,1,2,0.7,0.6667,0.74,0.2537,49,680,729,729,3,Siang
13613,2012-07-26,1,7,9,0,4,1,2,0.72,0.6818,0.7,0.1343,55,289,344,344,3,Siang
13614,2012-07-26,1,7,10,0,4,1,1,0.74,0.697,0.7,0.2239,79,143,222,222,3,Siang
13615,2012-07-26,1,7,11,0,4,1,1,0.8,0.803,0.66,0.2239,69,143,212,212,3,Siang
13616,2012-07-26,1,7,12,0,4,1,1,0.84,0.8182,0.56,0.2537,73,206,279,279,3,Siang
13617,2012-07-26,1,7,13,0,4,1,1,0.86,0.8333,0.53,0.2985,53,189,242,242,3,Sore
13618,2012-07-26,1,7,14,0,4,1,1,0.9,0.8788,0.47,0.2537,62,151,213,213,3,Sore
13619,2012-07-26,1,7,15,0,4,1,1,0.92,0.8939,0.42,0.2985,65,173,238,238,3,Sore
13620,2012-07-26,1,7,16,0,4,1,1,0.94,0.8788,0.38,0.3881,62,312,374,374,3,Sore
13621,2012-07-26,1,7,17,0,4,1,1,0.9,0.8636,0.45,0.4179,110,628,738,738,3,Sore
13622,2012-07-26,1,7,18,0,4,1,1,0.92,0.8788,0.4,0.3582,73,615,688,688,3,Sore
13623,2012-07-26,1,7,19,0,4,1,1,0.9,0.8636,0.45,0.3284,80,534,614,614,3,Malam
13624,2012-07-26,1,7,20,0,4,1,1,0.86,0.8182,0.5,0.2537,47,399,446,446,3,Malam
13625,2012-07-26,1,7,21,0,4,1,1,0.8,0.7424,0.49,0.6119,35,236,271,271,3,Malam
13626,2012-07-26,1,7,22,0,4,1,1,0.8,0.7424,0.49,0.6119,33,201,234,234,3,Malam
13627,2012-07-26,1,7,23,0,4,1,1,0.72,0.6818,0.7,0.1343,18,127,145,145,3,Malam
13628,2012-07-27,1,7,0,0,5,1,1,0.72,0.6818,0.7,0.0,14,83,97,97,3,
13629,2012-07-27,1,7,1,0,5,1,1,0.72,0.6818,0.7,0.1045,12,42,54,54,3,Pagi
13630,2012-07-27,1,7,2,0,5,1,1,0.7,0.6667,0.79,0.1343,8,18,26,26,3,Pagi
13631,2012-07-27,1,7,3,0,5,1,1,0.7,0.6667,0.74,0.1642,3,9,12,12,3,Pagi
13632,2012-07-27,1,7,4,0,5,1,1,0.7,0.6667,0.79,0.0,3,5,8,8,3,Pagi
13633,2012-07-27,1,7,5,0,5,1,1,0.7,0.6667,0.84,0.0,3,34,37,37,3,Pagi
13634,2012-07-27,1,7,6,0,5,1,1,0.7,0.6667,0.79,0.0,10,129,139,139,3,Pagi
13635,2012-07-27,1,7,7,0,5,1,1,0.72,0.6818,0.7,0.194,13,397,410,410,3,Siang
13636,2012-07-27,1,7,8,0,5,1,1,0.76,0.7273,0.66,0.0896,34,642,676,676,3,Siang
13637,2012-07-27,1,7,9,0,5,1,1,0.82,0.7727,0.49,0.2836,34,329,363,363,3,Siang
13638,2012-07-27,1,7,10,0,5,1,1,0.84,0.7727,0.47,0.0,85,146,231,231,3,Siang
13639,2012-07-27,1,7,11,0,5,1,1,0.84,0.7727,0.47,0.3284,67,184,251,251,3,Siang
13640,2012-07-27,1,7,12,0,5,1,1,0.84,0.7879,0.49,0.3582,92,207,299,299,3,Siang
13641,2012-07-27,1,7,13,0,5,1,1,0.84,0.7727,0.47,0.2836,83,231,314,314,3,Sore
13642,2012-07-27,1,7,14,0,5,1,1,0.86,0.803,0.47,0.2985,105,221,326,326,3,Sore
13643,2012-07-27,1,7,15,0,5,1,1,0.86,0.7879,0.41,0.2239,81,242,323,323,3,Sore
13644,2012-07-27,1,7,16,0,5,1,1,0.84,0.7727,0.47,0.2239,80,419,499,499,3,Sore
13645,2012-07-27,1,7,17,0,5,1,1,0.86,0.7879,0.41,0.2836,101,598,699,699,3,Sore
13646,2012-07-27,1,7,18,0,5,1,1,0.82,0.7576,0.46,0.1642,100,522,622,622,3,Sore
13647,2012-07-27,1,7,19,0,5,1,1,0.82,0.7727,0.52,0.194,93,423,516,516,3,Malam
13648,2012-07-27,1,7,20,0,5,1,1,0.78,0.7424,0.59,0.1045,85,269,354,354,3,Malam
13649,2012-07-27,1,7,21,0,5,1,1,0.78,0.7424,0.59,0.1045,71,189,260,260,3,Malam
13650,2012-07-27,1,7,22,0,5,1,1,0.78,0.7424,0.59,0.1343,48,151,199,199,3,Malam
13651,2012-07-27,1,7,23,0,5,1,1,0.76,0.7273,0.66,0.0,34,155,189,189,3,Malam
13652,2012-07-28,1,7,0,0,6,0,1,0.74,0.6818,0.62,0.1343,21,170,191,191,3,
13653,2012-07-28,1,7,1,0,6,0,1,0.72,0.6818,0.7,0.0896,11,69,80,80,3,Pagi
13654,2012-07-28,1,7,2,0,6,0,1,0.72,0.6818,0.7,0.0,14,76,90,90,3,Pagi
13655,2012-07-28,1,7,3,0,6,0,1,0.72,0.6818,0.7,0.0,10,33,43,43,3,Pagi
13656,2012-07-28,1,7,4,0,6,0,1,0.7,0.6667,0.79,0.194,1,10,11,11,3,Pagi
13657,2012-07-28,1,7,5,0,6,0,1,0.68,0.6364,0.79,0.1642,4,10,14,14,3,Pagi
13658,2012-07-28,1,7,6,0,6,0,1,0.7,0.6515,0.7,0.1045,10,40,50,50,3,Pagi
13659,2012-07-28,1,7,7,0,6,0,1,0.72,0.6818,0.7,0.1343,18,58,76,76,3,Siang
13660,2012-07-28,1,7,8,0,6,0,1,0.74,0.697,0.66,0.1642,36,127,163,163,3,Siang
13661,2012-07-28,1,7,9,0,6,0,1,0.78,0.7424,0.59,0.1045,110,227,337,337,3,Siang
13662,2012-07-28,1,7,10,0,6,0,1,0.82,0.7727,0.52,0.2239,129,266,395,395,3,Siang
13663,2012-07-28,1,7,11,0,6,0,1,0.84,0.7424,0.39,0.2239,162,295,457,457,3,Siang
13664,2012-07-28,1,7,12,0,6,0,1,0.84,0.7576,0.41,0.2239,157,330,487,487,3,Siang
13665,2012-07-28,1,7,13,0,6,0,1,0.86,0.7879,0.41,0.2836,173,325,498,498,3,Sore
13666,2012-07-28,1,7,14,0,6,0,1,0.86,0.7727,0.39,0.2537,186,308,494,494,3,Sore
13667,2012-07-28,1,7,15,0,6,0,1,0.88,0.7727,0.32,0.2836,206,291,497,497,3,Sore
13668,2012-07-28,1,7,16,0,6,0,1,0.86,0.7727,0.39,0.2239,208,279,487,487,3,Sore
13669,2012-07-28,1,7,17,0,6,0,1,0.82,0.7576,0.46,0.194,199,280,479,479,3,Sore
13670,2012-07-28,1,7,18,0,6,0,1,0.82,0.7424,0.43,0.2836,151,330,481,481,3,Sore
13671,2012-07-28,1,7,19,0,6,0,1,0.68,0.6364,0.83,0.0,115,223,338,338,3,Malam
13672,2012-07-28,1,7,20,0,6,0,1,0.66,0.6061,0.83,0.2239,79,154,233,233,3,Malam
13673,2012-07-28,1,7,21,0,6,0,1,0.66,0.6061,0.78,0.0896,94,206,300,300,3,Malam
13674,2012-07-28,1,7,22,0,6,0,1,0.66,0.6061,0.78,0.0896,88,188,276,276,3,Malam
13675,2012-07-28,1,7,23,0,6,0,1,0.66,0.6061,0.83,0.0896,52,156,208,208,3,Malam
13676,2012-07-29,1,7,0,0,0,0,1,0.66,0.5909,0.89,0.1343,59,129,188,188,3,
13677,2012-07-29,1,7,1,0,0,0,1,0.66,0.6061,0.83,0.1045,49,109,158,158,3,Pagi
13678,2012-07-29,1,7,2,0,0,0,1,0.66,0.6212,0.74,0.1343,33,79,112,112,3,Pagi
13679,2012-07-29,1,7,3,0,0,0,1,0.66,0.6212,0.69,0.2239,18,37,55,55,3,Pagi
13680,2012-07-29,1,7,4,0,0,0,1,0.64,0.6061,0.69,0.194,2,11,13,13,3,Pagi
13681,2012-07-29,1,7,5,0,0,0,1,0.62,0.5909,0.78,0.194,3,14,17,17,3,Pagi
13682,2012-07-29,1,7,6,0,0,0,1,0.64,0.6061,0.73,0.1642,6,12,18,18,3,Pagi
13683,2012-07-29,1,7,7,0,0,0,1,0.66,0.6212,0.69,0.2537,4,36,40,40,3,Siang
13684,2012-07-29,1,7,8,0,0,0,1,0.7,0.6515,0.65,0.2239,37,90,127,127,3,Siang
13685,2012-07-29,1,7,9,0,0,0,1,0.72,0.6818,0.62,0.2537,64,162,226,226,3,Siang
13686,2012-07-29,1,7,10,0,0,0,1,0.74,0.6818,0.62,0.0,123,258,381,381,3,Siang
13687,2012-07-29,1,7,11,0,0,0,1,0.76,0.697,0.55,0.2239,183,326,509,509,3,Siang
13688,2012-07-29,1,7,12,0,0,0,1,0.76,0.697,0.55,0.3284,154,357,511,511,3,Siang
13689,2012-07-29,1,7,13,0,0,0,1,0.8,0.7424,0.49,0.2239,181,302,483,483,3,Sore
13690,2012-07-29,1,7,14,0,0,0,1,0.8,0.7273,0.46,0.194,231,291,522,522,3,Sore
13691,2012-07-29,1,7,15,0,0,0,1,0.8,0.7273,0.43,0.1343,195,306,501,501,3,Sore
13692,2012-07-29,1,7,16,0,0,0,1,0.8,0.7273,0.43,0.1343,191,330,521,521,3,Sore
13693,2012-07-29,1,7,17,0,0,0,1,0.82,0.7424,0.41,0.1642,164,367,531,531,3,Sore
13694,2012-07-29,1,7,18,0,0,0,1,0.8,0.7121,0.41,0.2985,117,302,419,419,3,Sore
13695,2012-07-29,1,7,19,0,0,0,1,0.76,0.697,0.55,0.1642,143,300,443,443,3,Malam
13696,2012-07-29,1,7,20,0,0,0,1,0.74,0.697,0.66,0.1045,75,228,303,303,3,Malam
13697,2012-07-29,1,7,21,0,0,0,1,0.72,0.6818,0.7,0.1343,72,199,271,271,3,Malam
13698,2012-07-29,1,7,22,0,0,0,1,0.7,0.6515,0.7,0.1045,31,117,148,148,3,Malam
13699,2012-07-29,1,7,23,0,0,0,1,0.7,0.6515,0.7,0.0,18,82,100,100,3,Malam
13700,2012-07-30,1,7,0,0,1,1,1,0.7,0.6667,0.74,0.0896,12,46,58,58,3,
13701,2012-07-30,1,7,1,0,1,1,1,0.7,0.6667,0.74,0.0,4,15,19,19,3,Pagi
13702,2012-07-30,1,7,2,0,1,1,1,0.68,0.6364,0.74,0.0,2,6,8,8,3,Pagi
13703,2012-07-30,1,7,3,0,1,1,1,0.66,0.6061,0.83,0.0,0,3,3,3,3,Pagi
13704,2012-07-30,1,7,4,0,1,1,1,0.66,0.6061,0.83,0.0,0,5,5,5,3,Pagi
13705,2012-07-30,1,7,5,0,1,1,1,0.66,0.6061,0.83,0.1045,4,43,47,47,3,Pagi
13706,2012-07-30,1,7,6,0,1,1,1,0.66,0.6061,0.83,0.1642,6,155,161,161,3,Pagi
13707,2012-07-30,1,7,7,0,1,1,1,0.7,0.6667,0.79,0.0896,14,455,469,469,3,Siang
13708,2012-07-30,1,7,8,0,1,1,2,0.72,0.697,0.74,0.1045,31,720,751,751,3,Siang
13709,2012-07-30,1,7,9,0,1,1,2,0.74,0.697,0.7,0.0,34,259,293,293,3,Siang
13710,2012-07-30,1,7,10,0,1,1,2,0.74,0.697,0.66,0.2239,54,135,189,189,3,Siang
13711,2012-07-30,1,7,11,0,1,1,2,0.78,0.7273,0.55,0.1343,69,146,215,215,3,Siang
13712,2012-07-30,1,7,12,0,1,1,2,0.76,0.7121,0.58,0.1045,77,201,278,278,3,Siang
13713,2012-07-30,1,7,13,0,1,1,1,0.8,0.7424,0.49,0.1642,57,169,226,226,3,Sore
13714,2012-07-30,1,7,14,0,1,1,1,0.8,0.7424,0.49,0.2239,87,167,254,254,3,Sore
13715,2012-07-30,1,7,15,0,1,1,1,0.8,0.7424,0.49,0.2537,51,185,236,236,3,Sore
13716,2012-07-30,1,7,16,0,1,1,1,0.8,0.7424,0.49,0.2836,88,337,425,425,3,Sore
13717,2012-07-30,1,7,17,0,1,1,1,0.76,0.697,0.55,0.3284,62,765,827,827,3,Sore
13718,2012-07-30,1,7,18,0,1,1,1,0.76,0.7121,0.58,0.4179,77,735,812,812,3,Sore
13719,2012-07-30,1,7,19,0,1,1,1,0.82,0.7727,0.52,0.1642,81,584,665,665,3,Malam
13720,2012-07-30,1,7,20,0,1,1,1,0.72,0.6818,0.7,0.2239,78,384,462,462,3,Malam
13721,2012-07-30,1,7,21,0,1,1,1,0.72,0.6818,0.7,0.194,71,251,322,322,3,Malam
13722,2012-07-30,1,7,22,0,1,1,2,0.7,0.6667,0.74,0.2239,47,183,230,230,3,Malam
13723,2012-07-30,1,7,23,0,1,1,1,0.7,0.6667,0.74,0.194,34,116,150,150,3,Malam
13724,2012-07-31,1,7,0,0,2,1,1,0.68,0.6364,0.79,0.1343,11,27,38,38,3,
13725,2012-07-31,1,7,1,0,2,1,1,0.66,0.6061,0.83,0.1343,3,18,21,21,3,Pagi
13726,2012-07-31,1,7,2,0,2,1,1,0.66,0.6061,0.83,0.1343,0,8,8,8,3,Pagi
13727,2012-07-31,1,7,3,0,2,1,1,0.66,0.6061,0.83,0.0896,1,5,6,6,3,Pagi
13728,2012-07-31,1,7,4,0,2,1,1,0.66,0.6061,0.83,0.0896,0,6,6,6,3,Pagi
13729,2012-07-31,1,7,5,0,2,1,1,0.66,0.6061,0.83,0.1642,5,40,45,45,3,Pagi
13730,2012-07-31,1,7,6,0,2,1,1,0.64,0.5758,0.89,0.1642,2,192,194,194,3,Pagi
13731,2012-07-31,1,7,7,0,2,1,1,0.68,0.6364,0.83,0.2239,21,492,513,513,3,Siang
13732,2012-07-31,1,7,8,0,2,1,1,0.7,0.6667,0.79,0.1343,30,730,760,760,3,Siang
13733,2012-07-31,1,7,9,0,2,1,1,0.72,0.6818,0.7,0.1045,31,302,333,333,3,Siang
13734,2012-07-31,1,7,10,0,2,1,1,0.72,0.6818,0.66,0.0,73,154,227,227,3,Siang
13735,2012-07-31,1,7,11,0,2,1,1,0.76,0.7121,0.58,0.0,54,170,224,224,3,Siang
13736,2012-07-31,1,7,12,0,2,1,1,0.8,0.7273,0.46,0.0,50,198,248,248,3,Siang
13737,2012-07-31,1,7,13,0,2,1,1,0.8,0.7576,0.55,0.2836,69,219,288,288,3,Sore
13738,2012-07-31,1,7,14,0,2,1,1,0.8,0.7576,0.55,0.2836,72,188,260,260,3,Sore
13739,2012-07-31,1,7,15,0,2,1,1,0.76,0.7121,0.62,0.1343,29,115,144,144,3,Sore
13740,2012-07-31,1,7,16,0,2,1,1,0.76,0.7121,0.58,0.2239,66,336,402,402,3,Sore
13741,2012-07-31,1,7,17,0,2,1,1,0.78,0.7121,0.52,0.2239,94,726,820,820,3,Sore
13742,2012-07-31,1,7,18,0,2,1,1,0.76,0.697,0.55,0.2836,99,758,857,857,3,Sore
13743,2012-07-31,1,7,19,0,2,1,3,0.74,0.6818,0.62,0.3582,90,524,614,614,3,Malam
13744,2012-07-31,1,7,20,0,2,1,3,0.7,0.6515,0.7,0.194,55,397,452,452,3,Malam
13745,2012-07-31,1,7,21,0,2,1,1,0.68,0.6364,0.79,0.194,60,292,352,352,3,Malam
13746,2012-07-31,1,7,22,0,2,1,1,0.68,0.6364,0.74,0.2537,33,224,257,257,3,Malam
13747,2012-07-31,1,7,23,0,2,1,2,0.66,0.6061,0.83,0.1642,20,127,147,147,3,Malam
13748,2012-08-01,1,8,0,0,3,1,1,0.68,0.6364,0.79,0.1642,3,44,47,47,3,
13749,2012-08-01,1,8,1,0,3,1,1,0.66,0.6061,0.83,0.0896,5,28,33,33,3,Pagi
13750,2012-08-01,1,8,2,0,3,1,1,0.64,0.5758,0.83,0.1045,0,13,13,13,3,Pagi
13751,2012-08-01,1,8,3,0,3,1,1,0.64,0.5758,0.83,0.1045,0,7,7,7,3,Pagi
13752,2012-08-01,1,8,4,0,3,1,2,0.64,0.5909,0.78,0.1343,1,3,4,4,3,Pagi
13753,2012-08-01,1,8,5,0,3,1,2,0.64,0.5909,0.78,0.1343,3,46,49,49,3,Pagi
13754,2012-08-01,1,8,6,0,3,1,1,0.64,0.5909,0.78,0.1343,6,179,185,185,3,Pagi
13755,2012-08-01,1,8,7,0,3,1,2,0.64,0.5758,0.83,0.1343,19,468,487,487,3,Siang
13756,2012-08-01,1,8,8,0,3,1,2,0.66,0.6061,0.78,0.194,32,649,681,681,3,Siang
13757,2012-08-01,1,8,9,0,3,1,2,0.68,0.6364,0.74,0.0896,34,316,350,350,3,Siang
13758,2012-08-01,1,8,10,0,3,1,1,0.72,0.6818,0.66,0.0896,61,175,236,236,3,Siang
13759,2012-08-01,1,8,11,0,3,1,1,0.76,0.7121,0.58,0.0896,54,180,234,234,3,Siang
13760,2012-08-01,1,8,12,0,3,1,1,0.8,0.7424,0.49,0.1045,75,209,284,284,3,Siang
13761,2012-08-01,1,8,13,0,3,1,1,0.8,0.7424,0.52,0.1642,59,221,280,280,3,Sore
13762,2012-08-01,1,8,14,0,3,1,1,0.82,0.7576,0.46,0.1642,88,175,263,263,3,Sore
13763,2012-08-01,1,8,15,0,3,1,1,0.82,0.7576,0.46,0.1642,89,206,295,295,3,Sore
13764,2012-08-01,1,8,16,0,3,1,1,0.8,0.7576,0.55,0.2836,93,386,479,479,3,Sore
13765,2012-08-01,1,8,17,0,3,1,1,0.8,0.7424,0.49,0.1642,103,734,837,837,3,Sore
13766,2012-08-01,1,8,18,0,3,1,3,0.76,0.7121,0.62,0.2239,105,786,891,891,3,Sore
13767,2012-08-01,1,8,19,0,3,1,1,0.74,0.697,0.66,0.2537,88,564,652,652,3,Malam
13768,2012-08-01,1,8,20,0,3,1,1,0.74,0.697,0.66,0.1642,65,448,513,513,3,Malam
13769,2012-08-01,1,8,21,0,3,1,1,0.72,0.6818,0.7,0.1343,36,284,320,320,3,Malam
13770,2012-08-01,1,8,22,0,3,1,1,0.72,0.6818,0.7,0.1045,37,251,288,288,3,Malam
13771,2012-08-01,1,8,23,0,3,1,1,0.7,0.6667,0.74,0.0,18,134,152,152,3,Malam
13772,2012-08-02,1,8,0,0,4,1,1,0.7,0.6667,0.74,0.0,8,55,63,63,3,
13773,2012-08-02,1,8,1,0,4,1,1,0.68,0.6364,0.79,0.1045,6,36,42,42,3,Pagi
13774,2012-08-02,1,8,2,0,4,1,1,0.66,0.6061,0.83,0.0896,3,8,11,11,3,Pagi
13775,2012-08-02,1,8,3,0,4,1,1,0.66,0.6061,0.83,0.0,0,6,6,6,3,Pagi
13776,2012-08-02,1,8,4,0,4,1,1,0.66,0.6061,0.83,0.0,0,9,9,9,3,Pagi
13777,2012-08-02,1,8,5,0,4,1,1,0.66,0.5909,0.89,0.1343,4,37,41,41,3,Pagi
13778,2012-08-02,1,8,6,0,4,1,1,0.66,0.6061,0.83,0.0,6,177,183,183,3,Pagi
13779,2012-08-02,1,8,7,0,4,1,1,0.7,0.6667,0.79,0.0,21,452,473,473,3,Siang
13780,2012-08-02,1,8,8,0,4,1,1,0.72,0.697,0.74,0.1045,21,718,739,739,3,Siang
13781,2012-08-02,1,8,9,0,4,1,1,0.76,0.7273,0.66,0.1045,31,312,343,343,3,Siang
13782,2012-08-02,1,8,10,0,4,1,1,0.8,0.7576,0.55,0.0,51,130,181,181,3,Siang
13783,2012-08-02,1,8,11,0,4,1,1,0.82,0.7727,0.52,0.1045,59,167,226,226,3,Siang
13784,2012-08-02,1,8,12,0,4,1,1,0.84,0.7576,0.44,0.1343,56,230,286,286,3,Siang
13785,2012-08-02,1,8,13,0,4,1,1,0.86,0.7879,0.44,0.2239,98,212,310,310,3,Sore
13786,2012-08-02,1,8,14,0,4,1,1,0.86,0.7879,0.41,0.1343,54,171,225,225,3,Sore
13787,2012-08-02,1,8,15,0,4,1,1,0.78,0.7424,0.62,0.4627,68,202,270,270,3,Sore
13788,2012-08-02,1,8,16,0,4,1,1,0.82,0.7576,0.46,0.194,71,335,406,406,3,Sore
13789,2012-08-02,1,8,17,0,4,1,1,0.82,0.7727,0.52,0.2537,90,775,865,865,3,Sore
13790,2012-08-02,1,8,18,0,4,1,1,0.8,0.7727,0.59,0.2239,86,681,767,767,3,Sore
13791,2012-08-02,1,8,19,0,4,1,1,0.8,0.7879,0.63,0.1642,98,509,607,607,3,Malam
13792,2012-08-02,1,8,20,0,4,1,1,0.78,0.7576,0.66,0.0,51,376,427,427,3,Malam
13793,2012-08-02,1,8,21,0,4,1,1,0.76,0.7273,0.66,0.2239,41,301,342,342,3,Malam
13794,2012-08-02,1,8,22,0,4,1,1,0.74,0.697,0.7,0.194,35,227,262,262,3,Malam
13795,2012-08-02,1,8,23,0,4,1,1,0.72,0.6818,0.7,0.2537,25,152,177,177,3,Malam
13796,2012-08-03,1,8,0,0,5,1,1,0.72,0.6818,0.7,0.194,15,56,71,71,3,
13797,2012-08-03,1,8,1,0,5,1,1,0.7,0.6667,0.74,0.194,11,32,43,43,3,Pagi
13798,2012-08-03,1,8,2,0,5,1,1,0.68,0.6364,0.79,0.2239,0,14,14,14,3,Pagi
13799,2012-08-03,1,8,3,0,5,1,1,0.68,0.6364,0.79,0.2239,1,5,6,6,3,Pagi
13800,2012-08-03,1,8,4,0,5,1,1,0.66,0.6061,0.83,0.2537,1,11,12,12,3,Pagi
13801,2012-08-03,1,8,5,0,5,1,1,0.66,0.6061,0.83,0.1642,2,35,37,37,3,Pagi
13802,2012-08-03,1,8,6,0,5,1,1,0.66,0.6061,0.83,0.2239,5,158,163,163,3,Pagi
13803,2012-08-03,1,8,7,0,5,1,1,0.7,0.6667,0.74,0.1045,25,396,421,421,3,Siang
13804,2012-08-03,1,8,8,0,5,1,1,0.72,0.6818,0.7,0.1343,32,636,668,668,3,Siang
13805,2012-08-03,1,8,9,0,5,1,2,0.74,0.697,0.66,0.1045,69,327,396,396,3,Siang
13806,2012-08-03,1,8,10,0,5,1,2,0.8,0.7424,0.52,0.194,82,167,249,249,3,Siang
13807,2012-08-03,1,8,11,0,5,1,2,0.84,0.7879,0.49,0.2836,77,186,263,263,3,Siang
13808,2012-08-03,1,8,12,0,5,1,2,0.86,0.8182,0.5,0.2985,95,243,338,338,3,Siang
13809,2012-08-03,1,8,13,0,5,1,2,0.86,0.803,0.47,0.2836,98,247,345,345,3,Sore
13810,2012-08-03,1,8,14,0,5,1,2,0.86,0.7879,0.44,0.2537,102,229,331,331,3,Sore
13811,2012-08-03,1,8,15,0,5,1,1,0.88,0.8182,0.42,0.2537,112,268,380,380,3,Sore
13812,2012-08-03,1,8,16,0,5,1,2,0.86,0.7879,0.41,0.2239,112,380,492,492,3,Sore
13813,2012-08-03,1,8,17,0,5,1,2,0.84,0.803,0.53,0.2836,95,646,741,741,3,Sore
13814,2012-08-03,1,8,18,0,5,1,2,0.82,0.803,0.59,0.2537,98,573,671,671,3,Sore
13815,2012-08-03,1,8,19,0,5,1,2,0.8,0.7879,0.63,0.2239,81,388,469,469,3,Malam
13816,2012-08-03,1,8,20,0,5,1,2,0.78,0.7576,0.66,0.2239,89,300,389,389,3,Malam
13817,2012-08-03,1,8,21,0,5,1,2,0.76,0.7273,0.66,0.194,54,224,278,278,3,Malam
13818,2012-08-03,1,8,22,0,5,1,1,0.76,0.7273,0.7,0.2537,46,156,202,202,3,Malam
13819,2012-08-03,1,8,23,0,5,1,1,0.74,0.7121,0.79,0.1343,26,170,196,196,3,Malam
13820,2012-08-04,1,8,0,0,6,0,1,0.74,0.7121,0.79,0.1642,24,137,161,161,3,
13821,2012-08-04,1,8,1,0,6,0,1,0.72,0.7121,0.84,0.194,23,99,122,122,3,Pagi
13822,2012-08-04,1,8,2,0,6,0,1,0.72,0.7121,0.84,0.1343,20,64,84,84,3,Pagi
13823,2012-08-04,1,8,3,0,6,0,1,0.72,0.7121,0.84,0.1343,11,19,30,30,3,Pagi
13824,2012-08-04,1,8,4,0,6,0,1,0.72,0.697,0.79,0.194,2,11,13,13,3,Pagi
13825,2012-08-04,1,8,5,0,6,0,1,0.7,0.6667,0.84,0.2239,1,16,17,17,3,Pagi
13826,2012-08-04,1,8,6,0,6,0,1,0.7,0.6667,0.84,0.2239,12,37,49,49,3,Pagi
13827,2012-08-04,1,8,7,0,6,0,1,0.72,0.697,0.77,0.1642,18,49,67,67,3,Siang
13828,2012-08-04,1,8,8,0,6,0,1,0.74,0.7273,0.72,0.194,49,132,181,181,3,Siang
13829,2012-08-04,1,8,9,0,6,0,1,0.78,0.7576,0.65,0.2239,61,217,278,278,3,Siang
13830,2012-08-04,1,8,10,0,6,0,1,0.82,0.7727,0.57,0.194,108,288,396,396,3,Siang
13831,2012-08-04,1,8,11,0,6,0,1,0.86,0.803,0.47,0.2537,155,315,470,470,3,Siang
13832,2012-08-04,1,8,12,0,6,0,1,0.86,0.7879,0.4,0.3582,222,325,547,547,3,Siang
13833,2012-08-04,1,8,13,0,6,0,1,0.88,0.8182,0.42,0.2985,195,332,527,527,3,Sore
13834,2012-08-04,1,8,14,0,6,0,1,0.88,0.803,0.4,0.3881,183,289,472,472,3,Sore
13835,2012-08-04,1,8,15,0,6,0,1,0.88,0.8182,0.42,0.4179,205,284,489,489,3,Sore
13836,2012-08-04,1,8,16,0,6,0,1,0.9,0.8182,0.39,0.2985,197,253,450,450,3,Sore
13837,2012-08-04,1,8,17,0,6,0,1,0.88,0.7879,0.37,0.2985,179,313,492,492,3,Sore
13838,2012-08-04,1,8,18,0,6,0,1,0.86,0.7879,0.41,0.3284,169,321,490,490,3,Sore
13839,2012-08-04,1,8,19,0,6,0,1,0.82,0.7727,0.52,0.3582,133,264,397,397,3,Malam
13840,2012-08-04,1,8,20,0,6,0,1,0.82,0.7727,0.52,0.2985,117,195,312,312,3,Malam
13841,2012-08-04,1,8,21,0,6,0,1,0.8,0.7727,0.59,0.2537,96,193,289,289,3,Malam
13842,2012-08-04,1,8,22,0,6,0,1,0.76,0.7273,0.66,0.2836,104,165,269,269,3,Malam
13843,2012-08-04,1,8,23,0,6,0,1,0.76,0.7273,0.66,0.2985,61,161,222,222,3,Malam
13844,2012-08-05,1,8,0,0,0,0,1,0.74,0.697,0.7,0.2836,32,121,153,153,3,
13845,2012-08-05,1,8,1,0,0,0,1,0.74,0.697,0.7,0.2537,8,79,87,87,3,Pagi
13846,2012-08-05,1,8,2,0,0,0,1,0.74,0.697,0.7,0.2985,5,68,73,73,3,Pagi
13847,2012-08-05,1,8,3,0,0,0,1,0.72,0.697,0.74,0.2537,9,32,41,41,3,Pagi
13848,2012-08-05,1,8,4,0,0,0,1,0.72,0.697,0.74,0.2537,3,11,14,14,3,Pagi
13849,2012-08-05,1,8,5,0,0,0,1,0.72,0.697,0.74,0.2537,1,18,19,19,3,Pagi
13850,2012-08-05,1,8,6,0,0,0,1,0.72,0.697,0.79,0.2537,7,12,19,19,3,Pagi
13851,2012-08-05,1,8,7,0,0,0,1,0.74,0.7121,0.74,0.2985,18,50,68,68,3,Siang
13852,2012-08-05,1,8,8,0,0,0,1,0.76,0.7273,0.66,0.3284,27,81,108,108,3,Siang
13853,2012-08-05,1,8,9,0,0,0,1,0.8,0.7727,0.59,0.3582,61,168,229,229,3,Siang
13854,2012-08-05,1,8,10,0,0,0,1,0.8,0.7727,0.59,0.4179,111,253,364,364,3,Siang
13855,2012-08-05,1,8,11,0,0,0,1,0.82,0.7879,0.56,0.4179,155,282,437,437,3,Siang
13856,2012-08-05,1,8,12,0,0,0,1,0.86,0.803,0.47,0.5224,161,330,491,491,3,Siang
13857,2012-08-05,1,8,13,0,0,0,1,0.88,0.8182,0.44,0.4627,208,315,523,523,3,Sore
13858,2012-08-05,1,8,14,0,0,0,1,0.9,0.8485,0.42,0.4627,161,365,526,526,3,Sore
13859,2012-08-05,1,8,15,0,0,0,1,0.9,0.8182,0.37,0.5224,164,286,450,450,3,Sore
13860,2012-08-05,1,8,16,0,0,0,1,0.82,0.7576,0.46,0.2537,143,278,421,421,3,Sore
13861,2012-08-05,1,8,17,0,0,0,1,0.82,0.7576,0.46,0.2537,122,260,382,382,3,Sore
13862,2012-08-05,1,8,18,0,0,0,3,0.7,0.6667,0.74,0.1343,75,154,229,229,3,Sore
13863,2012-08-05,1,8,19,0,0,0,1,0.7,0.6667,0.84,0.2239,46,139,185,185,3,Malam
13864,2012-08-05,1,8,20,0,0,0,1,0.7,0.6667,0.84,0.1045,53,140,193,193,3,Malam
13865,2012-08-05,1,8,21,0,0,0,1,0.72,0.697,0.79,0.1045,51,157,208,208,3,Malam
13866,2012-08-05,1,8,22,0,0,0,1,0.72,0.697,0.79,0.0896,57,100,157,157,3,Malam
13867,2012-08-05,1,8,23,0,0,0,2,0.72,0.697,0.79,0.1642,29,58,87,87,3,Malam
13868,2012-08-06,1,8,0,0,1,1,2,0.72,0.697,0.79,0.0,9,24,33,33,3,
13869,2012-08-06,1,8,1,0,1,1,1,0.72,0.697,0.79,0.0896,1,10,11,11,3,Pagi
13870,2012-08-06,1,8,2,0,1,1,2,0.72,0.697,0.79,0.1343,0,5,5,5,3,Pagi
13871,2012-08-06,1,8,3,0,1,1,3,0.72,0.697,0.79,0.0896,0,5,5,5,3,Pagi
13872,2012-08-06,1,8,4,0,1,1,2,0.72,0.697,0.74,0.1343,3,8,11,11,3,Pagi
13873,2012-08-06,1,8,5,0,1,1,1,0.7,0.6667,0.79,0.194,2,23,25,25,3,Pagi
13874,2012-08-06,1,8,6,0,1,1,2,0.7,0.6667,0.79,0.2239,4,137,141,141,3,Pagi
13875,2012-08-06,1,8,7,0,1,1,3,0.72,0.6818,0.7,0.194,14,393,407,407,3,Siang
13876,2012-08-06,1,8,8,0,1,1,2,0.7,0.6667,0.79,0.0,27,578,605,605,3,Siang
13877,2012-08-06,1,8,9,0,1,1,3,0.7,0.6667,0.79,0.1642,28,248,276,276,3,Siang
13878,2012-08-06,1,8,10,0,1,1,1,0.74,0.697,0.7,0.2239,54,159,213,213,3,Siang
13879,2012-08-06,1,8,11,0,1,1,1,0.76,0.7273,0.66,0.1343,108,152,260,260,3,Siang
13880,2012-08-06,1,8,12,0,1,1,2,0.78,0.7273,0.55,0.0896,72,213,285,285,3,Siang
13881,2012-08-06,1,8,13,0,1,1,1,0.8,0.7424,0.49,0.2239,85,204,289,289,3,Sore
13882,2012-08-06,1,8,14,0,1,1,1,0.82,0.7576,0.46,0.0,99,188,287,287,3,Sore
13883,2012-08-06,1,8,15,0,1,1,1,0.82,0.7576,0.46,0.1343,91,183,274,274,3,Sore
13884,2012-08-06,1,8,16,0,1,1,1,0.84,0.7576,0.41,0.1045,88,363,451,451,3,Sore
13885,2012-08-06,1,8,17,0,1,1,1,0.82,0.7424,0.41,0.0,112,746,858,858,3,Sore
13886,2012-08-06,1,8,18,0,1,1,1,0.82,0.7424,0.41,0.1343,100,743,843,843,3,Sore
13887,2012-08-06,1,8,19,0,1,1,1,0.78,0.7424,0.59,0.194,109,531,640,640,3,Malam
13888,2012-08-06,1,8,20,0,1,1,1,0.76,0.7273,0.66,0.1642,89,368,457,457,3,Malam
13889,2012-08-06,1,8,21,0,1,1,1,0.74,0.697,0.7,0.194,72,245,317,317,3,Malam
13890,2012-08-06,1,8,22,0,1,1,1,0.74,0.697,0.7,0.0896,50,157,207,207,3,Malam
13891,2012-08-06,1,8,23,0,1,1,1,0.72,0.697,0.74,0.194,16,97,113,113,3,Malam
13892,2012-08-07,1,8,0,0,2,1,1,0.7,0.6667,0.84,0.194,15,32,47,47,3,
13893,2012-08-07,1,8,1,0,2,1,1,0.7,0.6667,0.84,0.1343,2,16,18,18,3,Pagi
13894,2012-08-07,1,8,2,0,2,1,1,0.7,0.6667,0.84,0.1343,6,7,13,13,3,Pagi
13895,2012-08-07,1,8,3,0,2,1,1,0.7,0.6667,0.84,0.0,0,6,6,6,3,Pagi
13896,2012-08-07,1,8,4,0,2,1,1,0.68,0.6364,0.83,0.1343,2,7,9,9,3,Pagi
13897,2012-08-07,1,8,5,0,2,1,1,0.7,0.6667,0.79,0.1045,3,33,36,36,3,Pagi
13898,2012-08-07,1,8,6,0,2,1,2,0.7,0.6667,0.79,0.194,3,176,179,179,3,Pagi
13899,2012-08-07,1,8,7,0,2,1,2,0.7,0.6667,0.74,0.1343,21,481,502,502,3,Siang
13900,2012-08-07,1,8,8,0,2,1,2,0.7,0.6515,0.7,0.1642,41,664,705,705,3,Siang
13901,2012-08-07,1,8,9,0,2,1,2,0.7,0.6667,0.74,0.1343,44,283,327,327,3,Siang
13902,2012-08-07,1,8,10,0,2,1,2,0.74,0.697,0.7,0.1343,89,161,250,250,3,Siang
13903,2012-08-07,1,8,11,0,2,1,2,0.76,0.7273,0.66,0.0896,84,130,214,214,3,Siang
13904,2012-08-07,1,8,12,0,2,1,2,0.8,0.7576,0.55,0.1343,86,197,283,283,3,Siang
13905,2012-08-07,1,8,13,0,2,1,2,0.8,0.7424,0.52,0.194,68,185,253,253,3,Sore
13906,2012-08-07,1,8,14,0,2,1,2,0.82,0.7576,0.46,0.0,76,185,261,261,3,Sore
13907,2012-08-07,1,8,15,0,2,1,1,0.8,0.7424,0.52,0.0,100,206,306,306,3,Sore
13908,2012-08-07,1,8,16,0,2,1,3,0.76,0.7273,0.66,0.2836,101,344,445,445,3,Sore
13909,2012-08-07,1,8,17,0,2,1,2,0.78,0.7424,0.62,0.1343,125,743,868,868,3,Sore
13910,2012-08-07,1,8,18,0,2,1,2,0.76,0.7121,0.62,0.1642,103,711,814,814,3,Sore
13911,2012-08-07,1,8,19,0,2,1,2,0.76,0.7273,0.66,0.1045,104,506,610,610,3,Malam
13912,2012-08-07,1,8,20,0,2,1,2,0.74,0.697,0.7,0.1343,74,374,448,448,3,Malam
13913,2012-08-07,1,8,21,0,2,1,2,0.72,0.697,0.74,0.0,70,247,317,317,3,Malam
13914,2012-08-07,1,8,22,0,2,1,1,0.72,0.697,0.74,0.1045,43,181,224,224,3,Malam
13915,2012-08-07,1,8,23,0,2,1,1,0.72,0.697,0.79,0.0,18,120,138,138,3,Malam
13916,2012-08-08,1,8,0,0,3,1,1,0.7,0.6667,0.84,0.0,12,46,58,58,3,
13917,2012-08-08,1,8,1,0,3,1,1,0.72,0.697,0.79,0.0,3,20,23,23,3,Pagi
13918,2012-08-08,1,8,2,0,3,1,1,0.7,0.6667,0.84,0.0,1,5,6,6,3,Pagi
13919,2012-08-08,1,8,3,0,3,1,1,0.7,0.6667,0.84,0.0,1,6,7,7,3,Pagi
13920,2012-08-08,1,8,4,0,3,1,1,0.7,0.6667,0.84,0.0,1,6,7,7,3,Pagi
13921,2012-08-08,1,8,5,0,3,1,2,0.68,0.6364,0.89,0.1642,3,40,43,43,3,Pagi
13922,2012-08-08,1,8,6,0,3,1,2,0.7,0.6667,0.84,0.1642,4,169,173,173,3,Pagi
13923,2012-08-08,1,8,7,0,3,1,2,0.7,0.6667,0.84,0.1642,24,458,482,482,3,Siang
13924,2012-08-08,1,8,8,0,3,1,2,0.74,0.7273,0.72,0.0896,48,689,737,737,3,Siang
13925,2012-08-08,1,8,9,0,3,1,2,0.76,0.7273,0.66,0.0,33,308,341,341,3,Siang
13926,2012-08-08,1,8,10,0,3,1,2,0.8,0.7424,0.52,0.1343,63,151,214,214,3,Siang
13927,2012-08-08,1,8,11,0,3,1,2,0.8,0.7424,0.52,0.0,80,159,239,239,3,Siang
13928,2012-08-08,1,8,12,0,3,1,2,0.8,0.7424,0.52,0.0,63,217,280,280,3,Siang
13929,2012-08-08,1,8,13,0,3,1,2,0.8,0.7424,0.52,0.0,101,212,313,313,3,Sore
13930,2012-08-08,1,8,14,0,3,1,2,0.8,0.7424,0.52,0.2537,63,173,236,236,3,Sore
13931,2012-08-08,1,8,15,0,3,1,2,0.84,0.7576,0.44,0.194,110,168,278,278,3,Sore
13932,2012-08-08,1,8,16,0,3,1,2,0.8,0.7424,0.49,0.2836,113,328,441,441,3,Sore
13933,2012-08-08,1,8,17,0,3,1,2,0.8,0.7576,0.55,0.2836,107,751,858,858,3,Sore
13934,2012-08-08,1,8,18,0,3,1,2,0.78,0.7273,0.55,0.1642,117,745,862,862,3,Sore
13935,2012-08-08,1,8,19,0,3,1,1,0.76,0.7273,0.66,0.2239,119,567,686,686,3,Malam
13936,2012-08-08,1,8,20,0,3,1,1,0.74,0.697,0.66,0.194,76,424,500,500,3,Malam
13937,2012-08-08,1,8,21,0,3,1,1,0.74,0.697,0.66,0.1045,70,311,381,381,3,Malam
13938,2012-08-08,1,8,22,0,3,1,1,0.72,0.697,0.74,0.1045,35,198,233,233,3,Malam
13939,2012-08-08,1,8,23,0,3,1,1,0.72,0.6818,0.7,0.1343,16,120,136,136,3,Malam
13940,2012-08-09,1,8,0,0,4,1,1,0.72,0.697,0.74,0.194,16,51,67,67,3,
13941,2012-08-09,1,8,1,0,4,1,1,0.7,0.6667,0.79,0.1343,5,23,28,28,3,Pagi
13942,2012-08-09,1,8,2,0,4,1,1,0.7,0.6667,0.84,0.0896,2,12,14,14,3,Pagi
13943,2012-08-09,1,8,3,0,4,1,1,0.68,0.6364,0.83,0.0896,1,5,6,6,3,Pagi
13944,2012-08-09,1,8,4,0,4,1,2,0.68,0.6364,0.89,0.1343,0,10,10,10,3,Pagi
13945,2012-08-09,1,8,5,0,4,1,2,0.66,0.5909,0.94,0.0,4,37,41,41,3,Pagi
13946,2012-08-09,1,8,6,0,4,1,1,0.66,0.6061,0.83,0.1642,5,162,167,167,3,Pagi
13947,2012-08-09,1,8,7,0,4,1,2,0.7,0.6667,0.84,0.1642,24,451,475,475,3,Siang
13948,2012-08-09,1,8,8,0,4,1,1,0.72,0.697,0.74,0.1045,28,670,698,698,3,Siang
13949,2012-08-09,1,8,9,0,4,1,1,0.76,0.7273,0.66,0.1642,54,299,353,353,3,Siang
13950,2012-08-09,1,8,10,0,4,1,1,0.8,0.7576,0.55,0.2239,72,133,205,205,3,Siang
13951,2012-08-09,1,8,11,0,4,1,1,0.84,0.7576,0.44,0.0,94,166,260,260,3,Siang
13952,2012-08-09,1,8,12,0,4,1,1,0.84,0.7576,0.44,0.1045,85,192,277,277,3,Siang
13953,2012-08-09,1,8,13,0,4,1,1,0.86,0.7879,0.41,0.1045,80,201,281,281,3,Sore
13954,2012-08-09,1,8,14,0,4,1,1,0.88,0.7727,0.32,0.2239,86,161,247,247,3,Sore
13955,2012-08-09,1,8,15,0,4,1,1,0.88,0.7727,0.32,0.2239,63,204,267,267,3,Sore
13956,2012-08-09,1,8,16,0,4,1,1,0.86,0.7727,0.39,0.2537,97,320,417,417,3,Sore
13957,2012-08-09,1,8,17,0,4,1,1,0.86,0.7576,0.36,0.2537,111,699,810,810,3,Sore
13958,2012-08-09,1,8,18,0,4,1,2,0.82,0.7576,0.46,0.2537,78,733,811,811,3,Sore
13959,2012-08-09,1,8,19,0,4,1,1,0.8,0.7576,0.55,0.194,90,533,623,623,3,Malam
13960,2012-08-09,1,8,20,0,4,1,1,0.7,0.6515,0.54,0.2836,91,387,478,478,3,Malam
13961,2012-08-09,1,8,21,0,4,1,2,0.7,0.6515,0.58,0.1642,50,286,336,336,3,Malam
13962,2012-08-09,1,8,22,0,4,1,2,0.66,0.6212,0.69,0.2239,41,218,259,259,3,Malam
13963,2012-08-09,1,8,23,0,4,1,1,0.66,0.6212,0.74,0.0,19,137,156,156,3,Malam
13964,2012-08-10,1,8,0,0,5,1,1,0.7,0.6515,0.65,0.0896,17,68,85,85,3,
13965,2012-08-10,1,8,1,0,5,1,1,0.7,0.6515,0.65,0.1045,6,35,41,41,3,Pagi
13966,2012-08-10,1,8,2,0,5,1,1,0.7,0.6667,0.74,0.1642,6,14,20,20,3,Pagi
13967,2012-08-10,1,8,3,0,5,1,2,0.72,0.697,0.79,0.194,3,6,9,9,3,Pagi
13968,2012-08-10,1,8,4,0,5,1,3,0.7,0.6667,0.84,0.2836,0,7,7,7,3,Pagi
13969,2012-08-10,1,8,5,0,5,1,3,0.7,0.6667,0.84,0.2836,4,29,33,33,3,Pagi
13970,2012-08-10,1,8,6,0,5,1,3,0.64,0.5758,0.89,0.2985,3,41,44,44,3,Pagi
13971,2012-08-10,1,8,7,0,5,1,3,0.64,0.5758,0.89,0.1045,5,128,133,133,3,Siang
13972,2012-08-10,1,8,8,0,5,1,3,0.62,0.5455,0.91,0.1642,7,112,119,119,3,Siang
13973,2012-08-10,1,8,9,0,5,1,2,0.64,0.5758,0.89,0.0,21,199,220,220,3,Siang
13974,2012-08-10,1,8,10,0,5,1,1,0.66,0.5909,0.89,0.1045,27,166,193,193,3,Siang
13975,2012-08-10,1,8,11,0,5,1,3,0.68,0.6364,0.79,0.1343,73,178,251,251,3,Siang
13976,2012-08-10,1,8,12,0,5,1,2,0.74,0.697,0.66,0.3582,75,240,315,315,3,Siang
13977,2012-08-10,1,8,13,0,5,1,2,0.76,0.7121,0.58,0.3582,66,224,290,290,3,Sore
13978,2012-08-10,1,8,14,0,5,1,1,0.76,0.7121,0.58,0.3582,71,236,307,307,3,Sore
13979,2012-08-10,1,8,15,0,5,1,1,0.8,0.7424,0.52,0.4478,100,224,324,324,3,Sore
13980,2012-08-10,1,8,16,0,5,1,1,0.78,0.7273,0.55,0.2985,96,371,467,467,3,Sore
13981,2012-08-10,1,8,17,0,5,1,1,0.8,0.7424,0.52,0.2836,111,619,730,730,3,Sore
13982,2012-08-10,1,8,18,0,5,1,1,0.76,0.7121,0.62,0.2985,88,552,640,640,3,Sore
13983,2012-08-10,1,8,19,0,5,1,1,0.76,0.7121,0.62,0.2836,98,394,492,492,3,Malam
13984,2012-08-10,1,8,20,0,5,1,1,0.74,0.697,0.66,0.2985,55,315,370,370,3,Malam
13985,2012-08-10,1,8,21,0,5,1,1,0.74,0.697,0.66,0.2537,50,236,286,286,3,Malam
13986,2012-08-10,1,8,22,0,5,1,1,0.72,0.697,0.74,0.2836,50,168,218,218,3,Malam
13987,2012-08-10,1,8,23,0,5,1,1,0.72,0.6818,0.7,0.2836,33,159,192,192,3,Malam
13988,2012-08-11,1,8,0,0,6,0,1,0.7,0.6515,0.7,0.2836,38,142,180,180,3,
13989,2012-08-11,1,8,1,0,6,0,1,0.66,0.6212,0.74,0.2239,32,84,116,116,3,Pagi
13990,2012-08-11,1,8,2,0,6,0,3,0.64,0.5909,0.78,0.194,19,66,85,85,3,Pagi
13991,2012-08-11,1,8,3,0,6,0,3,0.62,0.5758,0.83,0.1642,2,19,21,21,3,Pagi
13992,2012-08-11,1,8,4,0,6,0,1,0.62,0.5758,0.83,0.1045,3,7,10,10,3,Pagi
13993,2012-08-11,1,8,5,0,6,0,1,0.62,0.5606,0.88,0.1045,2,9,11,11,3,Pagi
13994,2012-08-11,1,8,6,0,6,0,2,0.62,0.5606,0.88,0.1045,5,18,23,23,3,Pagi
13995,2012-08-11,1,8,7,0,6,0,1,0.64,0.5758,0.83,0.0896,8,54,62,62,3,Siang
13996,2012-08-11,1,8,8,0,6,0,1,0.66,0.6061,0.83,0.1045,30,132,162,162,3,Siang
13997,2012-08-11,1,8,9,0,6,0,1,0.68,0.6364,0.79,0.194,54,217,271,271,3,Siang
13998,2012-08-11,1,8,10,0,6,0,1,0.72,0.6818,0.62,0.0896,125,282,407,407,3,Siang
13999,2012-08-11,1,8,11,0,6,0,1,0.74,0.697,0.66,0.1642,203,296,499,499,3,Siang
14000,2012-08-11,1,8,12,0,6,0,1,0.76,0.7121,0.58,0.2239,214,332,546,546,3,Siang
14001,2012-08-11,1,8,13,0,6,0,1,0.8,0.7424,0.49,0.3582,228,341,569,569,3,Sore
14002,2012-08-11,1,8,14,0,6,0,1,0.8,0.7424,0.49,0.2985,248,290,538,538,3,Sore
14003,2012-08-11,1,8,15,0,6,0,1,0.8,0.7273,0.46,0.2836,246,316,562,562,3,Sore
14004,2012-08-11,1,8,16,0,6,0,1,0.8,0.7273,0.46,0.2985,227,304,531,531,3,Sore
14005,2012-08-11,1,8,17,0,6,0,3,0.74,0.697,0.66,0.3582,220,292,512,512,3,Sore
14006,2012-08-11,1,8,18,0,6,0,2,0.7,0.6667,0.74,0.2985,107,193,300,300,3,Sore
14007,2012-08-11,1,8,19,0,6,0,2,0.66,0.5909,0.89,0.1045,97,178,275,275,3,Malam
14008,2012-08-11,1,8,20,0,6,0,3,0.66,0.5909,0.89,0.4179,31,129,160,160,3,Malam
14009,2012-08-11,1,8,21,0,6,0,2,0.66,0.5909,0.89,0.1642,26,102,128,128,3,Malam
14010,2012-08-11,1,8,22,0,6,0,2,0.66,0.5909,0.89,0.1642,40,128,168,168,3,Malam
14011,2012-08-11,1,8,23,0,6,0,3,0.66,0.6061,0.78,0.1642,42,121,163,163,3,Malam
14012,2012-08-12,1,8,0,0,0,0,2,0.64,0.6061,0.73,0.1343,24,96,120,120,3,
14013,2012-08-12,1,8,1,0,0,0,1,0.62,0.5909,0.78,0.1343,21,92,113,113,3,Pagi
14014,2012-08-12,1,8,2,0,0,0,1,0.64,0.6061,0.69,0.1343,19,67,86,86,3,Pagi
14015,2012-08-12,1,8,3,0,0,0,1,0.62,0.5909,0.73,0.0896,11,37,48,48,3,Pagi
14016,2012-08-12,1,8,4,0,0,0,1,0.64,0.6061,0.69,0.0896,2,8,10,10,3,Pagi
14017,2012-08-12,1,8,5,0,0,0,1,0.64,0.6212,0.61,0.194,1,9,10,10,3,Pagi
14018,2012-08-12,1,8,6,0,0,0,1,0.64,0.6061,0.65,0.1642,2,14,16,16,3,Pagi
14019,2012-08-12,1,8,7,0,0,0,1,0.64,0.6061,0.65,0.1343,9,30,39,39,3,Siang
14020,2012-08-12,1,8,8,0,0,0,1,0.66,0.6212,0.54,0.2239,35,84,119,119,3,Siang
14021,2012-08-12,1,8,9,0,0,0,1,0.7,0.6515,0.48,0.2239,64,153,217,217,3,Siang
14022,2012-08-12,1,8,10,0,0,0,1,0.7,0.6515,0.51,0.1642,88,240,328,328,3,Siang
14023,2012-08-12,1,8,11,0,0,0,1,0.74,0.6667,0.42,0.1642,167,282,449,449,3,Siang
14024,2012-08-12,1,8,12,0,0,0,1,0.74,0.6667,0.42,0.194,163,342,505,505,3,Siang
14025,2012-08-12,1,8,13,0,0,0,1,0.78,0.697,0.4,0.0,178,365,543,543,3,Sore
14026,2012-08-12,1,8,14,0,0,0,1,0.76,0.6818,0.4,0.194,213,366,579,579,3,Sore
14027,2012-08-12,1,8,15,0,0,0,1,0.76,0.6818,0.4,0.1343,235,342,577,577,3,Sore
14028,2012-08-12,1,8,16,0,0,0,1,0.76,0.6818,0.4,0.1045,213,300,513,513,3,Sore
14029,2012-08-12,1,8,17,0,0,0,1,0.8,0.697,0.33,0.0,186,319,505,505,3,Sore
14030,2012-08-12,1,8,18,0,0,0,1,0.78,0.6818,0.35,0.1045,164,327,491,491,3,Sore
14031,2012-08-12,1,8,19,0,0,0,1,0.74,0.6515,0.4,0.1343,148,317,465,465,3,Malam
14032,2012-08-12,1,8,20,0,0,0,1,0.72,0.6515,0.45,0.0,96,204,300,300,3,Malam
14033,2012-08-12,1,8,21,0,0,0,1,0.72,0.6667,0.51,0.0896,78,142,220,220,3,Malam
14034,2012-08-12,1,8,22,0,0,0,1,0.7,0.6515,0.58,0.1343,40,141,181,181,3,Malam
14035,2012-08-12,1,8,23,0,0,0,1,0.68,0.6364,0.61,0.0,25,85,110,110,3,Malam
14036,2012-08-13,1,8,0,0,1,1,1,0.66,0.6212,0.65,0.1045,14,33,47,47,3,
14037,2012-08-13,1,8,1,0,1,1,1,0.66,0.6212,0.65,0.0896,3,11,14,14,3,Pagi
14038,2012-08-13,1,8,2,0,1,1,1,0.64,0.6061,0.69,0.1045,1,8,9,9,3,Pagi
14039,2012-08-13,1,8,3,0,1,1,1,0.64,0.6061,0.69,0.0,1,5,6,6,3,Pagi
14040,2012-08-13,1,8,4,0,1,1,1,0.64,0.6061,0.69,0.1045,0,11,11,11,3,Pagi
14041,2012-08-13,1,8,5,0,1,1,1,0.64,0.6061,0.69,0.1045,3,33,36,36,3,Pagi
14042,2012-08-13,1,8,6,0,1,1,1,0.62,0.5909,0.73,0.0896,4,155,159,159,3,Pagi
14043,2012-08-13,1,8,7,0,1,1,1,0.66,0.6212,0.65,0.1343,11,425,436,436,3,Siang
14044,2012-08-13,1,8,8,0,1,1,2,0.72,0.6667,0.51,0.0896,25,648,673,673,3,Siang
14045,2012-08-13,1,8,9,0,1,1,2,0.74,0.6667,0.45,0.0,40,265,305,305,3,Siang
14046,2012-08-13,1,8,10,0,1,1,2,0.76,0.6818,0.4,0.0,88,111,199,199,3,Siang
14047,2012-08-13,1,8,11,0,1,1,1,0.76,0.6818,0.4,0.0896,94,151,245,245,3,Siang
14048,2012-08-13,1,8,12,0,1,1,1,0.78,0.697,0.4,0.194,96,180,276,276,3,Siang
14049,2012-08-13,1,8,13,0,1,1,1,0.78,0.697,0.4,0.1642,79,175,254,254,3,Sore
14050,2012-08-13,1,8,14,0,1,1,1,0.8,0.697,0.33,0.1045,85,163,248,248,3,Sore
14051,2012-08-13,1,8,15,0,1,1,1,0.82,0.7273,0.34,0.2239,80,194,274,274,3,Sore
14052,2012-08-13,1,8,16,0,1,1,1,0.8,0.7121,0.36,0.0896,116,348,464,464,3,Sore
14053,2012-08-13,1,8,17,0,1,1,1,0.8,0.7121,0.36,0.1642,102,716,818,818,3,Sore
14054,2012-08-13,1,8,18,0,1,1,1,0.76,0.697,0.52,0.2836,103,709,812,812,3,Sore
14055,2012-08-13,1,8,19,0,1,1,1,0.74,0.6818,0.58,0.1642,88,467,555,555,3,Malam
14056,2012-08-13,1,8,20,0,1,1,1,0.74,0.6818,0.62,0.2239,58,374,432,432,3,Malam
14057,2012-08-13,1,8,21,0,1,1,1,0.72,0.6818,0.66,0.194,44,246,290,290,3,Malam
14058,2012-08-13,1,8,22,0,1,1,1,0.72,0.6818,0.62,0.3284,44,148,192,192,3,Malam
14059,2012-08-13,1,8,23,0,1,1,1,0.7,0.6515,0.7,0.2239,28,100,128,128,3,Malam
14060,2012-08-14,1,8,0,0,2,1,1,0.7,0.6667,0.74,0.2239,12,48,60,60,3,
14061,2012-08-14,1,8,1,0,2,1,1,0.68,0.6364,0.79,0.2537,8,19,27,27,3,Pagi
14062,2012-08-14,1,8,2,0,2,1,2,0.68,0.6364,0.83,0.194,2,9,11,11,3,Pagi
14063,2012-08-14,1,8,3,0,2,1,2,0.68,0.6364,0.83,0.194,0,3,3,3,3,Pagi
14064,2012-08-14,1,8,4,0,2,1,2,0.68,0.6364,0.83,0.194,0,5,5,5,3,Pagi
14065,2012-08-14,1,8,5,0,2,1,2,0.68,0.6364,0.89,0.194,1,35,36,36,3,Pagi
14066,2012-08-14,1,8,6,0,2,1,3,0.64,0.5758,0.83,0.194,1,63,64,64,3,Pagi
14067,2012-08-14,1,8,7,0,2,1,2,0.66,0.6061,0.83,0.0896,1,178,179,179,3,Siang
14068,2012-08-14,1,8,8,0,2,1,2,0.66,0.5909,0.89,0.0896,27,591,618,618,3,Siang
14069,2012-08-14,1,8,9,0,2,1,2,0.7,0.6667,0.74,0.0,48,354,402,402,3,Siang
14070,2012-08-14,1,8,10,0,2,1,1,0.7,0.6667,0.79,0.1045,53,155,208,208,3,Siang
14071,2012-08-14,1,8,11,0,2,1,1,0.74,0.6818,0.62,0.0,69,127,196,196,3,Siang
14072,2012-08-14,1,8,12,0,2,1,1,0.78,0.7121,0.49,0.1343,93,207,300,300,3,Siang
14073,2012-08-14,1,8,13,0,2,1,1,0.8,0.7273,0.46,0.0896,83,203,286,286,3,Sore
14074,2012-08-14,1,8,14,0,2,1,1,0.82,0.7424,0.41,0.2239,80,175,255,255,3,Sore
14075,2012-08-14,1,8,15,0,2,1,1,0.82,0.7576,0.46,0.2239,84,199,283,283,3,Sore
14076,2012-08-14,1,8,16,0,2,1,1,0.82,0.7424,0.43,0.2239,95,363,458,458,3,Sore
14077,2012-08-14,1,8,17,0,2,1,3,0.76,0.7273,0.66,0.2537,78,734,812,812,3,Sore
14078,2012-08-14,1,8,18,0,2,1,1,0.76,0.7121,0.62,0.2836,97,757,854,854,3,Sore
14079,2012-08-14,1,8,19,0,2,1,1,0.76,0.7273,0.66,0.194,94,533,627,627,3,Malam
14080,2012-08-14,1,8,20,0,2,1,1,0.74,0.7121,0.74,0.2239,65,371,436,436,3,Malam
14081,2012-08-14,1,8,21,0,2,1,1,0.74,0.6818,0.62,0.2239,56,252,308,308,3,Malam
14082,2012-08-14,1,8,22,0,2,1,1,0.72,0.6818,0.66,0.0896,28,161,189,189,3,Malam
14083,2012-08-14,1,8,23,0,2,1,1,0.72,0.6818,0.66,0.1642,53,114,167,167,3,Malam
14084,2012-08-15,1,8,0,0,3,1,1,0.7,0.6515,0.61,0.194,8,52,60,60,3,
14085,2012-08-15,1,8,1,0,3,1,1,0.7,0.6515,0.61,0.0,6,31,37,37,3,Pagi
14086,2012-08-15,1,8,2,0,3,1,1,0.68,0.6364,0.65,0.0,1,7,8,8,3,Pagi
14087,2012-08-15,1,8,3,0,3,1,1,0.66,0.6212,0.74,0.1045,1,10,11,11,3,Pagi
14088,2012-08-15,1,8,4,0,3,1,1,0.64,0.5758,0.83,0.1045,0,4,4,4,3,Pagi
14089,2012-08-15,1,8,5,0,3,1,1,0.64,0.5909,0.78,0.1045,4,35,39,39,3,Pagi
14090,2012-08-15,1,8,6,0,3,1,1,0.64,0.5909,0.78,0.1045,12,160,172,172,3,Pagi
14091,2012-08-15,1,8,7,0,3,1,2,0.66,0.6212,0.69,0.194,25,467,492,492,3,Siang
14092,2012-08-15,1,8,8,0,3,1,2,0.7,0.6515,0.65,0.2836,40,642,682,682,3,Siang
14093,2012-08-15,1,8,9,0,3,1,2,0.72,0.6818,0.62,0.194,57,310,367,367,3,Siang
14094,2012-08-15,1,8,10,0,3,1,2,0.72,0.6818,0.62,0.194,70,163,233,233,3,Siang
14095,2012-08-15,1,8,11,0,3,1,2,0.74,0.6818,0.58,0.194,80,155,235,235,3,Siang
14096,2012-08-15,1,8,12,0,3,1,1,0.74,0.6818,0.55,0.2239,77,230,307,307,3,Siang
14097,2012-08-15,1,8,13,0,3,1,2,0.78,0.7121,0.49,0.194,88,206,294,294,3,Sore
14098,2012-08-15,1,8,14,0,3,1,2,0.76,0.697,0.52,0.2985,94,161,255,255,3,Sore
14099,2012-08-15,1,8,15,0,3,1,1,0.76,0.697,0.52,0.2537,70,196,266,266,3,Sore
14100,2012-08-15,1,8,16,0,3,1,1,0.76,0.6818,0.48,0.194,91,340,431,431,3,Sore
14101,2012-08-15,1,8,17,0,3,1,1,0.74,0.6818,0.55,0.2836,102,749,851,851,3,Sore
14102,2012-08-15,1,8,18,0,3,1,1,0.74,0.6667,0.51,0.2239,80,768,848,848,3,Sore
14103,2012-08-15,1,8,19,0,3,1,1,0.7,0.6515,0.61,0.1343,124,525,649,649,3,Malam
14104,2012-08-15,1,8,20,0,3,1,1,0.7,0.6515,0.61,0.1343,72,355,427,427,3,Malam
14105,2012-08-15,1,8,21,0,3,1,1,0.7,0.6515,0.61,0.194,49,266,315,315,3,Malam
14106,2012-08-15,1,8,22,0,3,1,1,0.7,0.6515,0.61,0.1642,29,197,226,226,3,Malam
14107,2012-08-15,1,8,23,0,3,1,1,0.68,0.6364,0.65,0.1045,18,120,138,138,3,Malam
14108,2012-08-16,1,8,0,0,4,1,1,0.66,0.6212,0.69,0.0,13,63,76,76,3,
14109,2012-08-16,1,8,1,0,4,1,1,0.64,0.6061,0.73,0.0,3,18,21,21,3,Pagi
14110,2012-08-16,1,8,2,0,4,1,1,0.64,0.6061,0.69,0.194,0,15,15,15,3,Pagi
14111,2012-08-16,1,8,3,0,4,1,1,0.62,0.5909,0.73,0.2537,0,4,4,4,3,Pagi
14112,2012-08-16,1,8,4,0,4,1,1,0.62,0.5909,0.73,0.2239,2,3,5,5,3,Pagi
14113,2012-08-16,1,8,5,0,4,1,1,0.6,0.5758,0.78,0.1642,7,30,37,37,3,Pagi
14114,2012-08-16,1,8,6,0,4,1,1,0.6,0.5758,0.78,0.1642,3,162,165,165,3,Pagi
14115,2012-08-16,1,8,7,0,4,1,1,0.64,0.6061,0.69,0.2239,16,448,464,464,3,Siang
14116,2012-08-16,1,8,8,0,4,1,1,0.68,0.6364,0.61,0.194,33,649,682,682,3,Siang
14117,2012-08-16,1,8,9,0,4,1,1,0.72,0.6667,0.54,0.1045,41,296,337,337,3,Siang
14118,2012-08-16,1,8,10,0,4,1,1,0.74,0.6667,0.48,0.1343,78,121,199,199,3,Siang
14119,2012-08-16,1,8,11,0,4,1,1,0.76,0.6667,0.37,0.0896,83,191,274,274,3,Siang
14120,2012-08-16,1,8,12,0,4,1,1,0.8,0.697,0.33,0.1045,96,247,343,343,3,Siang
14121,2012-08-16,1,8,13,0,4,1,1,0.8,0.697,0.31,0.2239,81,219,300,300,3,Sore
14122,2012-08-16,1,8,14,0,4,1,1,0.82,0.7121,0.32,0.0,72,176,248,248,3,Sore
14123,2012-08-16,1,8,15,0,4,1,1,0.8,0.697,0.33,0.2537,63,197,260,260,3,Sore
14124,2012-08-16,1,8,16,0,4,1,1,0.82,0.7121,0.32,0.2239,79,340,419,419,3,Sore
14125,2012-08-16,1,8,17,0,4,1,1,0.82,0.7273,0.34,0.194,130,767,897,897,3,Sore
14126,2012-08-16,1,8,18,0,4,1,1,0.8,0.7121,0.36,0.0,109,723,832,832,3,Sore
14127,2012-08-16,1,8,19,0,4,1,1,0.76,0.6818,0.4,0.1045,119,558,677,677,3,Malam
14128,2012-08-16,1,8,20,0,4,1,1,0.76,0.6818,0.4,0.0896,100,414,514,514,3,Malam
14129,2012-08-16,1,8,21,0,4,1,1,0.74,0.6667,0.48,0.194,83,273,356,356,3,Malam
14130,2012-08-16,1,8,22,0,4,1,1,0.72,0.6667,0.51,0.1642,69,185,254,254,3,Malam
14131,2012-08-16,1,8,23,0,4,1,1,0.7,0.6515,0.54,0.1045,58,168,226,226,3,Malam
14132,2012-08-17,1,8,0,0,5,1,1,0.68,0.2424,0.57,0.1642,21,67,88,88,3,
14133,2012-08-17,1,8,1,0,5,1,1,0.66,0.2424,0.65,0.1045,16,38,54,54,3,Pagi
14134,2012-08-17,1,8,2,0,5,1,1,0.66,0.2424,0.61,0.1343,4,15,19,19,3,Pagi
14135,2012-08-17,1,8,3,0,5,1,1,0.64,0.2424,0.65,0.1045,0,6,6,6,3,Pagi
14136,2012-08-17,1,8,4,0,5,1,1,0.64,0.2424,0.73,0.1642,0,9,9,9,3,Pagi
14137,2012-08-17,1,8,5,0,5,1,1,0.64,0.2424,0.73,0.1045,2,34,36,36,3,Pagi
14138,2012-08-17,1,8,6,0,5,1,1,0.62,0.2424,0.78,0.1343,6,151,157,157,3,Pagi
14139,2012-08-17,1,8,7,0,5,1,1,0.64,0.2424,0.73,0.1045,11,368,379,379,3,Siang
14140,2012-08-17,1,8,8,0,5,1,1,0.68,0.2424,0.65,0.1343,43,625,668,668,3,Siang
14141,2012-08-17,1,8,9,0,5,1,1,0.7,0.2424,0.58,0.1045,58,320,378,378,3,Siang
14142,2012-08-17,1,8,10,0,5,1,1,0.74,0.2424,0.55,0.1642,82,149,231,231,3,Siang
14143,2012-08-17,1,8,11,0,5,1,1,0.76,0.2424,0.52,0.2836,98,205,303,303,3,Siang
14144,2012-08-17,1,8,12,0,5,1,1,0.82,0.2424,0.41,0.2239,110,255,365,365,3,Siang
14145,2012-08-17,1,8,13,0,5,1,1,0.84,0.2424,0.36,0.3881,103,254,357,357,3,Sore
14146,2012-08-17,1,8,14,0,5,1,1,0.86,0.2424,0.34,0.4179,128,200,328,328,3,Sore
14147,2012-08-17,1,8,15,0,5,1,1,0.86,0.2424,0.3,0.4627,127,256,383,383,3,Sore
14148,2012-08-17,1,8,16,0,5,1,2,0.84,0.2424,0.32,0.4478,116,372,488,488,3,Sore
14149,2012-08-17,1,8,17,0,5,1,1,0.82,0.2424,0.36,0.3284,144,647,791,791,3,Sore
14150,2012-08-17,1,8,18,0,5,1,2,0.82,0.2424,0.38,0.2537,108,561,669,669,3,Sore
14151,2012-08-17,1,8,19,0,5,1,2,0.74,0.2424,0.55,0.3881,88,403,491,491,3,Malam
14152,2012-08-17,1,8,20,0,5,1,2,0.72,0.2424,0.58,0.2239,97,262,359,359,3,Malam
14153,2012-08-17,1,8,21,0,5,1,2,0.68,0.2424,0.69,0.2985,57,198,255,255,3,Malam
14154,2012-08-17,1,8,22,0,5,1,3,0.66,0.2424,0.83,0.194,43,170,213,213,3,Malam
14155,2012-08-17,1,8,23,0,5,1,3,0.64,0.2424,0.83,0.2239,21,100,121,121,3,Malam
14156,2012-08-18,1,8,0,0,6,0,2,0.64,0.5758,0.83,0.2239,6,99,105,105,3,
14157,2012-08-18,1,8,1,0,6,0,3,0.62,0.5455,0.94,0.1642,14,78,92,92,3,Pagi
14158,2012-08-18,1,8,2,0,6,0,3,0.62,0.5606,0.88,0.1642,4,39,43,43,3,Pagi
14159,2012-08-18,1,8,3,0,6,0,1,0.62,0.5606,0.88,0.194,7,23,30,30,3,Pagi
14160,2012-08-18,1,8,4,0,6,0,1,0.62,0.5909,0.73,0.2239,5,8,13,13,3,Pagi
14161,2012-08-18,1,8,5,0,6,0,1,0.6,0.5758,0.78,0.2537,2,7,9,9,3,Pagi
14162,2012-08-18,1,8,6,0,6,0,1,0.6,0.5606,0.83,0.2239,4,23,27,27,3,Pagi
14163,2012-08-18,1,8,7,0,6,0,1,0.6,0.5606,0.83,0.2239,12,52,64,64,3,Siang
14164,2012-08-18,1,8,8,0,6,0,1,0.64,0.6061,0.69,0.2537,28,161,189,189,3,Siang
14165,2012-08-18,1,8,9,0,6,0,1,0.66,0.6212,0.65,0.2836,81,211,292,292,3,Siang
14166,2012-08-18,1,8,10,0,6,0,1,0.7,0.6515,0.54,0.1642,166,314,480,480,3,Siang
14167,2012-08-18,1,8,11,0,6,0,1,0.72,0.6667,0.51,0.0,180,356,536,536,3,Siang
14168,2012-08-18,1,8,12,0,6,0,1,0.76,0.6667,0.37,0.194,266,388,654,654,3,Siang
14169,2012-08-18,1,8,13,0,6,0,1,0.74,0.6515,0.4,0.194,289,355,644,644,3,Sore
14170,2012-08-18,1,8,14,0,6,0,1,0.76,0.6667,0.37,0.2836,242,356,598,598,3,Sore
14171,2012-08-18,1,8,15,0,6,0,1,0.76,0.6667,0.37,0.2239,250,346,596,596,3,Sore
14172,2012-08-18,1,8,16,0,6,0,1,0.76,0.6667,0.37,0.2537,287,354,641,641,3,Sore
14173,2012-08-18,1,8,17,0,6,0,1,0.76,0.6667,0.37,0.2239,256,379,635,635,3,Sore
14174,2012-08-18,1,8,18,0,6,0,1,0.74,0.6515,0.37,0.1642,225,329,554,554,3,Sore
14175,2012-08-18,1,8,19,0,6,0,1,0.7,0.6364,0.45,0.1642,164,324,488,488,3,Malam
14176,2012-08-18,1,8,20,0,6,0,1,0.7,0.6364,0.45,0.1045,99,242,341,341,3,Malam
14177,2012-08-18,1,8,21,0,6,0,1,0.66,0.6212,0.61,0.0,90,248,338,338,3,Malam
14178,2012-08-18,1,8,22,0,6,0,1,0.66,0.6212,0.61,0.0,90,171,261,261,3,Malam
14179,2012-08-18,1,8,23,0,6,0,1,0.64,0.6061,0.65,0.0896,60,175,235,235,3,Malam
14180,2012-08-19,1,8,0,0,0,0,1,0.66,0.6212,0.57,0.0896,44,143,187,187,3,
14181,2012-08-19,1,8,1,0,0,0,1,0.64,0.6061,0.65,0.0,29,102,131,131,3,Pagi
14182,2012-08-19,1,8,2,0,0,0,2,0.62,0.6061,0.69,0.0896,16,103,119,119,3,Pagi
14183,2012-08-19,1,8,3,0,0,0,2,0.62,0.6061,0.61,0.1642,21,34,55,55,3,Pagi
14184,2012-08-19,1,8,4,0,0,0,2,0.62,0.6061,0.65,0.1642,4,22,26,26,3,Pagi
14185,2012-08-19,1,8,5,0,0,0,2,0.6,0.5909,0.73,0.1343,3,8,11,11,3,Pagi
14186,2012-08-19,1,8,6,0,0,0,2,0.62,0.6061,0.69,0.1045,5,15,20,20,3,Pagi
14187,2012-08-19,1,8,7,0,0,0,2,0.62,0.6061,0.69,0.1343,12,29,41,41,3,Siang
14188,2012-08-19,1,8,8,0,0,0,2,0.64,0.6061,0.69,0.1045,34,90,124,124,3,Siang
14189,2012-08-19,1,8,9,0,0,0,2,0.66,0.6212,0.74,0.0,86,184,270,270,3,Siang
14190,2012-08-19,1,8,10,0,0,0,2,0.68,0.6364,0.69,0.0,138,287,425,425,3,Siang
14191,2012-08-19,1,8,11,0,0,0,3,0.64,0.5909,0.78,0.1642,83,189,272,272,3,Siang
14192,2012-08-19,1,8,12,0,0,0,3,0.64,0.6061,0.73,0.0,112,186,298,298,3,Siang
14193,2012-08-19,1,8,13,0,0,0,3,0.64,0.5758,0.83,0.1343,50,112,162,162,3,Sore
14194,2012-08-19,1,8,14,0,0,0,3,0.64,0.6061,0.73,0.0,41,108,149,149,3,Sore
14195,2012-08-19,1,8,15,0,0,0,2,0.64,0.6061,0.65,0.0,89,187,276,276,3,Sore
14196,2012-08-19,1,8,16,0,0,0,2,0.66,0.6212,0.65,0.0,97,259,356,356,3,Sore
14197,2012-08-19,1,8,17,0,0,0,2,0.64,0.5909,0.78,0.1045,76,267,343,343,3,Sore
14198,2012-08-19,1,8,18,0,0,0,2,0.64,0.5909,0.78,0.1045,86,291,377,377,3,Sore
14199,2012-08-19,1,8,19,0,0,0,2,0.64,0.6061,0.73,0.1343,72,269,341,341,3,Malam
14200,2012-08-19,1,8,20,0,0,0,2,0.64,0.6061,0.73,0.194,61,213,274,274,3,Malam
14201,2012-08-19,1,8,21,0,0,0,3,0.62,0.5909,0.78,0.0896,36,154,190,190,3,Malam
14202,2012-08-19,1,8,22,0,0,0,2,0.62,0.5909,0.78,0.1642,6,50,56,56,3,Malam
14203,2012-08-19,1,8,23,0,0,0,2,0.62,0.5909,0.73,0.0,7,39,46,46,3,Malam
14204,2012-08-20,1,8,0,0,1,1,2,0.6,0.5606,0.83,0.1045,1,25,26,26,3,
14205,2012-08-20,1,8,1,0,1,1,1,0.6,0.5606,0.83,0.1642,0,10,10,10,3,Pagi
14206,2012-08-20,1,8,2,0,1,1,1,0.6,0.5606,0.83,0.1642,0,5,5,5,3,Pagi
14207,2012-08-20,1,8,3,0,1,1,1,0.6,0.5455,0.88,0.1045,0,3,3,3,3,Pagi
14208,2012-08-20,1,8,4,0,1,1,2,0.6,0.5606,0.83,0.0896,0,7,7,7,3,Pagi
14209,2012-08-20,1,8,5,0,1,1,2,0.6,0.5606,0.83,0.0,2,35,37,37,3,Pagi
14210,2012-08-20,1,8,6,0,1,1,2,0.6,0.5758,0.78,0.1343,6,155,161,161,3,Pagi
14211,2012-08-20,1,8,7,0,1,1,2,0.62,0.5909,0.78,0.1343,15,427,442,442,3,Siang
14212,2012-08-20,1,8,8,0,1,1,2,0.62,0.5909,0.73,0.1045,37,618,655,655,3,Siang
14213,2012-08-20,1,8,9,0,1,1,2,0.64,0.6061,0.69,0.0,55,302,357,357,3,Siang
14214,2012-08-20,1,8,10,0,1,1,2,0.64,0.6061,0.69,0.0896,69,124,193,193,3,Siang
14215,2012-08-20,1,8,11,0,1,1,1,0.66,0.6212,0.65,0.1045,90,151,241,241,3,Siang
14216,2012-08-20,1,8,12,0,1,1,2,0.66,0.6212,0.61,0.1045,66,216,282,282,3,Siang
14217,2012-08-20,1,8,13,0,1,1,1,0.7,0.6515,0.58,0.1343,97,194,291,291,3,Sore
14218,2012-08-20,1,8,14,0,1,1,1,0.72,0.6667,0.54,0.1642,87,188,275,275,3,Sore
14219,2012-08-20,1,8,15,0,1,1,1,0.72,0.6667,0.54,0.2537,102,207,309,309,3,Sore
14220,2012-08-20,1,8,16,0,1,1,1,0.72,0.6667,0.54,0.2537,103,357,460,460,3,Sore
14221,2012-08-20,1,8,17,0,1,1,1,0.7,0.6515,0.58,0.2836,83,810,893,893,3,Sore
14222,2012-08-20,1,8,18,0,1,1,2,0.62,0.5909,0.78,0.2537,89,726,815,815,3,Sore
14223,2012-08-20,1,8,19,0,1,1,2,0.62,0.5909,0.78,0.194,33,266,299,299,3,Malam
14224,2012-08-20,1,8,20,0,1,1,2,0.62,0.5758,0.83,0.2836,30,231,261,261,3,Malam
14225,2012-08-20,1,8,21,0,1,1,1,0.6,0.5606,0.83,0.0,26,219,245,245,3,Malam
14226,2012-08-20,1,8,22,0,1,1,2,0.6,0.5606,0.83,0.0,25,136,161,161,3,Malam
14227,2012-08-20,1,8,23,0,1,1,2,0.6,0.5606,0.83,0.0,10,92,102,102,3,Malam
14228,2012-08-21,1,8,0,0,2,1,2,0.6,0.5606,0.83,0.0896,7,52,59,59,3,
14229,2012-08-21,1,8,1,0,2,1,2,0.6,0.5606,0.83,0.1343,11,22,33,33,3,Pagi
14230,2012-08-21,1,8,2,0,2,1,2,0.58,0.5455,0.88,0.2836,1,7,8,8,3,Pagi
14231,2012-08-21,1,8,3,0,2,1,1,0.56,0.5303,0.88,0.0,0,3,3,3,3,Pagi
14232,2012-08-21,1,8,4,0,2,1,1,0.56,0.5303,0.88,0.0,0,4,4,4,3,Pagi
14233,2012-08-21,1,8,5,0,2,1,1,0.56,0.5303,0.83,0.0896,4,30,34,34,3,Pagi
14234,2012-08-21,1,8,6,0,2,1,1,0.56,0.5303,0.83,0.1045,5,164,169,169,3,Pagi
14235,2012-08-21,1,8,7,0,2,1,1,0.6,0.5758,0.78,0.1045,19,500,519,519,3,Siang
14236,2012-08-21,1,8,8,0,2,1,1,0.6,0.5758,0.78,0.1343,27,696,723,723,3,Siang
14237,2012-08-21,1,8,9,0,2,1,1,0.64,0.6061,0.69,0.0,47,281,328,328,3,Siang
14238,2012-08-21,1,8,10,0,2,1,1,0.66,0.6212,0.61,0.1045,58,120,178,178,3,Siang
14239,2012-08-21,1,8,11,0,2,1,1,0.7,0.6515,0.54,0.0,61,195,256,256,3,Siang
14240,2012-08-21,1,8,12,0,2,1,1,0.72,0.6515,0.45,0.0,79,226,305,305,3,Siang
14241,2012-08-21,1,8,13,0,2,1,1,0.74,0.6515,0.4,0.0,76,255,331,331,3,Sore
14242,2012-08-21,1,8,14,0,2,1,1,0.76,0.6667,0.37,0.0896,110,192,302,302,3,Sore
14243,2012-08-21,1,8,15,0,2,1,1,0.76,0.6667,0.37,0.0,76,226,302,302,3,Sore
14244,2012-08-21,1,8,16,0,2,1,1,0.76,0.6667,0.37,0.0,109,358,467,467,3,Sore
14245,2012-08-21,1,8,17,0,2,1,1,0.74,0.6667,0.51,0.2836,92,786,878,878,3,Sore
14246,2012-08-21,1,8,18,0,2,1,1,0.72,0.6667,0.54,0.2239,93,532,625,625,3,Sore
14247,2012-08-21,1,8,19,0,2,1,3,0.62,0.5909,0.73,0.1045,56,420,476,476,3,Malam
14248,2012-08-21,1,8,20,0,2,1,1,0.64,0.6061,0.73,0.0,62,296,358,358,3,Malam
14249,2012-08-21,1,8,21,0,2,1,1,0.64,0.6061,0.73,0.0,41,239,280,280,3,Malam
14250,2012-08-21,1,8,22,0,2,1,1,0.64,0.5909,0.78,0.0,24,208,232,232,3,Malam
14251,2012-08-21,1,8,23,0,2,1,1,0.62,0.5758,0.83,0.0,23,113,136,136,3,Malam
14252,2012-08-22,1,8,0,0,3,1,1,0.62,0.5758,0.83,0.1045,9,46,55,55,3,
14253,2012-08-22,1,8,1,0,3,1,1,0.62,0.5909,0.78,0.0,1,20,21,21,3,Pagi
14254,2012-08-22,1,8,2,0,3,1,1,0.62,0.5909,0.78,0.0,7,10,17,17,3,Pagi
14255,2012-08-22,1,8,3,0,3,1,1,0.62,0.5909,0.78,0.0,0,7,7,7,3,Pagi
14256,2012-08-22,1,8,4,0,3,1,1,0.58,0.5455,0.83,0.1045,1,7,8,8,3,Pagi
14257,2012-08-22,1,8,5,0,3,1,1,0.6,0.5758,0.78,0.0,2,38,40,40,3,Pagi
14258,2012-08-22,1,8,6,0,3,1,1,0.62,0.5909,0.73,0.0,12,175,187,187,3,Pagi
14259,2012-08-22,1,8,7,0,3,1,1,0.62,0.5909,0.78,0.0,16,537,553,553,3,Siang
14260,2012-08-22,1,8,8,0,3,1,1,0.64,0.6061,0.73,0.0896,37,703,740,740,3,Siang
14261,2012-08-22,1,8,9,0,3,1,1,0.68,0.6364,0.65,0.0,41,335,376,376,3,Siang
14262,2012-08-22,1,8,10,0,3,1,1,0.7,0.6515,0.61,0.0896,66,159,225,225,3,Siang
14263,2012-08-22,1,8,11,0,3,1,1,0.72,0.6667,0.58,0.0896,71,196,267,267,3,Siang
14264,2012-08-22,1,8,12,0,3,1,1,0.74,0.6667,0.51,0.0,59,253,312,312,3,Siang
14265,2012-08-22,1,8,13,0,3,1,1,0.76,0.6818,0.48,0.1045,74,242,316,316,3,Sore
14266,2012-08-22,1,8,14,0,3,1,1,0.76,0.6818,0.45,0.1045,82,184,266,266,3,Sore
14267,2012-08-22,1,8,15,0,3,1,1,0.76,0.6818,0.48,0.1343,94,222,316,316,3,Sore
14268,2012-08-22,1,8,16,0,3,1,3,0.74,0.6818,0.55,0.2239,102,358,460,460,3,Sore
14269,2012-08-22,1,8,17,0,3,1,3,0.74,0.6818,0.55,0.2239,72,711,783,783,3,Sore
14270,2012-08-22,1,8,18,0,3,1,3,0.66,0.6212,0.61,0.2239,91,592,683,683,3,Sore
14271,2012-08-22,1,8,19,0,3,1,2,0.66,0.6212,0.74,0.0,56,524,580,580,3,Malam
14272,2012-08-22,1,8,20,0,3,1,1,0.64,0.6061,0.73,0.194,59,332,391,391,3,Malam
14273,2012-08-22,1,8,21,0,3,1,1,0.64,0.6061,0.73,0.0,60,291,351,351,3,Malam
14274,2012-08-22,1,8,22,0,3,1,1,0.64,0.6061,0.73,0.0,55,226,281,281,3,Malam
14275,2012-08-22,1,8,23,0,3,1,1,0.64,0.5758,0.83,0.0,27,113,140,140,3,Malam
14276,2012-08-23,1,8,0,0,4,1,1,0.64,0.5909,0.78,0.0,9,51,60,60,3,
14277,2012-08-23,1,8,1,0,4,1,1,0.62,0.5758,0.83,0.0,10,15,25,25,3,Pagi
14278,2012-08-23,1,8,2,0,4,1,1,0.62,0.5758,0.83,0.0,9,11,20,20,3,Pagi
14279,2012-08-23,1,8,3,0,4,1,1,0.62,0.5758,0.83,0.0896,3,6,9,9,3,Pagi
14280,2012-08-23,1,8,4,0,4,1,1,0.62,0.5758,0.83,0.0,0,6,6,6,3,Pagi
14281,2012-08-23,1,8,5,0,4,1,1,0.62,0.5758,0.83,0.0,1,36,37,37,3,Pagi
14282,2012-08-23,1,8,6,0,4,1,2,0.6,0.5455,0.88,0.0896,14,178,192,192,3,Pagi
14283,2012-08-23,1,8,7,0,4,1,2,0.62,0.5758,0.83,0.0896,18,463,481,481,3,Siang
14284,2012-08-23,1,8,8,0,4,1,2,0.66,0.6212,0.74,0.0896,45,662,707,707,3,Siang
14285,2012-08-23,1,8,9,0,4,1,2,0.7,0.6515,0.7,0.0,58,354,412,412,3,Siang
14286,2012-08-23,1,8,10,0,4,1,1,0.74,0.6818,0.58,0.0896,76,157,233,233,3,Siang
14287,2012-08-23,1,8,11,0,4,1,1,0.76,0.6818,0.48,0.0896,86,192,278,278,3,Siang
14288,2012-08-23,1,8,12,0,4,1,1,0.78,0.6818,0.38,0.0,97,235,332,332,3,Siang
14289,2012-08-23,1,8,13,0,4,1,1,0.82,0.7273,0.38,0.0896,93,253,346,346,3,Sore
14290,2012-08-23,1,8,14,0,4,1,1,0.78,0.697,0.46,0.2239,114,191,305,305,3,Sore
14291,2012-08-23,1,8,15,0,4,1,1,0.78,0.697,0.46,0.1343,104,201,305,305,3,Sore
14292,2012-08-23,1,8,16,0,4,1,1,0.76,0.6818,0.48,0.1642,121,344,465,465,3,Sore
14293,2012-08-23,1,8,17,0,4,1,1,0.76,0.6818,0.45,0.2239,111,709,820,820,3,Sore
14294,2012-08-23,1,8,18,0,4,1,1,0.74,0.6667,0.48,0.2239,130,811,941,941,3,Sore
14295,2012-08-23,1,8,19,0,4,1,1,0.72,0.6667,0.51,0.0896,96,537,633,633,3,Malam
14296,2012-08-23,1,8,20,0,4,1,1,0.7,0.6515,0.61,0.1045,70,404,474,474,3,Malam
14297,2012-08-23,1,8,21,0,4,1,1,0.7,0.6515,0.61,0.1343,53,276,329,329,3,Malam
14298,2012-08-23,1,8,22,0,4,1,2,0.68,0.6364,0.61,0.1045,21,177,198,198,3,Malam
14299,2012-08-23,1,8,23,0,4,1,2,0.66,0.6212,0.69,0.0,24,133,157,157,3,Malam
14300,2012-08-24,1,8,0,0,5,1,2,0.66,0.6212,0.69,0.0,27,84,111,111,3,
14301,2012-08-24,1,8,1,0,5,1,2,0.64,0.6061,0.73,0.0,5,37,42,42,3,Pagi
14302,2012-08-24,1,8,2,0,5,1,1,0.66,0.6212,0.69,0.0,1,15,16,16,3,Pagi
14303,2012-08-24,1,8,3,0,5,1,1,0.64,0.6061,0.73,0.0,2,6,8,8,3,Pagi
14304,2012-08-24,1,8,4,0,5,1,2,0.64,0.6061,0.73,0.0,2,6,8,8,3,Pagi
14305,2012-08-24,1,8,5,0,5,1,1,0.64,0.5909,0.78,0.0,1,37,38,38,3,Pagi
14306,2012-08-24,1,8,6,0,5,1,2,0.62,0.5758,0.83,0.0,9,142,151,151,3,Pagi
14307,2012-08-24,1,8,7,0,5,1,2,0.64,0.5909,0.78,0.0,13,412,425,425,3,Siang
14308,2012-08-24,1,8,8,0,5,1,2,0.66,0.6212,0.74,0.0,41,703,744,744,3,Siang
14309,2012-08-24,1,8,9,0,5,1,2,0.72,0.6667,0.58,0.0,58,331,389,389,3,Siang
14310,2012-08-24,1,8,10,0,5,1,2,0.76,0.6818,0.48,0.0,78,184,262,262,3,Siang
14311,2012-08-24,1,8,11,0,5,1,2,0.76,0.6818,0.48,0.1045,69,212,281,281,3,Siang
14312,2012-08-24,1,8,12,0,5,1,2,0.76,0.6818,0.45,0.0896,95,276,371,371,3,Siang
14313,2012-08-24,1,8,13,0,5,1,2,0.8,0.7121,0.41,0.1045,79,272,351,351,3,Sore
14314,2012-08-24,1,8,14,0,5,1,1,0.78,0.697,0.43,0.1045,109,229,338,338,3,Sore
14315,2012-08-24,1,8,15,0,5,1,2,0.76,0.6818,0.48,0.1343,99,251,350,350,3,Sore
14316,2012-08-24,1,8,16,0,5,1,2,0.76,0.6818,0.48,0.1343,101,414,515,515,3,Sore
14317,2012-08-24,1,8,17,0,5,1,2,0.74,0.6667,0.51,0.2239,117,695,812,812,3,Sore
14318,2012-08-24,1,8,18,0,5,1,2,0.72,0.6818,0.62,0.194,109,627,736,736,3,Sore
14319,2012-08-24,1,8,19,0,5,1,2,0.72,0.6667,0.58,0.1642,106,430,536,536,3,Malam
14320,2012-08-24,1,8,20,0,5,1,2,0.7,0.6515,0.65,0.2239,66,297,363,363,3,Malam
14321,2012-08-24,1,8,21,0,5,1,2,0.7,0.6515,0.61,0.1642,58,248,306,306,3,Malam
14322,2012-08-24,1,8,22,0,5,1,2,0.7,0.6515,0.61,0.0,42,209,251,251,3,Malam
14323,2012-08-24,1,8,23,0,5,1,2,0.68,0.6364,0.69,0.0896,38,140,178,178,3,Malam
14324,2012-08-25,1,8,0,0,6,0,2,0.7,0.6515,0.61,0.0,21,114,135,135,3,
14325,2012-08-25,1,8,1,0,6,0,2,0.68,0.6364,0.69,0.0,15,100,115,115,3,Pagi
14326,2012-08-25,1,8,2,0,6,0,2,0.66,0.6212,0.74,0.0896,18,61,79,79,3,Pagi
14327,2012-08-25,1,8,3,0,6,0,1,0.66,0.6212,0.69,0.0896,7,31,38,38,3,Pagi
14328,2012-08-25,1,8,4,0,6,0,2,0.66,0.6212,0.69,0.1045,3,9,12,12,3,Pagi
14329,2012-08-25,1,8,5,0,6,0,2,0.64,0.6061,0.73,0.1642,4,10,14,14,3,Pagi
14330,2012-08-25,1,8,6,0,6,0,2,0.64,0.5909,0.78,0.1642,5,25,30,30,3,Pagi
14331,2012-08-25,1,8,7,0,6,0,2,0.64,0.5909,0.78,0.194,14,88,102,102,3,Siang
14332,2012-08-25,1,8,8,0,6,0,2,0.66,0.6212,0.74,0.2537,29,133,162,162,3,Siang
14333,2012-08-25,1,8,9,0,6,0,2,0.68,0.6364,0.69,0.2836,60,228,288,288,3,Siang
14334,2012-08-25,1,8,10,0,6,0,2,0.7,0.6515,0.65,0.2985,148,294,442,442,3,Siang
14335,2012-08-25,1,8,11,0,6,0,2,0.72,0.6818,0.62,0.2836,143,314,457,457,3,Siang
14336,2012-08-25,1,8,12,0,6,0,3,0.72,0.6667,0.54,0.3881,217,367,584,584,3,Siang
14337,2012-08-25,1,8,13,0,6,0,2,0.72,0.6667,0.51,0.3582,186,331,517,517,3,Sore
14338,2012-08-25,1,8,14,0,6,0,3,0.66,0.6212,0.65,0.2537,150,332,482,482,3,Sore
14339,2012-08-25,1,8,15,0,6,0,2,0.64,0.6061,0.73,0.3284,79,154,233,233,3,Sore
14340,2012-08-25,1,8,16,0,6,0,2,0.66,0.6212,0.74,0.2985,174,260,434,434,3,Sore
14341,2012-08-25,1,8,17,0,6,0,2,0.66,0.6212,0.74,0.3284,132,271,403,403,3,Sore
14342,2012-08-25,1,8,18,0,6,0,2,0.66,0.6212,0.69,0.4627,122,261,383,383,3,Sore
14343,2012-08-25,1,8,19,0,6,0,2,0.64,0.5909,0.78,0.2985,97,257,354,354,3,Malam
14344,2012-08-25,1,8,20,0,6,0,3,0.62,0.5758,0.83,0.2537,65,176,241,241,3,Malam
14345,2012-08-25,1,8,21,0,6,0,1,0.62,0.5758,0.83,0.3582,60,148,208,208,3,Malam
14346,2012-08-25,1,8,22,0,6,0,1,0.62,0.5758,0.83,0.3582,46,136,182,182,3,Malam
14347,2012-08-25,1,8,23,0,6,0,2,0.62,0.5758,0.83,0.2537,34,124,158,158,3,Malam
14348,2012-08-26,1,8,0,0,0,0,1,0.64,0.5758,0.89,0.2537,23,111,134,134,3,
14349,2012-08-26,1,8,1,0,0,0,1,0.64,0.5758,0.89,0.194,18,116,134,134,3,Pagi
14350,2012-08-26,1,8,2,0,0,0,2,0.64,0.5758,0.89,0.2239,12,104,116,116,3,Pagi
14351,2012-08-26,1,8,3,0,0,0,2,0.64,0.5758,0.89,0.2537,11,42,53,53,3,Pagi
14352,2012-08-26,1,8,4,0,0,0,2,0.64,0.5758,0.89,0.194,5,11,16,16,3,Pagi
14353,2012-08-26,1,8,5,0,0,0,1,0.64,0.5758,0.89,0.194,3,13,16,16,3,Pagi
14354,2012-08-26,1,8,6,0,0,0,1,0.62,0.5606,0.88,0.2985,5,16,21,21,3,Pagi
14355,2012-08-26,1,8,7,0,0,0,1,0.64,0.5758,0.89,0.194,11,23,34,34,3,Siang
14356,2012-08-26,1,8,8,0,0,0,1,0.68,0.6364,0.79,0.2836,21,112,133,133,3,Siang
14357,2012-08-26,1,8,9,0,0,0,1,0.68,0.6364,0.79,0.2537,67,196,263,263,3,Siang
14358,2012-08-26,1,8,10,0,0,0,1,0.74,0.697,0.66,0.3881,127,258,385,385,3,Siang
14359,2012-08-26,1,8,11,0,0,0,1,0.74,0.697,0.66,0.3582,150,332,482,482,3,Siang
14360,2012-08-26,1,8,12,0,0,0,3,0.72,0.697,0.74,0.3582,225,401,626,626,3,Siang
14361,2012-08-26,1,8,13,0,0,0,3,0.66,0.6061,0.78,0.4179,166,375,541,541,3,Sore
14362,2012-08-26,1,8,14,0,0,0,1,0.64,0.5758,0.89,0.1045,125,252,377,377,3,Sore
14363,2012-08-26,1,8,15,0,0,0,3,0.64,0.5758,0.89,0.2836,132,259,391,391,3,Sore
14364,2012-08-26,1,8,16,0,0,0,3,0.64,0.5758,0.89,0.2836,57,116,173,173,3,Sore
14365,2012-08-26,1,8,17,0,0,0,1,0.64,0.5758,0.89,0.2239,61,172,233,233,3,Sore
14366,2012-08-26,1,8,18,0,0,0,2,0.64,0.5758,0.89,0.0896,77,187,264,264,3,Sore
14367,2012-08-26,1,8,19,0,0,0,2,0.64,0.5758,0.89,0.1642,80,212,292,292,3,Malam
14368,2012-08-26,1,8,20,0,0,0,1,0.64,0.5758,0.89,0.1642,40,171,211,211,3,Malam
14369,2012-08-26,1,8,21,0,0,0,1,0.64,0.5758,0.83,0.1343,26,140,166,166,3,Malam
14370,2012-08-26,1,8,22,0,0,0,1,0.62,0.5606,0.88,0.0896,20,94,114,114,3,Malam
14371,2012-08-26,1,8,23,0,0,0,1,0.62,0.5758,0.83,0.0896,21,59,80,80,3,Malam
14372,2012-08-27,1,8,0,0,1,1,1,0.62,0.5758,0.83,0.0,4,28,32,32,3,
14373,2012-08-27,1,8,1,0,1,1,1,0.62,0.5606,0.88,0.0896,3,4,7,7,3,Pagi
14374,2012-08-27,1,8,2,0,1,1,1,0.62,0.5606,0.88,0.1343,0,8,8,8,3,Pagi
14375,2012-08-27,1,8,3,0,1,1,1,0.62,0.5606,0.88,0.0896,1,3,4,4,3,Pagi
14376,2012-08-27,1,8,4,0,1,1,1,0.62,0.5758,0.83,0.0,1,11,12,12,3,Pagi
14377,2012-08-27,1,8,5,0,1,1,1,0.62,0.5606,0.88,0.0,4,32,36,36,3,Pagi
14378,2012-08-27,1,8,6,0,1,1,1,0.62,0.5606,0.88,0.0,4,141,145,145,3,Pagi
14379,2012-08-27,1,8,7,0,1,1,1,0.66,0.6061,0.83,0.0,15,418,433,433,3,Siang
14380,2012-08-27,1,8,8,0,1,1,1,0.66,0.6061,0.83,0.0896,29,670,699,699,3,Siang
14381,2012-08-27,1,8,9,0,1,1,1,0.66,0.6061,0.83,0.1045,40,302,342,342,3,Siang
14382,2012-08-27,1,8,10,0,1,1,1,0.72,0.697,0.74,0.1343,63,143,206,206,3,Siang
14383,2012-08-27,1,8,11,0,1,1,1,0.74,0.697,0.66,0.194,47,182,229,229,3,Siang
14384,2012-08-27,1,8,12,0,1,1,1,0.76,0.7121,0.62,0.0,69,214,283,283,3,Siang
14385,2012-08-27,1,8,13,0,1,1,1,0.76,0.7121,0.57,0.1642,77,211,288,288,3,Sore
14386,2012-08-27,1,8,14,0,1,1,1,0.8,0.7424,0.49,0.0896,66,180,246,246,3,Sore
14387,2012-08-27,1,8,15,0,1,1,1,0.8,0.7576,0.55,0.2985,77,205,282,282,3,Sore
14388,2012-08-27,1,8,16,0,1,1,1,0.8,0.7576,0.55,0.2537,77,367,444,444,3,Sore
14389,2012-08-27,1,8,17,0,1,1,1,0.8,0.7273,0.46,0.2239,101,744,845,845,3,Sore
14390,2012-08-27,1,8,18,0,1,1,1,0.78,0.7121,0.52,0.2537,83,751,834,834,3,Sore
14391,2012-08-27,1,8,19,0,1,1,1,0.74,0.697,0.7,0.2239,74,499,573,573,3,Malam
14392,2012-08-27,1,8,20,0,1,1,1,0.74,0.697,0.7,0.194,50,366,416,416,3,Malam
14393,2012-08-27,1,8,21,0,1,1,1,0.72,0.697,0.74,0.194,39,239,278,278,3,Malam
14394,2012-08-27,1,8,22,0,1,1,1,0.7,0.6667,0.84,0.194,30,131,161,161,3,Malam
14395,2012-08-27,1,8,23,0,1,1,1,0.7,0.6667,0.84,0.1642,35,79,114,114,3,Malam
14396,2012-08-28,1,8,0,0,2,1,1,0.7,0.6667,0.84,0.2537,9,29,38,38,3,
14397,2012-08-28,1,8,1,0,2,1,1,0.68,0.6364,0.89,0.194,4,17,21,21,3,Pagi
14398,2012-08-28,1,8,2,0,2,1,1,0.68,0.6364,0.83,0.2537,2,13,15,15,3,Pagi
14399,2012-08-28,1,8,3,0,2,1,1,0.66,0.5909,0.89,0.1343,0,4,4,4,3,Pagi
14400,2012-08-28,1,8,4,0,2,1,1,0.66,0.6061,0.83,0.1343,2,6,8,8,3,Pagi
14401,2012-08-28,1,8,5,0,2,1,2,0.66,0.6061,0.83,0.0896,3,39,42,42,3,Pagi
14402,2012-08-28,1,8,6,0,2,1,2,0.66,0.5909,0.89,0.1045,3,144,147,147,3,Pagi
14403,2012-08-28,1,8,7,0,2,1,2,0.66,0.6061,0.83,0.1045,14,255,269,269,3,Siang
14404,2012-08-28,1,8,8,0,2,1,2,0.66,0.6212,0.85,0.1045,25,668,693,693,3,Siang
14405,2012-08-28,1,8,9,0,2,1,2,0.7,0.6667,0.79,0.1642,44,351,395,395,3,Siang
14406,2012-08-28,1,8,10,0,2,1,1,0.74,0.6818,0.62,0.2537,39,165,204,204,3,Siang
14407,2012-08-28,1,8,11,0,2,1,1,0.78,0.7273,0.55,0.2537,47,171,218,218,3,Siang
14408,2012-08-28,1,8,12,0,2,1,1,0.8,0.7424,0.49,0.2836,56,241,297,297,3,Siang
14409,2012-08-28,1,8,13,0,2,1,1,0.82,0.7424,0.43,0.2985,56,232,288,288,3,Sore
14410,2012-08-28,1,8,14,0,2,1,1,0.84,0.7424,0.38,0.3284,72,179,251,251,3,Sore
14411,2012-08-28,1,8,15,0,2,1,1,0.82,0.7273,0.34,0.2985,59,258,317,317,3,Sore
14412,2012-08-28,1,8,16,0,2,1,1,0.82,0.7121,0.33,0.3284,84,396,480,480,3,Sore
14413,2012-08-28,1,8,17,0,2,1,1,0.8,0.697,0.35,0.3881,90,774,864,864,3,Sore
14414,2012-08-28,1,8,18,0,2,1,1,0.78,0.697,0.4,0.2537,82,736,818,818,3,Sore
14415,2012-08-28,1,8,19,0,2,1,1,0.74,0.6667,0.45,0.1642,82,515,597,597,3,Malam
14416,2012-08-28,1,8,20,0,2,1,1,0.72,0.6667,0.48,0.1045,87,348,435,435,3,Malam
14417,2012-08-28,1,8,21,0,2,1,1,0.72,0.6667,0.48,0.0896,38,276,314,314,3,Malam
14418,2012-08-28,1,8,22,0,2,1,1,0.7,0.6515,0.54,0.0,20,196,216,216,3,Malam
14419,2012-08-28,1,8,23,0,2,1,1,0.68,0.6364,0.57,0.0,17,92,109,109,3,Malam
14420,2012-08-29,1,8,0,0,3,1,1,0.66,0.6212,0.69,0.0,8,39,47,47,3,
14421,2012-08-29,1,8,1,0,3,1,1,0.64,0.6061,0.69,0.1343,2,12,14,14,3,Pagi
14422,2012-08-29,1,8,2,0,3,1,1,0.62,0.5909,0.73,0.1343,2,4,6,6,3,Pagi
14423,2012-08-29,1,8,3,0,3,1,1,0.62,0.5909,0.73,0.1045,0,9,9,9,3,Pagi
14424,2012-08-29,1,8,4,0,3,1,1,0.6,0.5909,0.73,0.2239,2,8,10,10,3,Pagi
14425,2012-08-29,1,8,5,0,3,1,1,0.6,0.5909,0.73,0.194,3,37,40,40,3,Pagi
14426,2012-08-29,1,8,6,0,3,1,1,0.6,0.5909,0.73,0.194,6,175,181,181,3,Pagi
14427,2012-08-29,1,8,7,0,3,1,1,0.64,0.6061,0.65,0.0896,23,531,554,554,3,Siang
14428,2012-08-29,1,8,8,0,3,1,1,0.66,0.6212,0.61,0.1642,28,780,808,808,3,Siang
14429,2012-08-29,1,8,9,0,3,1,1,0.7,0.6515,0.51,0.194,40,308,348,348,3,Siang
14430,2012-08-29,1,8,10,0,3,1,1,0.72,0.6667,0.48,0.1642,34,144,178,178,3,Siang
14431,2012-08-29,1,8,11,0,3,1,1,0.72,0.6515,0.45,0.0,67,186,253,253,3,Siang
14432,2012-08-29,1,8,12,0,3,1,1,0.76,0.6818,0.4,0.0,79,281,360,360,3,Siang
14433,2012-08-29,1,8,13,0,3,1,1,0.74,0.6667,0.42,0.0,68,232,300,300,3,Sore
14434,2012-08-29,1,8,14,0,3,1,1,0.76,0.6818,0.4,0.0896,87,214,301,301,3,Sore
14435,2012-08-29,1,8,15,0,3,1,1,0.76,0.6818,0.4,0.194,96,242,338,338,3,Sore
14436,2012-08-29,1,8,16,0,3,1,1,0.76,0.6667,0.37,0.1343,104,389,493,493,3,Sore
14437,2012-08-29,1,8,17,0,3,1,1,0.78,0.6818,0.35,0.2239,108,762,870,870,3,Sore
14438,2012-08-29,1,8,18,0,3,1,1,0.74,0.6667,0.42,0.1642,119,693,812,812,3,Sore
14439,2012-08-29,1,8,19,0,3,1,1,0.7,0.6515,0.54,0.194,120,523,643,643,3,Malam
14440,2012-08-29,1,8,20,0,3,1,1,0.68,0.6364,0.57,0.0,49,378,427,427,3,Malam
14441,2012-08-29,1,8,21,0,3,1,1,0.66,0.6212,0.54,0.1045,48,265,313,313,3,Malam
14442,2012-08-29,1,8,22,0,3,1,1,0.66,0.6212,0.54,0.0,50,185,235,235,3,Malam
14443,2012-08-29,1,8,23,0,3,1,1,0.66,0.6212,0.57,0.0,34,123,157,157,3,Malam
14444,2012-08-30,1,8,0,0,4,1,1,0.64,0.6061,0.69,0.0,14,51,65,65,3,
14445,2012-08-30,1,8,1,0,4,1,1,0.64,0.6061,0.65,0.0,6,17,23,23,3,Pagi
14446,2012-08-30,1,8,2,0,4,1,1,0.62,0.5909,0.73,0.0,3,14,17,17,3,Pagi
14447,2012-08-30,1,8,3,0,4,1,1,0.62,0.5909,0.73,0.0,0,5,5,5,3,Pagi
14448,2012-08-30,1,8,4,0,4,1,1,0.62,0.5909,0.73,0.0,4,4,8,8,3,Pagi
14449,2012-08-30,1,8,5,0,4,1,1,0.62,0.5909,0.73,0.0,2,33,35,35,3,Pagi
14450,2012-08-30,1,8,6,0,4,1,1,0.6,0.5606,0.83,0.1642,8,155,163,163,3,Pagi
14451,2012-08-30,1,8,7,0,4,1,1,0.64,0.6061,0.73,0.0,31,501,532,532,3,Siang
14452,2012-08-30,1,8,8,0,4,1,1,0.66,0.6212,0.65,0.0,53,701,754,754,3,Siang
14453,2012-08-30,1,8,9,0,4,1,1,0.7,0.6515,0.58,0.0,57,339,396,396,3,Siang
14454,2012-08-30,1,8,10,0,4,1,1,0.72,0.6667,0.54,0.0,73,161,234,234,3,Siang
14455,2012-08-30,1,8,11,0,4,1,1,0.76,0.6818,0.4,0.0896,85,191,276,276,3,Siang
14456,2012-08-30,1,8,12,0,4,1,1,0.76,0.6818,0.45,0.1343,73,221,294,294,3,Siang
14457,2012-08-30,1,8,13,0,4,1,1,0.76,0.6818,0.48,0.1045,76,214,290,290,3,Sore
14458,2012-08-30,1,8,14,0,4,1,1,0.76,0.6818,0.48,0.1343,74,199,273,273,3,Sore
14459,2012-08-30,1,8,15,0,4,1,1,0.8,0.7273,0.46,0.1642,99,239,338,338,3,Sore
14460,2012-08-30,1,8,16,0,4,1,1,0.8,0.7273,0.43,0.1642,77,405,482,482,3,Sore
14461,2012-08-30,1,8,17,0,4,1,1,0.82,0.7273,0.34,0.2239,93,751,844,844,3,Sore
14462,2012-08-30,1,8,18,0,4,1,1,0.8,0.7121,0.38,0.1343,109,744,853,853,3,Sore
14463,2012-08-30,1,8,19,0,4,1,1,0.76,0.6818,0.48,0.1343,78,532,610,610,3,Malam
14464,2012-08-30,1,8,20,0,4,1,1,0.74,0.6818,0.58,0.1642,68,403,471,471,3,Malam
14465,2012-08-30,1,8,21,0,4,1,1,0.72,0.6818,0.66,0.1343,32,275,307,307,3,Malam
14466,2012-08-30,1,8,22,0,4,1,1,0.7,0.6515,0.7,0.0,38,253,291,291,3,Malam
14467,2012-08-30,1,8,23,0,4,1,1,0.7,0.6667,0.74,0.1045,19,133,152,152,3,Malam
14468,2012-08-31,1,8,0,0,5,1,1,0.68,0.6364,0.83,0.1642,13,69,82,82,3,
14469,2012-08-31,1,8,1,0,5,1,1,0.68,0.6364,0.83,0.1642,8,24,32,32,3,Pagi
14470,2012-08-31,1,8,2,0,5,1,1,0.66,0.5909,0.89,0.1343,9,11,20,20,3,Pagi
14471,2012-08-31,1,8,3,0,5,1,1,0.66,0.5909,0.89,0.1045,3,2,5,5,3,Pagi
14472,2012-08-31,1,8,4,0,5,1,1,0.64,0.5758,0.89,0.1343,0,7,7,7,3,Pagi
14473,2012-08-31,1,8,5,0,5,1,1,0.64,0.5758,0.89,0.1642,2,27,29,29,3,Pagi
14474,2012-08-31,1,8,6,0,5,1,2,0.64,0.5758,0.89,0.1642,7,101,108,108,3,Pagi
14475,2012-08-31,1,8,7,0,5,1,2,0.64,0.5758,0.89,0.0896,21,400,421,421,3,Siang
14476,2012-08-31,1,8,8,0,5,1,2,0.7,0.6667,0.74,0.0,36,654,690,690,3,Siang
14477,2012-08-31,1,8,9,0,5,1,1,0.74,0.697,0.7,0.0,61,337,398,398,3,Siang
14478,2012-08-31,1,8,10,0,5,1,1,0.76,0.7121,0.62,0.0896,59,197,256,256,3,Siang
14479,2012-08-31,1,8,11,0,5,1,1,0.86,0.7424,0.28,0.2985,88,221,309,309,3,Siang
14480,2012-08-31,1,8,12,0,5,1,1,0.86,0.7424,0.26,0.2537,120,290,410,410,3,Siang
14481,2012-08-31,1,8,13,0,5,1,1,0.88,0.7576,0.27,0.3284,97,271,368,368,3,Sore
14482,2012-08-31,1,8,14,0,5,1,1,0.9,0.7727,0.25,0.2239,112,324,436,436,3,Sore
14483,2012-08-31,1,8,15,0,5,1,1,0.9,0.7879,0.27,0.2985,109,417,526,526,3,Sore
14484,2012-08-31,1,8,16,0,5,1,1,0.9,0.7879,0.27,0.2537,111,417,528,528,3,Sore
14485,2012-08-31,1,8,17,0,5,1,1,0.88,0.7727,0.32,0.1642,129,488,617,617,3,Sore
14486,2012-08-31,1,8,18,0,5,1,1,0.86,0.7576,0.36,0.2537,87,459,546,546,3,Sore
14487,2012-08-31,1,8,19,0,5,1,1,0.8,0.7424,0.49,0.1343,91,361,452,452,3,Malam
14488,2012-08-31,1,8,20,0,5,1,1,0.8,0.7424,0.49,0.1343,102,254,356,356,3,Malam
14489,2012-08-31,1,8,21,0,5,1,1,0.76,0.7121,0.58,0.194,71,232,303,303,3,Malam
14490,2012-08-31,1,8,22,0,5,1,1,0.76,0.7121,0.58,0.194,65,212,277,277,3,Malam
14491,2012-08-31,1,8,23,0,5,1,1,0.74,0.6818,0.62,0.1045,32,142,174,174,3,Malam
14492,2012-09-01,1,9,0,0,6,0,1,0.74,0.6818,0.62,0.1045,22,146,168,168,3,
14493,2012-09-01,1,9,1,0,6,0,1,0.72,0.697,0.74,0.1343,11,68,79,79,3,Pagi
14494,2012-09-01,1,9,2,0,6,0,1,0.7,0.6515,0.7,0.1642,8,61,69,69,3,Pagi
14495,2012-09-01,1,9,3,0,6,0,1,0.7,0.6515,0.7,0.1045,6,29,35,35,3,Pagi
14496,2012-09-01,1,9,4,0,6,0,1,0.7,0.6515,0.7,0.0,3,9,12,12,3,Pagi
14497,2012-09-01,1,9,5,0,6,0,1,0.68,0.6364,0.79,0.0,2,20,22,22,3,Pagi
14498,2012-09-01,1,9,6,0,6,0,1,0.68,0.6364,0.79,0.0,13,23,36,36,3,Pagi
14499,2012-09-01,1,9,7,0,6,0,2,0.74,0.6818,0.58,0.1343,8,58,66,66,3,Siang
14500,2012-09-01,1,9,8,0,6,0,2,0.76,0.7121,0.58,0.2537,28,134,162,162,3,Siang
14501,2012-09-01,1,9,9,0,6,0,2,0.76,0.7121,0.58,0.194,62,175,237,237,3,Siang
14502,2012-09-01,1,9,10,0,6,0,2,0.78,0.7273,0.55,0.194,128,289,417,417,3,Siang
14503,2012-09-01,1,9,11,0,6,0,2,0.8,0.7576,0.55,0.2239,219,273,492,492,3,Siang
14504,2012-09-01,1,9,12,0,6,0,2,0.8,0.7576,0.55,0.1642,187,284,471,471,3,Siang
14505,2012-09-01,1,9,13,0,6,0,2,0.82,0.7727,0.52,0.0896,237,267,504,504,3,Sore
14506,2012-09-01,1,9,14,0,6,0,2,0.86,0.7879,0.44,0.1642,240,274,514,514,3,Sore
14507,2012-09-01,1,9,15,0,6,0,2,0.86,0.7879,0.44,0.2836,257,306,563,563,3,Sore
14508,2012-09-01,1,9,16,0,6,0,2,0.84,0.7879,0.49,0.1642,209,253,462,462,3,Sore
14509,2012-09-01,1,9,17,0,6,0,2,0.82,0.7727,0.52,0.0,205,258,463,463,3,Sore
14510,2012-09-01,1,9,18,0,6,0,2,0.82,0.7727,0.52,0.0,184,258,442,442,3,Sore
14511,2012-09-01,1,9,19,0,6,0,3,0.78,0.7424,0.62,0.0,157,235,392,392,3,Malam
14512,2012-09-01,1,9,20,0,6,0,3,0.76,0.7273,0.67,0.2537,67,140,207,207,3,Malam
14513,2012-09-01,1,9,21,0,6,0,3,0.64,0.5758,0.89,0.0,21,83,104,104,3,Malam
14514,2012-09-01,1,9,22,0,6,0,2,0.66,0.5909,0.89,0.0,21,57,78,78,3,Malam
14515,2012-09-01,1,9,23,0,6,0,1,0.66,0.5909,0.89,0.0896,57,88,145,145,3,Malam
14516,2012-09-02,1,9,0,0,0,0,2,0.66,0.5909,0.89,0.0896,27,72,99,99,3,
14517,2012-09-02,1,9,1,0,0,0,1,0.66,0.5909,0.89,0.0,15,58,73,73,3,Pagi
14518,2012-09-02,1,9,2,0,0,0,1,0.66,0.5909,0.89,0.0,28,56,84,84,3,Pagi
14519,2012-09-02,1,9,3,0,0,0,1,0.66,0.5909,0.89,0.0896,9,33,42,42,3,Pagi
14520,2012-09-02,1,9,4,0,0,0,1,0.66,0.5909,0.89,0.0,7,15,22,22,3,Pagi
14521,2012-09-02,1,9,5,0,0,0,1,0.66,0.5909,0.89,0.0,2,10,12,12,3,Pagi
14522,2012-09-02,1,9,6,0,0,0,2,0.66,0.5909,0.89,0.0,2,13,15,15,3,Pagi
14523,2012-09-02,1,9,7,0,0,0,1,0.66,0.5909,0.94,0.0896,13,29,42,42,3,Siang
14524,2012-09-02,1,9,8,0,0,0,1,0.68,0.6364,0.89,0.0896,30,99,129,129,3,Siang
14525,2012-09-02,1,9,9,0,0,0,2,0.7,0.6667,0.84,0.0,88,144,232,232,3,Siang
14526,2012-09-02,1,9,10,0,0,0,2,0.72,0.697,0.79,0.0,158,230,388,388,3,Siang
14527,2012-09-02,1,9,11,0,0,0,2,0.74,0.697,0.7,0.0,226,263,489,489,3,Siang
14528,2012-09-02,1,9,12,0,0,0,3,0.74,0.697,0.7,0.0,248,297,545,545,3,Siang
14529,2012-09-02,1,9,13,0,0,0,3,0.72,0.697,0.74,0.0896,263,230,493,493,3,Sore
14530,2012-09-02,1,9,14,0,0,0,3,0.72,0.697,0.79,0.0896,249,208,457,457,3,Sore
14531,2012-09-02,1,9,15,0,0,0,3,0.74,0.7121,0.74,0.1343,179,176,355,355,3,Sore
14532,2012-09-02,1,9,16,0,0,0,1,0.74,0.697,0.7,0.0,222,252,474,474,3,Sore
14533,2012-09-02,1,9,17,0,0,0,1,0.76,0.7273,0.66,0.0896,219,284,503,503,3,Sore
14534,2012-09-02,1,9,18,0,0,0,1,0.74,0.7121,0.74,0.0,227,273,500,500,3,Sore
14535,2012-09-02,1,9,19,0,0,0,2,0.7,0.6667,0.84,0.2239,140,152,292,292,3,Malam
14536,2012-09-02,1,9,20,0,0,0,2,0.7,0.6667,0.84,0.1642,63,41,104,104,3,Malam
14537,2012-09-02,1,9,21,0,0,0,1,0.7,0.6515,0.7,0.1642,79,92,171,171,3,Malam
14538,2012-09-02,1,9,22,0,0,0,3,0.68,0.6364,0.83,0.1343,66,100,166,166,3,Malam
14539,2012-09-02,1,9,23,0,0,0,3,0.66,0.5909,0.89,0.0896,53,70,123,123,3,Malam
14540,2012-09-03,1,9,0,1,1,0,2,0.66,0.5909,0.94,0.0,42,62,104,104,3,
14541,2012-09-03,1,9,1,1,1,0,2,0.68,0.6364,0.89,0.1642,18,37,55,55,3,Pagi
14542,2012-09-03,1,9,2,1,1,0,1,0.66,0.5909,0.89,0.1045,10,30,40,40,3,Pagi
14543,2012-09-03,1,9,3,1,1,0,1,0.66,0.5909,0.89,0.1343,6,22,28,28,3,Pagi
14544,2012-09-03,1,9,4,1,1,0,1,0.66,0.5909,0.89,0.0896,6,5,11,11,3,Pagi
14545,2012-09-03,1,9,5,1,1,0,1,0.66,0.5909,0.89,0.0,1,3,4,4,3,Pagi
14546,2012-09-03,1,9,6,1,1,0,1,0.66,0.5909,0.94,0.0,3,12,15,15,3,Pagi
14547,2012-09-03,1,9,7,1,1,0,1,0.68,0.6364,0.85,0.0,6,37,43,43,3,Siang
14548,2012-09-03,1,9,8,1,1,0,2,0.7,0.6667,0.84,0.1045,36,91,127,127,3,Siang
14549,2012-09-03,1,9,9,1,1,0,2,0.7,0.6667,0.84,0.1343,71,158,229,229,3,Siang
14550,2012-09-03,1,9,10,1,1,0,2,0.74,0.7121,0.74,0.2239,135,224,359,359,3,Siang
14551,2012-09-03,1,9,11,1,1,0,2,0.74,0.697,0.7,0.2836,187,272,459,459,3,Siang
14552,2012-09-03,1,9,12,1,1,0,2,0.76,0.7121,0.62,0.2985,191,352,543,543,3,Siang
14553,2012-09-03,1,9,13,1,1,0,2,0.76,0.7273,0.66,0.2537,209,357,566,566,3,Sore
14554,2012-09-03,1,9,14,1,1,0,1,0.74,0.697,0.7,0.2985,163,349,512,512,3,Sore
14555,2012-09-03,1,9,15,1,1,0,1,0.74,0.697,0.7,0.2239,168,281,449,449,3,Sore
14556,2012-09-03,1,9,16,1,1,0,1,0.74,0.697,0.7,0.2239,165,335,500,500,3,Sore
14557,2012-09-03,1,9,17,1,1,0,1,0.74,0.697,0.7,0.1343,181,317,498,498,3,Sore
14558,2012-09-03,1,9,18,1,1,0,1,0.74,0.697,0.66,0.1642,145,337,482,482,3,Sore
14559,2012-09-03,1,9,19,1,1,0,1,0.72,0.697,0.74,0.194,73,301,374,374,3,Malam
14560,2012-09-03,1,9,20,1,1,0,1,0.72,0.6818,0.76,0.1045,78,183,261,261,3,Malam
14561,2012-09-03,1,9,21,1,1,0,1,0.72,0.6818,0.76,0.1045,42,142,184,184,3,Malam
14562,2012-09-03,1,9,22,1,1,0,2,0.7,0.6667,0.84,0.1343,17,104,121,121,3,Malam
14563,2012-09-03,1,9,23,1,1,0,2,0.7,0.6667,0.84,0.2537,12,58,70,70,3,Malam
14564,2012-09-04,1,9,0,0,2,1,2,0.7,0.6667,0.84,0.2537,10,19,29,29,3,
14565,2012-09-04,1,9,1,0,2,1,1,0.68,0.6364,0.82,0.1343,15,9,24,24,3,Pagi
14566,2012-09-04,1,9,2,0,2,1,1,0.68,0.6364,0.82,0.1343,1,4,5,5,3,Pagi
14567,2012-09-04,1,9,3,0,2,1,2,0.66,0.5909,0.89,0.0896,1,9,10,10,3,Pagi
14568,2012-09-04,1,9,4,0,2,1,2,0.66,0.5909,0.89,0.0,0,8,8,8,3,Pagi
14569,2012-09-04,1,9,5,0,2,1,2,0.66,0.5909,0.89,0.0,1,37,38,38,3,Pagi
14570,2012-09-04,1,9,6,0,2,1,2,0.68,0.6364,0.89,0.1045,7,165,172,172,3,Pagi
14571,2012-09-04,1,9,7,0,2,1,2,0.68,0.6364,0.89,0.1045,13,480,493,493,3,Siang
14572,2012-09-04,1,9,8,0,2,1,1,0.7,0.6667,0.84,0.1642,15,617,632,632,3,Siang
14573,2012-09-04,1,9,9,0,2,1,2,0.72,0.697,0.79,0.2239,30,293,323,323,3,Siang
14574,2012-09-04,1,9,10,0,2,1,2,0.72,0.697,0.74,0.2537,42,130,172,172,3,Siang
14575,2012-09-04,1,9,11,0,2,1,2,0.74,0.697,0.7,0.2836,39,159,198,198,3,Siang
14576,2012-09-04,1,9,12,0,2,1,1,0.76,0.7273,0.7,0.2836,54,233,287,287,3,Siang
14577,2012-09-04,1,9,13,0,2,1,1,0.8,0.7576,0.55,0.4478,72,203,275,275,3,Sore
14578,2012-09-04,1,9,14,0,2,1,1,0.8,0.7576,0.55,0.4179,72,202,274,274,3,Sore
14579,2012-09-04,1,9,15,0,2,1,1,0.8,0.7727,0.59,0.4627,68,224,292,292,3,Sore
14580,2012-09-04,1,9,16,0,2,1,1,0.76,0.7273,0.7,0.4179,61,397,458,458,3,Sore
14581,2012-09-04,1,9,17,0,2,1,1,0.76,0.7273,0.7,0.3582,110,746,856,856,3,Sore
14582,2012-09-04,1,9,18,0,2,1,1,0.76,0.7424,0.75,0.2239,94,745,839,839,3,Sore
14583,2012-09-04,1,9,19,0,2,1,1,0.76,0.7273,0.7,0.2239,50,502,552,552,3,Malam
14584,2012-09-04,1,9,20,0,2,1,1,0.74,0.697,0.7,0.2537,47,338,385,385,3,Malam
14585,2012-09-04,1,9,21,0,2,1,1,0.74,0.7121,0.74,0.2537,28,240,268,268,3,Malam
14586,2012-09-04,1,9,22,0,2,1,1,0.74,0.697,0.7,0.2836,25,154,179,179,3,Malam
14587,2012-09-04,1,9,23,0,2,1,1,0.72,0.697,0.74,0.2985,12,83,95,95,3,Malam
14588,2012-09-05,1,9,0,0,3,1,1,0.72,0.697,0.74,0.2537,10,27,37,37,3,
14589,2012-09-05,1,9,1,0,3,1,1,0.7,0.6667,0.84,0.194,2,11,13,13,3,Pagi
14590,2012-09-05,1,9,2,0,3,1,1,0.7,0.6667,0.84,0.194,0,9,9,9,3,Pagi
14591,2012-09-05,1,9,3,0,3,1,1,0.7,0.6667,0.79,0.2836,0,4,4,4,3,Pagi
14592,2012-09-05,1,9,4,0,3,1,1,0.7,0.6667,0.79,0.2836,2,3,5,5,3,Pagi
14593,2012-09-05,1,9,5,0,3,1,2,0.7,0.6667,0.79,0.2985,1,39,40,40,3,Pagi
14594,2012-09-05,1,9,6,0,3,1,1,0.7,0.6667,0.79,0.2836,7,203,210,210,3,Pagi
14595,2012-09-05,1,9,7,0,3,1,2,0.7,0.6667,0.79,0.2537,11,489,500,500,3,Siang
14596,2012-09-05,1,9,8,0,3,1,1,0.72,0.697,0.74,0.194,33,692,725,725,3,Siang
14597,2012-09-05,1,9,9,0,3,1,1,0.74,0.697,0.7,0.2537,27,263,290,290,3,Siang
14598,2012-09-05,1,9,10,0,3,1,2,0.76,0.7273,0.7,0.1642,54,181,235,235,3,Siang
14599,2012-09-05,1,9,11,0,3,1,2,0.78,0.7424,0.62,0.1642,61,156,217,217,3,Siang
14600,2012-09-05,1,9,12,0,3,1,1,0.78,0.7727,0.7,0.1045,49,217,266,266,3,Siang
14601,2012-09-05,1,9,13,0,3,1,1,0.8,0.7879,0.63,0.1642,50,184,234,234,3,Sore
14602,2012-09-05,1,9,14,0,3,1,1,0.82,0.7879,0.56,0.1045,34,177,211,211,3,Sore
14603,2012-09-05,1,9,15,0,3,1,1,0.78,0.7727,0.7,0.194,41,204,245,245,3,Sore
14604,2012-09-05,1,9,16,0,3,1,1,0.76,0.7273,0.7,0.2537,86,344,430,430,3,Sore
14605,2012-09-05,1,9,17,0,3,1,1,0.76,0.7273,0.66,0.2537,83,780,863,863,3,Sore
14606,2012-09-05,1,9,18,0,3,1,1,0.76,0.7424,0.75,0.194,82,757,839,839,3,Sore
14607,2012-09-05,1,9,19,0,3,1,1,0.74,0.697,0.7,0.1642,64,598,662,662,3,Malam
14608,2012-09-05,1,9,20,0,3,1,1,0.72,0.7121,0.84,0.1642,55,357,412,412,3,Malam
14609,2012-09-05,1,9,21,0,3,1,1,0.72,0.697,0.79,0.0,18,278,296,296,3,Malam
14610,2012-09-05,1,9,22,0,3,1,1,0.72,0.697,0.79,0.0,38,181,219,219,3,Malam
14611,2012-09-05,1,9,23,0,3,1,1,0.7,0.6667,0.84,0.0896,24,126,150,150,3,Malam
14612,2012-09-06,1,9,0,0,4,1,2,0.7,0.6667,0.84,0.0896,30,35,65,65,3,
14613,2012-09-06,1,9,1,0,4,1,2,0.7,0.6667,0.84,0.0,2,16,18,18,3,Pagi
14614,2012-09-06,1,9,2,0,4,1,1,0.72,0.697,0.79,0.0,1,7,8,8,3,Pagi
14615,2012-09-06,1,9,3,0,4,1,1,0.7,0.6667,0.84,0.1045,0,9,9,9,3,Pagi
14616,2012-09-06,1,9,4,0,4,1,2,0.7,0.6667,0.84,0.0896,0,8,8,8,3,Pagi
14617,2012-09-06,1,9,5,0,4,1,2,0.7,0.6667,0.84,0.194,3,35,38,38,3,Pagi
14618,2012-09-06,1,9,6,0,4,1,2,0.7,0.6667,0.84,0.0896,11,189,200,200,3,Pagi
14619,2012-09-06,1,9,7,0,4,1,2,0.7,0.6667,0.84,0.1045,21,461,482,482,3,Siang
14620,2012-09-06,1,9,8,0,4,1,3,0.7,0.6667,0.79,0.0,24,622,646,646,3,Siang
14621,2012-09-06,1,9,9,0,4,1,3,0.66,0.5909,0.94,0.1343,8,115,123,123,3,Siang
14622,2012-09-06,1,9,10,0,4,1,3,0.66,0.5909,0.94,0.1343,9,40,49,49,3,Siang
14623,2012-09-06,1,9,11,0,4,1,3,0.7,0.6667,0.84,0.1642,10,52,62,62,3,Siang
14624,2012-09-06,1,9,12,0,4,1,2,0.72,0.697,0.79,0.2239,11,126,137,137,3,Siang
14625,2012-09-06,1,9,13,0,4,1,2,0.72,0.697,0.79,0.1045,39,152,191,191,3,Sore
14626,2012-09-06,1,9,14,0,4,1,1,0.74,0.7121,0.74,0.0896,38,178,216,216,3,Sore
14627,2012-09-06,1,9,15,0,4,1,1,0.74,0.697,0.66,0.194,42,228,270,270,3,Sore
14628,2012-09-06,1,9,16,0,4,1,1,0.74,0.697,0.7,0.2239,42,374,416,416,3,Sore
14629,2012-09-06,1,9,17,0,4,1,1,0.74,0.697,0.7,0.2537,67,741,808,808,3,Sore
14630,2012-09-06,1,9,18,0,4,1,1,0.72,0.6818,0.7,0.2537,74,761,835,835,3,Sore
14631,2012-09-06,1,9,19,0,4,1,1,0.68,0.6364,0.74,0.2537,54,504,558,558,3,Malam
14632,2012-09-06,1,9,20,0,4,1,1,0.66,0.6061,0.78,0.2239,50,356,406,406,3,Malam
14633,2012-09-06,1,9,21,0,4,1,1,0.64,0.5758,0.89,0.1642,32,240,272,272,3,Malam
14634,2012-09-06,1,9,22,0,4,1,1,0.64,0.5758,0.89,0.1642,24,193,217,217,3,Malam
14635,2012-09-06,1,9,23,0,4,1,1,0.64,0.5758,0.89,0.1642,19,150,169,169,3,Malam
14636,2012-09-07,1,9,0,0,5,1,1,0.64,0.5758,0.89,0.1343,17,79,96,96,3,
14637,2012-09-07,1,9,1,0,5,1,1,0.62,0.5606,0.88,0.1045,10,19,29,29,3,Pagi
14638,2012-09-07,1,9,2,0,5,1,1,0.62,0.5758,0.83,0.0896,1,10,11,11,3,Pagi
14639,2012-09-07,1,9,3,0,5,1,1,0.62,0.5758,0.83,0.0896,0,9,9,9,3,Pagi
14640,2012-09-07,1,9,4,0,5,1,1,0.62,0.5606,0.88,0.0,1,7,8,8,3,Pagi
14641,2012-09-07,1,9,5,0,5,1,1,0.62,0.5606,0.88,0.0,1,39,40,40,3,Pagi
14642,2012-09-07,1,9,6,0,5,1,1,0.62,0.5606,0.88,0.1045,5,135,140,140,3,Pagi
14643,2012-09-07,1,9,7,0,5,1,1,0.64,0.5758,0.89,0.1045,21,465,486,486,3,Siang
14644,2012-09-07,1,9,8,0,5,1,1,0.66,0.6061,0.83,0.1045,29,690,719,719,3,Siang
14645,2012-09-07,1,9,9,0,5,1,1,0.7,0.6667,0.79,0.1343,33,311,344,344,3,Siang
14646,2012-09-07,1,9,10,0,5,1,1,0.72,0.697,0.74,0.1343,53,171,224,224,3,Siang
14647,2012-09-07,1,9,11,0,5,1,1,0.76,0.7121,0.62,0.1343,81,215,296,296,3,Siang
14648,2012-09-07,1,9,12,0,5,1,1,0.78,0.7424,0.59,0.1642,76,247,323,323,3,Siang
14649,2012-09-07,1,9,13,0,5,1,1,0.8,0.7727,0.59,0.2537,71,283,354,354,3,Sore
14650,2012-09-07,1,9,14,0,5,1,1,0.8,0.7727,0.59,0.2537,66,187,253,253,3,Sore
14651,2012-09-07,1,9,15,0,5,1,1,0.8,0.7576,0.55,0.2537,66,265,331,331,3,Sore
14652,2012-09-07,1,9,16,0,5,1,1,0.8,0.7576,0.55,0.2836,75,395,470,470,3,Sore
14653,2012-09-07,1,9,17,0,5,1,1,0.78,0.7424,0.59,0.3284,88,684,772,772,3,Sore
14654,2012-09-07,1,9,18,0,5,1,1,0.76,0.7121,0.62,0.2985,95,697,792,792,3,Sore
14655,2012-09-07,1,9,19,0,5,1,1,0.74,0.6818,0.62,0.2836,70,498,568,568,3,Malam
14656,2012-09-07,1,9,20,0,5,1,1,0.72,0.6818,0.66,0.2239,51,340,391,391,3,Malam
14657,2012-09-07,1,9,21,0,5,1,1,0.7,0.6667,0.74,0.1642,55,246,301,301,3,Malam
14658,2012-09-07,1,9,22,0,5,1,1,0.7,0.6667,0.74,0.2239,52,247,299,299,3,Malam
14659,2012-09-07,1,9,23,0,5,1,1,0.66,0.5909,0.89,0.2537,28,220,248,248,3,Malam
14660,2012-09-08,1,9,0,0,6,0,1,0.66,0.5909,0.89,0.2537,20,130,150,150,3,
14661,2012-09-08,1,9,1,0,6,0,2,0.66,0.5909,0.89,0.2836,10,107,117,117,3,Pagi
14662,2012-09-08,1,9,2,0,6,0,1,0.66,0.5909,0.89,0.3284,9,68,77,77,3,Pagi
14663,2012-09-08,1,9,3,0,6,0,2,0.66,0.5909,0.89,0.2239,3,40,43,43,3,Pagi
14664,2012-09-08,1,9,4,0,6,0,2,0.66,0.5909,0.94,0.2239,3,8,11,11,3,Pagi
14665,2012-09-08,1,9,5,0,6,0,2,0.66,0.5909,0.94,0.2537,2,13,15,15,3,Pagi
14666,2012-09-08,1,9,6,0,6,0,2,0.66,0.5909,0.89,0.2836,8,26,34,34,3,Pagi
14667,2012-09-08,1,9,7,0,6,0,1,0.66,0.5909,0.89,0.2836,11,71,82,82,3,Siang
14668,2012-09-08,1,9,8,0,6,0,1,0.7,0.6667,0.79,0.3284,33,197,230,230,3,Siang
14669,2012-09-08,1,9,9,0,6,0,1,0.7,0.6667,0.74,0.3881,87,261,348,348,3,Siang
14670,2012-09-08,1,9,10,0,6,0,1,0.74,0.697,0.7,0.3881,100,322,422,422,3,Siang
14671,2012-09-08,1,9,11,0,6,0,1,0.76,0.7121,0.62,0.4478,173,405,578,578,3,Siang
14672,2012-09-08,1,9,12,0,6,0,1,0.8,0.7576,0.55,0.4925,220,474,694,694,3,Siang
14673,2012-09-08,1,9,13,0,6,0,1,0.82,0.7727,0.52,0.5224,233,435,668,668,3,Sore
14674,2012-09-08,1,9,14,0,6,0,1,0.82,0.7727,0.52,0.4478,260,366,626,626,3,Sore
14675,2012-09-08,1,9,15,0,6,0,3,0.56,0.5303,0.88,0.2537,175,337,512,512,3,Sore
14676,2012-09-08,1,9,16,0,6,0,3,0.56,0.5303,0.88,0.194,19,95,114,114,3,Sore
14677,2012-09-08,1,9,17,0,6,0,3,0.58,0.5455,0.83,0.194,52,119,171,171,3,Sore
14678,2012-09-08,1,9,18,0,6,0,3,0.58,0.5455,0.83,0.1343,27,140,167,167,3,Sore
14679,2012-09-08,1,9,19,0,6,0,3,0.58,0.5455,0.88,0.1045,28,187,215,215,3,Malam
14680,2012-09-08,1,9,20,0,6,0,2,0.58,0.5455,0.88,0.0896,28,166,194,194,3,Malam
14681,2012-09-08,1,9,21,0,6,0,2,0.6,0.5606,0.83,0.1642,26,155,181,181,3,Malam
14682,2012-09-08,1,9,22,0,6,0,2,0.58,0.5455,0.78,0.2985,18,176,194,194,3,Malam
14683,2012-09-08,1,9,23,0,6,0,2,0.58,0.5455,0.73,0.1642,12,121,133,133,3,Malam
14684,2012-09-09,1,9,0,0,0,0,2,0.56,0.5303,0.73,0.194,18,106,124,124,3,
14685,2012-09-09,1,9,1,0,0,0,1,0.56,0.5303,0.73,0.2239,20,104,124,124,3,Pagi
14686,2012-09-09,1,9,2,0,0,0,1,0.54,0.5152,0.77,0.2836,15,81,96,96,3,Pagi
14687,2012-09-09,1,9,3,0,0,0,1,0.54,0.5152,0.73,0.2239,14,32,46,46,3,Pagi
14688,2012-09-09,1,9,4,0,0,0,1,0.52,0.5,0.77,0.2537,12,16,28,28,3,Pagi
14689,2012-09-09,1,9,5,0,0,0,1,0.52,0.5,0.77,0.194,16,39,55,55,3,Pagi
14690,2012-09-09,1,9,6,0,0,0,1,0.52,0.5,0.77,0.194,11,24,35,35,3,Pagi
14691,2012-09-09,1,9,7,0,0,0,1,0.54,0.5152,0.73,0.1642,20,50,70,70,3,Siang
14692,2012-09-09,1,9,8,0,0,0,1,0.58,0.5455,0.68,0.2239,27,143,170,170,3,Siang
14693,2012-09-09,1,9,9,0,0,0,1,0.62,0.6061,0.61,0.2537,85,214,299,299,3,Siang
14694,2012-09-09,1,9,10,0,0,0,1,0.64,0.6212,0.57,0.2985,172,323,495,495,3,Siang
14695,2012-09-09,1,9,11,0,0,0,1,0.66,0.6212,0.47,0.2537,194,391,585,585,3,Siang
14696,2012-09-09,1,9,12,0,0,0,1,0.66,0.6212,0.47,0.0,247,510,757,757,3,Siang
14697,2012-09-09,1,9,13,0,0,0,1,0.68,0.6364,0.39,0.0,238,491,729,729,3,Sore
14698,2012-09-09,1,9,14,0,0,0,1,0.72,0.6515,0.3,0.2836,232,415,647,647,3,Sore
14699,2012-09-09,1,9,15,0,0,0,1,0.72,0.6515,0.32,0.2537,284,412,696,696,3,Sore
14700,2012-09-09,1,9,16,0,0,0,1,0.68,0.6364,0.36,0.2836,228,473,701,701,3,Sore
14701,2012-09-09,1,9,17,0,0,0,1,0.7,0.6364,0.37,0.2537,213,458,671,671,3,Sore
14702,2012-09-09,1,9,18,0,0,0,1,0.66,0.6212,0.36,0.2537,156,404,560,560,3,Sore
14703,2012-09-09,1,9,19,0,0,0,1,0.66,0.6212,0.36,0.2537,134,362,496,496,3,Malam
14704,2012-09-09,1,9,20,0,0,0,1,0.62,0.6212,0.41,0.2836,91,265,356,356,3,Malam
14705,2012-09-09,1,9,21,0,0,0,1,0.6,0.6212,0.46,0.2239,57,149,206,206,3,Malam
14706,2012-09-09,1,9,22,0,0,0,1,0.58,0.5455,0.49,0.2537,64,125,189,189,3,Malam
14707,2012-09-09,1,9,23,0,0,0,1,0.56,0.5303,0.52,0.2836,22,70,92,92,3,Malam
14708,2012-09-10,1,9,0,0,1,1,1,0.56,0.5303,0.52,0.2836,6,35,41,41,3,
14709,2012-09-10,1,9,1,0,1,1,1,0.54,0.5152,0.6,0.194,7,11,18,18,3,Pagi
14710,2012-09-10,1,9,2,0,1,1,1,0.54,0.5152,0.6,0.3582,11,6,17,17,3,Pagi
14711,2012-09-10,1,9,3,0,1,1,1,0.52,0.5,0.68,0.2836,5,7,12,12,3,Pagi
14712,2012-09-10,1,9,4,0,1,1,1,0.52,0.5,0.68,0.2836,1,4,5,5,3,Pagi
14713,2012-09-10,1,9,5,0,1,1,1,0.5,0.4848,0.72,0.2537,4,36,40,40,3,Pagi
14714,2012-09-10,1,9,6,0,1,1,1,0.5,0.4848,0.72,0.1343,8,172,180,180,3,Pagi
14715,2012-09-10,1,9,7,0,1,1,1,0.52,0.5,0.68,0.2239,20,427,447,447,3,Siang
14716,2012-09-10,1,9,8,0,1,1,1,0.56,0.5303,0.6,0.2836,33,697,730,730,3,Siang
14717,2012-09-10,1,9,9,0,1,1,1,0.6,0.6212,0.53,0.2985,40,321,361,361,3,Siang
14718,2012-09-10,1,9,10,0,1,1,1,0.62,0.6212,0.5,0.2836,42,168,210,210,3,Siang
14719,2012-09-10,1,9,11,0,1,1,1,0.62,0.6212,0.43,0.2985,69,167,236,236,3,Siang
14720,2012-09-10,1,9,12,0,1,1,1,0.64,0.6212,0.44,0.3881,76,256,332,332,3,Siang
14721,2012-09-10,1,9,13,0,1,1,1,0.64,0.6212,0.38,0.2239,72,251,323,323,3,Sore
14722,2012-09-10,1,9,14,0,1,1,1,0.66,0.6212,0.36,0.2836,107,233,340,340,3,Sore
14723,2012-09-10,1,9,15,0,1,1,1,0.66,0.6212,0.31,0.3881,115,231,346,346,3,Sore
14724,2012-09-10,1,9,16,0,1,1,1,0.66,0.6212,0.34,0.3284,108,380,488,488,3,Sore
14725,2012-09-10,1,9,17,0,1,1,1,0.66,0.6212,0.34,0.3284,127,744,871,871,3,Sore
14726,2012-09-10,1,9,18,0,1,1,1,0.62,0.6212,0.35,0.2985,111,857,968,968,3,Sore
14727,2012-09-10,1,9,19,0,1,1,1,0.62,0.6212,0.38,0.2985,71,562,633,633,3,Malam
14728,2012-09-10,1,9,20,0,1,1,1,0.6,0.6212,0.4,0.194,34,356,390,390,3,Malam
14729,2012-09-10,1,9,21,0,1,1,1,0.56,0.5303,0.49,0.1642,29,256,285,285,3,Malam
14730,2012-09-10,1,9,22,0,1,1,1,0.54,0.5152,0.52,0.1343,15,144,159,159,3,Malam
14731,2012-09-10,1,9,23,0,1,1,1,0.54,0.5152,0.52,0.0,7,86,93,93,3,Malam
14732,2012-09-11,1,9,0,0,2,1,1,0.52,0.5,0.59,0.1045,5,27,32,32,3,
14733,2012-09-11,1,9,1,0,2,1,1,0.5,0.4848,0.63,0.0,0,10,10,10,3,Pagi
14734,2012-09-11,1,9,2,0,2,1,1,0.48,0.4697,0.77,0.1642,1,5,6,6,3,Pagi
14735,2012-09-11,1,9,3,0,2,1,1,0.48,0.4697,0.67,0.1343,1,7,8,8,3,Pagi
14736,2012-09-11,1,9,4,0,2,1,1,0.48,0.4697,0.72,0.1045,1,8,9,9,3,Pagi
14737,2012-09-11,1,9,5,0,2,1,1,0.46,0.4545,0.72,0.0896,3,41,44,44,3,Pagi
14738,2012-09-11,1,9,6,0,2,1,1,0.46,0.4545,0.77,0.1045,11,200,211,211,3,Pagi
14739,2012-09-11,1,9,7,0,2,1,1,0.5,0.4848,0.72,0.1045,24,572,596,596,3,Siang
14740,2012-09-11,1,9,8,0,2,1,1,0.54,0.5152,0.68,0.0896,48,702,750,750,3,Siang
14741,2012-09-11,1,9,9,0,2,1,1,0.6,0.6212,0.49,0.0,35,323,358,358,3,Siang
14742,2012-09-11,1,9,10,0,2,1,1,0.62,0.6212,0.38,0.0,54,142,196,196,3,Siang
14743,2012-09-11,1,9,11,0,2,1,1,0.64,0.6212,0.33,0.0896,60,187,247,247,3,Siang
14744,2012-09-11,1,9,12,0,2,1,1,0.64,0.6212,0.33,0.0,62,254,316,316,3,Siang
14745,2012-09-11,1,9,13,0,2,1,1,0.66,0.6212,0.29,0.0896,72,256,328,328,3,Sore
14746,2012-09-11,1,9,14,0,2,1,1,0.68,0.6212,0.3,0.0896,74,181,255,255,3,Sore
14747,2012-09-11,1,9,15,0,2,1,1,0.7,0.6364,0.28,0.1045,73,253,326,326,3,Sore
14748,2012-09-11,1,9,16,0,2,1,1,0.7,0.6364,0.28,0.1343,99,437,536,536,3,Sore
14749,2012-09-11,1,9,17,0,2,1,1,0.7,0.6364,0.28,0.0,168,802,970,970,3,Sore
14750,2012-09-11,1,9,18,0,2,1,1,0.64,0.6212,0.36,0.1642,110,767,877,877,3,Sore
14751,2012-09-11,1,9,19,0,2,1,1,0.62,0.6212,0.41,0.194,56,540,596,596,3,Malam
14752,2012-09-11,1,9,20,0,2,1,1,0.58,0.5455,0.56,0.1343,40,421,461,461,3,Malam
14753,2012-09-11,1,9,21,0,2,1,1,0.56,0.5303,0.6,0.1045,28,282,310,310,3,Malam
14754,2012-09-11,1,9,22,0,2,1,1,0.56,0.5303,0.64,0.1045,27,189,216,216,3,Malam
14755,2012-09-11,1,9,23,0,2,1,1,0.54,0.5152,0.68,0.1045,18,91,109,109,3,Malam
14756,2012-09-12,1,9,0,0,3,1,1,0.52,0.5,0.72,0.1045,8,41,49,49,3,
14757,2012-09-12,1,9,1,0,3,1,1,0.52,0.5,0.72,0.1045,2,19,21,21,3,Pagi
14758,2012-09-12,1,9,2,0,3,1,1,0.52,0.5,0.72,0.0896,2,9,11,11,3,Pagi
14759,2012-09-12,1,9,3,0,3,1,1,0.5,0.4848,0.77,0.0896,0,7,7,7,3,Pagi
14760,2012-09-12,1,9,4,0,3,1,1,0.5,0.4848,0.72,0.0896,0,5,5,5,3,Pagi
14761,2012-09-12,1,9,5,0,3,1,1,0.5,0.4848,0.72,0.0896,4,44,48,48,3,Pagi
14762,2012-09-12,1,9,6,0,3,1,1,0.5,0.4848,0.72,0.0896,6,199,205,205,3,Pagi
14763,2012-09-12,1,9,7,0,3,1,1,0.52,0.5,0.72,0.0,24,533,557,557,3,Siang
14764,2012-09-12,1,9,8,0,3,1,1,0.56,0.5303,0.64,0.1045,43,727,770,770,3,Siang
14765,2012-09-12,1,9,9,0,3,1,1,0.6,0.6061,0.64,0.1343,50,278,328,328,3,Siang
14766,2012-09-12,1,9,10,0,3,1,1,0.62,0.6061,0.61,0.1343,57,148,205,205,3,Siang
14767,2012-09-12,1,9,11,0,3,1,1,0.66,0.6212,0.5,0.194,51,181,232,232,3,Siang
14768,2012-09-12,1,9,12,0,3,1,1,0.68,0.6364,0.36,0.1343,88,264,352,352,3,Siang
14769,2012-09-12,1,9,13,0,3,1,1,0.7,0.6364,0.34,0.1343,85,238,323,323,3,Sore
14770,2012-09-12,1,9,14,0,3,1,1,0.7,0.6364,0.37,0.1642,78,200,278,278,3,Sore
14771,2012-09-12,1,9,15,0,3,1,1,0.72,0.6515,0.37,0.1343,75,243,318,318,3,Sore
14772,2012-09-12,1,9,16,0,3,1,1,0.72,0.6515,0.37,0.1642,90,419,509,509,3,Sore
14773,2012-09-12,1,9,17,0,3,1,1,0.7,0.6364,0.41,0.2985,114,811,925,925,3,Sore
14774,2012-09-12,1,9,18,0,3,1,1,0.66,0.6212,0.44,0.2537,91,886,977,977,3,Sore
14775,2012-09-12,1,9,19,0,3,1,1,0.64,0.6212,0.5,0.194,78,557,635,635,3,Malam
14776,2012-09-12,1,9,20,0,3,1,1,0.62,0.6212,0.57,0.1343,38,432,470,470,3,Malam
14777,2012-09-12,1,9,21,0,3,1,1,0.6,0.6061,0.6,0.1343,27,279,306,306,3,Malam
14778,2012-09-12,1,9,22,0,3,1,1,0.56,0.5303,0.64,0.0896,23,189,212,212,3,Malam
14779,2012-09-12,1,9,23,0,3,1,1,0.56,0.5303,0.68,0.1045,16,111,127,127,3,Malam
14780,2012-09-13,1,9,0,0,4,1,1,0.56,0.5303,0.73,0.0896,11,46,57,57,3,
14781,2012-09-13,1,9,1,0,4,1,1,0.54,0.5152,0.77,0.0896,6,22,28,28,3,Pagi
14782,2012-09-13,1,9,2,0,4,1,1,0.54,0.5152,0.77,0.0,0,9,9,9,3,Pagi
14783,2012-09-13,1,9,3,0,4,1,1,0.52,0.5,0.83,0.0,2,9,11,11,3,Pagi
14784,2012-09-13,1,9,4,0,4,1,1,0.52,0.5,0.83,0.0,0,6,6,6,3,Pagi
14785,2012-09-13,1,9,5,0,4,1,1,0.52,0.5,0.83,0.0,3,54,57,57,3,Pagi
14786,2012-09-13,1,9,6,0,4,1,1,0.5,0.4848,0.82,0.0,9,186,195,195,3,Pagi
14787,2012-09-13,1,9,7,0,4,1,1,0.54,0.5152,0.77,0.0,22,549,571,571,3,Siang
14788,2012-09-13,1,9,8,0,4,1,1,0.56,0.5303,0.73,0.0,33,725,758,758,3,Siang
14789,2012-09-13,1,9,9,0,4,1,1,0.6,0.6061,0.64,0.0896,46,292,338,338,3,Siang
14790,2012-09-13,1,9,10,0,4,1,1,0.64,0.6212,0.61,0.0896,63,149,212,212,3,Siang
14791,2012-09-13,1,9,11,0,4,1,1,0.66,0.6212,0.5,0.1642,71,183,254,254,3,Siang
14792,2012-09-13,1,9,12,0,4,1,1,0.68,0.6364,0.44,0.1045,57,240,297,297,3,Siang
14793,2012-09-13,1,9,13,0,4,1,1,0.7,0.6364,0.42,0.0,60,223,283,283,3,Sore
14794,2012-09-13,1,9,14,0,4,1,1,0.72,0.6515,0.39,0.1343,60,214,274,274,3,Sore
14795,2012-09-13,1,9,15,0,4,1,1,0.72,0.6515,0.42,0.1045,99,253,352,352,3,Sore
14796,2012-09-13,1,9,16,0,4,1,1,0.72,0.6515,0.39,0.0896,85,406,491,491,3,Sore
14797,2012-09-13,1,9,17,0,4,1,1,0.72,0.6515,0.42,0.194,97,787,884,884,3,Sore
14798,2012-09-13,1,9,18,0,4,1,1,0.68,0.6364,0.57,0.2537,108,744,852,852,3,Sore
14799,2012-09-13,1,9,19,0,4,1,1,0.64,0.6061,0.65,0.1343,80,594,674,674,3,Malam
14800,2012-09-13,1,9,20,0,4,1,1,0.62,0.6061,0.69,0.1045,55,408,463,463,3,Malam
14801,2012-09-13,1,9,21,0,4,1,1,0.62,0.6061,0.65,0.1045,26,291,317,317,3,Malam
14802,2012-09-13,1,9,22,0,4,1,1,0.6,0.5909,0.69,0.1343,28,223,251,251,3,Malam
14803,2012-09-13,1,9,23,0,4,1,1,0.58,0.5455,0.73,0.1045,33,137,170,170,3,Malam
14804,2012-09-14,1,9,0,0,5,1,1,0.56,0.5303,0.73,0.0896,24,63,87,87,3,
14805,2012-09-14,1,9,1,0,5,1,1,0.56,0.5303,0.73,0.0896,6,35,41,41,3,Pagi
14806,2012-09-14,1,9,2,0,5,1,1,0.56,0.5303,0.73,0.0,7,23,30,30,3,Pagi
14807,2012-09-14,1,9,3,0,5,1,1,0.54,0.5152,0.77,0.0,5,9,14,14,3,Pagi
14808,2012-09-14,1,9,4,0,5,1,1,0.54,0.5152,0.77,0.0,1,11,12,12,3,Pagi
14809,2012-09-14,1,9,5,0,5,1,1,0.54,0.5152,0.83,0.0,1,40,41,41,3,Pagi
14810,2012-09-14,1,9,6,0,5,1,1,0.54,0.5152,0.88,0.0,8,144,152,152,3,Pagi
14811,2012-09-14,1,9,7,0,5,1,2,0.56,0.5303,0.88,0.0,17,437,454,454,3,Siang
14812,2012-09-14,1,9,8,0,5,1,2,0.6,0.5758,0.78,0.1642,51,715,766,766,3,Siang
14813,2012-09-14,1,9,9,0,5,1,2,0.62,0.5909,0.78,0.1642,46,301,347,347,3,Siang
14814,2012-09-14,1,9,10,0,5,1,2,0.68,0.6364,0.65,0.0,75,171,246,246,3,Siang
14815,2012-09-14,1,9,11,0,5,1,2,0.68,0.6364,0.61,0.1045,84,196,280,280,3,Siang
14816,2012-09-14,1,9,12,0,5,1,2,0.7,0.6515,0.54,0.194,119,290,409,409,3,Siang
14817,2012-09-14,1,9,13,0,5,1,2,0.7,0.6515,0.54,0.194,107,301,408,408,3,Sore
14818,2012-09-14,1,9,14,0,5,1,2,0.72,0.6515,0.45,0.1642,113,258,371,371,3,Sore
14819,2012-09-14,1,9,15,0,5,1,2,0.72,0.6667,0.48,0.1343,94,273,367,367,3,Sore
14820,2012-09-14,1,9,16,0,5,1,2,0.72,0.6667,0.51,0.0,109,454,563,563,3,Sore
14821,2012-09-14,1,9,17,0,5,1,1,0.72,0.6667,0.51,0.194,137,757,894,894,3,Sore
14822,2012-09-14,1,9,18,0,5,1,1,0.72,0.6515,0.45,0.2239,116,692,808,808,3,Sore
14823,2012-09-14,1,9,19,0,5,1,1,0.68,0.6364,0.57,0.1642,83,496,579,579,3,Malam
14824,2012-09-14,1,9,20,0,5,1,1,0.66,0.6212,0.61,0.1045,67,337,404,404,3,Malam
14825,2012-09-14,1,9,21,0,5,1,1,0.64,0.6061,0.73,0.2239,42,270,312,312,3,Malam
14826,2012-09-14,1,9,22,0,5,1,1,0.62,0.5758,0.83,0.194,40,189,229,229,3,Malam
14827,2012-09-14,1,9,23,0,5,1,1,0.62,0.5909,0.78,0.0896,27,168,195,195,3,Malam
14828,2012-09-15,1,9,0,0,6,0,1,0.6,0.5606,0.83,0.1045,38,169,207,207,3,
14829,2012-09-15,1,9,1,0,6,0,1,0.6,0.5909,0.73,0.0,8,101,109,109,3,Pagi
14830,2012-09-15,1,9,2,0,6,0,1,0.58,0.5455,0.78,0.1045,18,75,93,93,3,Pagi
14831,2012-09-15,1,9,3,0,6,0,1,0.6,0.5909,0.73,0.2537,6,31,37,37,3,Pagi
14832,2012-09-15,1,9,4,0,6,0,2,0.6,0.5909,0.69,0.3582,3,3,6,6,3,Pagi
14833,2012-09-15,1,9,5,0,6,0,1,0.58,0.5455,0.6,0.5224,1,15,16,16,3,Pagi
14834,2012-09-15,1,9,6,0,6,0,1,0.54,0.5152,0.49,0.4179,6,27,33,33,3,Pagi
14835,2012-09-15,1,9,7,0,6,0,1,0.54,0.5152,0.52,0.2836,10,63,73,73,3,Siang
14836,2012-09-15,1,9,8,0,6,0,1,0.56,0.5303,0.49,0.4179,43,169,212,212,3,Siang
14837,2012-09-15,1,9,9,0,6,0,1,0.6,0.6212,0.43,0.4179,79,263,342,342,3,Siang
14838,2012-09-15,1,9,10,0,6,0,1,0.62,0.6212,0.41,0.3881,119,323,442,442,3,Siang
14839,2012-09-15,1,9,11,0,6,0,1,0.64,0.6212,0.38,0.3881,228,399,627,627,3,Siang
14840,2012-09-15,1,9,12,0,6,0,1,0.66,0.6212,0.36,0.3582,287,419,706,706,3,Siang
14841,2012-09-15,1,9,13,0,6,0,1,0.68,0.6364,0.36,0.194,327,377,704,704,3,Sore
14842,2012-09-15,1,9,14,0,6,0,1,0.68,0.6364,0.34,0.3284,325,390,715,715,3,Sore
14843,2012-09-15,1,9,15,0,6,0,2,0.68,0.6364,0.34,0.2836,312,342,654,654,3,Sore
14844,2012-09-15,1,9,16,0,6,0,2,0.66,0.6212,0.36,0.2239,350,433,783,783,3,Sore
14845,2012-09-15,1,9,17,0,6,0,2,0.66,0.6212,0.36,0.2537,295,434,729,729,3,Sore
14846,2012-09-15,1,9,18,0,6,0,2,0.64,0.6212,0.36,0.2836,232,382,614,614,3,Sore
14847,2012-09-15,1,9,19,0,6,0,1,0.62,0.6212,0.41,0.1642,169,309,478,478,3,Malam
14848,2012-09-15,1,9,20,0,6,0,1,0.6,0.6212,0.43,0.0896,89,241,330,330,3,Malam
14849,2012-09-15,1,9,21,0,6,0,1,0.56,0.5303,0.52,0.1045,86,210,296,296,3,Malam
14850,2012-09-15,1,9,22,0,6,0,1,0.56,0.5303,0.52,0.0,82,197,279,279,3,Malam
14851,2012-09-15,1,9,23,0,6,0,1,0.54,0.5152,0.6,0.0,47,182,229,229,3,Malam
14852,2012-09-16,1,9,0,0,0,0,1,0.54,0.5152,0.64,0.0,28,123,151,151,3,
14853,2012-09-16,1,9,1,0,0,0,1,0.54,0.5152,0.64,0.0,35,82,117,117,3,Pagi
14854,2012-09-16,1,9,2,0,0,0,1,0.52,0.5,0.63,0.0,27,62,89,89,3,Pagi
14855,2012-09-16,1,9,3,0,0,0,1,0.5,0.4848,0.68,0.0,10,38,48,48,3,Pagi
14856,2012-09-16,1,9,4,0,0,0,1,0.5,0.4848,0.72,0.0,2,6,8,8,3,Pagi
14857,2012-09-16,1,9,5,0,0,0,1,0.5,0.4848,0.72,0.0,3,10,13,13,3,Pagi
14858,2012-09-16,1,9,6,0,0,0,1,0.5,0.4848,0.72,0.0,9,26,35,35,3,Pagi
14859,2012-09-16,1,9,7,0,0,0,1,0.5,0.4848,0.77,0.1045,28,43,71,71,3,Siang
14860,2012-09-16,1,9,8,0,0,0,1,0.54,0.5152,0.64,0.1642,34,94,128,128,3,Siang
14861,2012-09-16,1,9,9,0,0,0,1,0.58,0.5455,0.6,0.1343,70,226,296,296,3,Siang
14862,2012-09-16,1,9,10,0,0,0,1,0.62,0.6212,0.5,0.1045,160,330,490,490,3,Siang
14863,2012-09-16,1,9,11,0,0,0,1,0.64,0.6212,0.47,0.1642,183,376,559,559,3,Siang
14864,2012-09-16,1,9,12,0,0,0,1,0.66,0.6212,0.44,0.1642,188,468,656,656,3,Siang
14865,2012-09-16,1,9,13,0,0,0,1,0.64,0.6212,0.41,0.1642,240,454,694,694,3,Sore
14866,2012-09-16,1,9,14,0,0,0,1,0.66,0.6212,0.39,0.1343,225,410,635,635,3,Sore
14867,2012-09-16,1,9,15,0,0,0,1,0.64,0.6212,0.41,0.1642,215,342,557,557,3,Sore
14868,2012-09-16,1,9,16,0,0,0,1,0.64,0.6212,0.44,0.1642,194,402,596,596,3,Sore
14869,2012-09-16,1,9,17,0,0,0,1,0.66,0.6212,0.41,0.0,177,393,570,570,3,Sore
14870,2012-09-16,1,9,18,0,0,0,1,0.62,0.6212,0.5,0.1642,120,361,481,481,3,Sore
14871,2012-09-16,1,9,19,0,0,0,1,0.62,0.6212,0.5,0.1343,91,312,403,403,3,Malam
14872,2012-09-16,1,9,20,0,0,0,1,0.6,0.6212,0.53,0.1045,57,267,324,324,3,Malam
14873,2012-09-16,1,9,21,0,0,0,1,0.6,0.6212,0.56,0.1045,43,148,191,191,3,Malam
14874,2012-09-16,1,9,22,0,0,0,1,0.56,0.5303,0.68,0.0896,18,109,127,127,3,Malam
14875,2012-09-16,1,9,23,0,0,0,1,0.54,0.5152,0.68,0.1045,9,85,94,94,3,Malam
14876,2012-09-17,1,9,0,0,1,1,1,0.54,0.5152,0.68,0.1642,14,31,45,45,3,
14877,2012-09-17,1,9,1,0,1,1,1,0.52,0.5,0.72,0.0896,9,12,21,21,3,Pagi
14878,2012-09-17,1,9,2,0,1,1,1,0.52,0.5,0.72,0.0,5,8,13,13,3,Pagi
14879,2012-09-17,1,9,3,0,1,1,1,0.5,0.4848,0.77,0.0896,0,7,7,7,3,Pagi
14880,2012-09-17,1,9,4,0,1,1,1,0.5,0.4848,0.77,0.0,2,9,11,11,3,Pagi
14881,2012-09-17,1,9,5,0,1,1,1,0.48,0.4697,0.82,0.0896,1,44,45,45,3,Pagi
14882,2012-09-17,1,9,6,0,1,1,1,0.48,0.4697,0.82,0.0,7,157,164,164,3,Pagi
14883,2012-09-17,1,9,7,0,1,1,1,0.52,0.5,0.77,0.0,18,474,492,492,3,Siang
14884,2012-09-17,1,9,8,0,1,1,1,0.54,0.5152,0.77,0.0896,36,647,683,683,3,Siang
14885,2012-09-17,1,9,9,0,1,1,1,0.58,0.5455,0.68,0.1343,34,265,299,299,3,Siang
14886,2012-09-17,1,9,10,0,1,1,2,0.62,0.6061,0.65,0.194,73,129,202,202,3,Siang
14887,2012-09-17,1,9,11,0,1,1,2,0.62,0.6061,0.69,0.2239,61,191,252,252,3,Siang
14888,2012-09-17,1,9,12,0,1,1,2,0.62,0.6061,0.69,0.194,62,233,295,295,3,Siang
14889,2012-09-17,1,9,13,0,1,1,1,0.64,0.6061,0.65,0.2537,112,231,343,343,3,Sore
14890,2012-09-17,1,9,14,0,1,1,2,0.64,0.6061,0.65,0.2537,129,203,332,332,3,Sore
14891,2012-09-17,1,9,15,0,1,1,2,0.64,0.6061,0.65,0.2537,82,256,338,338,3,Sore
14892,2012-09-17,1,9,16,0,1,1,2,0.64,0.6061,0.69,0.2537,74,379,453,453,3,Sore
14893,2012-09-17,1,9,17,0,1,1,2,0.64,0.6061,0.65,0.2239,102,740,842,842,3,Sore
14894,2012-09-17,1,9,18,0,1,1,2,0.62,0.5909,0.73,0.1642,66,708,774,774,3,Sore
14895,2012-09-17,1,9,19,0,1,1,2,0.62,0.5909,0.73,0.1045,51,435,486,486,3,Malam
14896,2012-09-17,1,9,20,0,1,1,2,0.62,0.5909,0.73,0.1343,32,308,340,340,3,Malam
14897,2012-09-17,1,9,21,0,1,1,3,0.62,0.5758,0.83,0.2239,28,205,233,233,3,Malam
14898,2012-09-17,1,9,22,0,1,1,3,0.62,0.5758,0.83,0.2537,20,109,129,129,3,Malam
14899,2012-09-17,1,9,23,0,1,1,3,0.6,0.5152,0.94,0.2537,4,66,70,70,3,Malam
14900,2012-09-18,1,9,0,0,2,1,3,0.6,0.5152,0.94,0.2537,2,11,13,13,3,
14901,2012-09-18,1,9,1,0,2,1,3,0.6,0.5152,0.94,0.194,0,5,5,5,3,Pagi
14902,2012-09-18,1,9,2,0,2,1,3,0.6,0.5152,0.94,0.194,0,4,4,4,3,Pagi
14903,2012-09-18,1,9,3,0,2,1,2,0.62,0.5455,0.94,0.2836,0,6,6,6,3,Pagi
14904,2012-09-18,1,9,4,0,2,1,2,0.62,0.5455,0.94,0.3582,2,5,7,7,3,Pagi
14905,2012-09-18,1,9,5,0,2,1,2,0.64,0.5758,0.89,0.3284,3,45,48,48,3,Pagi
14906,2012-09-18,1,9,6,0,2,1,2,0.64,0.5758,0.89,0.3284,4,163,167,167,3,Pagi
14907,2012-09-18,1,9,7,0,2,1,2,0.64,0.5758,0.89,0.4478,13,343,356,356,3,Siang
14908,2012-09-18,1,9,8,0,2,1,2,0.66,0.6061,0.83,0.5522,32,640,672,672,3,Siang
14909,2012-09-18,1,9,9,0,2,1,2,0.66,0.6061,0.83,0.5821,27,266,293,293,3,Siang
14910,2012-09-18,1,9,10,0,2,1,3,0.68,0.6364,0.79,0.6418,30,130,160,160,3,Siang
14911,2012-09-18,1,9,11,0,2,1,2,0.68,0.6364,0.79,0.6418,36,115,151,151,3,Siang
14912,2012-09-18,1,9,12,0,2,1,3,0.68,0.6364,0.83,0.4478,16,72,88,88,3,Siang
14913,2012-09-18,1,9,13,0,2,1,2,0.7,0.6667,0.74,0.5821,17,97,114,114,3,Sore
14914,2012-09-18,1,9,14,0,2,1,3,0.6,0.5152,0.94,0.4627,27,116,143,143,3,Sore
14915,2012-09-18,1,9,15,0,2,1,3,0.6,0.5455,0.88,0.2537,1,35,36,36,3,Sore
14916,2012-09-18,1,9,16,0,2,1,3,0.6,0.5455,0.88,0.2985,19,122,141,141,3,Sore
14917,2012-09-18,1,9,17,0,2,1,3,0.6,0.5455,0.88,0.194,36,302,338,338,3,Sore
14918,2012-09-18,1,9,18,0,2,1,2,0.6,0.5455,0.88,0.1642,19,262,281,281,3,Sore
14919,2012-09-18,1,9,19,0,2,1,2,0.6,0.5455,0.88,0.2985,22,302,324,324,3,Malam
14920,2012-09-18,1,9,20,0,2,1,2,0.6,0.5455,0.88,0.194,19,271,290,290,3,Malam
14921,2012-09-18,1,9,21,0,2,1,2,0.6,0.5455,0.88,0.194,21,186,207,207,3,Malam
14922,2012-09-18,1,9,22,0,2,1,3,0.58,0.5455,0.83,0.4627,14,137,151,151,3,Malam
14923,2012-09-18,1,9,23,0,2,1,2,0.56,0.5303,0.83,0.2239,11,67,78,78,3,Malam
14924,2012-09-19,1,9,0,0,3,1,2,0.56,0.5303,0.68,0.2836,3,23,26,26,3,
14925,2012-09-19,1,9,1,0,3,1,2,0.54,0.5152,0.68,0.2537,0,12,12,12,3,Pagi
14926,2012-09-19,1,9,2,0,3,1,2,0.54,0.5152,0.64,0.3284,0,3,3,3,3,Pagi
14927,2012-09-19,1,9,3,0,3,1,2,0.52,0.5,0.63,0.2537,1,4,5,5,3,Pagi
14928,2012-09-19,1,9,4,0,3,1,2,0.52,0.5,0.68,0.3582,0,10,10,10,3,Pagi
14929,2012-09-19,1,9,5,0,3,1,2,0.52,0.5,0.68,0.2836,2,54,56,56,3,Pagi
14930,2012-09-19,1,9,6,0,3,1,1,0.52,0.5,0.63,0.2537,6,166,172,172,3,Pagi
14931,2012-09-19,1,9,7,0,3,1,1,0.52,0.5,0.63,0.2239,16,529,545,545,3,Siang
14932,2012-09-19,1,9,8,0,3,1,1,0.52,0.5,0.59,0.2239,39,758,797,797,3,Siang
14933,2012-09-19,1,9,9,0,3,1,1,0.54,0.5152,0.6,0.2537,26,336,362,362,3,Siang
14934,2012-09-19,1,9,10,0,3,1,1,0.56,0.5303,0.52,0.194,23,169,192,192,3,Siang
14935,2012-09-19,1,9,11,0,3,1,1,0.6,0.6212,0.43,0.2537,44,203,247,247,3,Siang
14936,2012-09-19,1,9,12,0,3,1,1,0.6,0.6212,0.43,0.2537,53,260,313,313,3,Siang
14937,2012-09-19,1,9,13,0,3,1,1,0.6,0.6212,0.4,0.2537,55,234,289,289,3,Sore
14938,2012-09-19,1,9,14,0,3,1,1,0.62,0.6212,0.38,0.2537,59,227,286,286,3,Sore
14939,2012-09-19,1,9,15,0,3,1,1,0.62,0.6212,0.35,0.0,57,254,311,311,3,Sore
14940,2012-09-19,1,9,16,0,3,1,1,0.62,0.6212,0.35,0.0,69,397,466,466,3,Sore
14941,2012-09-19,1,9,17,0,3,1,1,0.6,0.6212,0.38,0.2239,74,812,886,886,3,Sore
14942,2012-09-19,1,9,18,0,3,1,1,0.58,0.5455,0.4,0.2836,85,807,892,892,3,Sore
14943,2012-09-19,1,9,19,0,3,1,1,0.56,0.5303,0.43,0.2239,72,539,611,611,3,Malam
14944,2012-09-19,1,9,20,0,3,1,1,0.52,0.5,0.48,0.1642,31,378,409,409,3,Malam
14945,2012-09-19,1,9,21,0,3,1,1,0.5,0.4848,0.59,0.1642,25,324,349,349,3,Malam
14946,2012-09-19,1,9,22,0,3,1,1,0.5,0.4848,0.63,0.0896,31,198,229,229,3,Malam
14947,2012-09-19,1,9,23,0,3,1,1,0.48,0.4697,0.67,0.0896,17,106,123,123,3,Malam
14948,2012-09-20,1,9,0,0,4,1,1,0.5,0.4848,0.63,0.0,12,46,58,58,3,
14949,2012-09-20,1,9,1,0,4,1,1,0.46,0.4545,0.72,0.1045,4,14,18,18,3,Pagi
14950,2012-09-20,1,9,2,0,4,1,1,0.46,0.4545,0.72,0.0896,2,9,11,11,3,Pagi
14951,2012-09-20,1,9,3,0,4,1,1,0.44,0.4394,0.77,0.0,0,6,6,6,3,Pagi
14952,2012-09-20,1,9,4,0,4,1,1,0.44,0.4394,0.77,0.1045,0,6,6,6,3,Pagi
14953,2012-09-20,1,9,5,0,4,1,1,0.44,0.4394,0.77,0.1045,4,52,56,56,3,Pagi
14954,2012-09-20,1,9,6,0,4,1,1,0.44,0.4394,0.77,0.0,9,161,170,170,3,Pagi
14955,2012-09-20,1,9,7,0,4,1,1,0.46,0.4545,0.82,0.1045,20,514,534,534,3,Siang
14956,2012-09-20,1,9,8,0,4,1,1,0.5,0.4848,0.68,0.0896,44,746,790,790,3,Siang
14957,2012-09-20,1,9,9,0,4,1,1,0.56,0.5303,0.6,0.0896,25,330,355,355,3,Siang
14958,2012-09-20,1,9,10,0,4,1,1,0.58,0.5455,0.53,0.0896,33,157,190,190,3,Siang
14959,2012-09-20,1,9,11,0,4,1,1,0.62,0.6212,0.43,0.0,37,206,243,243,3,Siang
14960,2012-09-20,1,9,12,0,4,1,1,0.62,0.6212,0.43,0.1343,57,233,290,290,3,Siang
14961,2012-09-20,1,9,13,0,4,1,1,0.64,0.6212,0.44,0.1343,68,268,336,336,3,Sore
14962,2012-09-20,1,9,14,0,4,1,1,0.64,0.6212,0.47,0.194,76,222,298,298,3,Sore
14963,2012-09-20,1,9,15,0,4,1,1,0.66,0.6212,0.47,0.194,60,231,291,291,3,Sore
14964,2012-09-20,1,9,16,0,4,1,1,0.64,0.6212,0.47,0.1642,72,385,457,457,3,Sore
14965,2012-09-20,1,9,17,0,4,1,1,0.64,0.6212,0.5,0.2239,91,885,976,976,3,Sore
14966,2012-09-20,1,9,18,0,4,1,1,0.6,0.6212,0.56,0.2537,119,781,900,900,3,Sore
14967,2012-09-20,1,9,19,0,4,1,1,0.58,0.5455,0.6,0.2239,69,534,603,603,3,Malam
14968,2012-09-20,1,9,20,0,4,1,1,0.56,0.5303,0.64,0.1343,57,360,417,417,3,Malam
14969,2012-09-20,1,9,21,0,4,1,1,0.56,0.5303,0.64,0.194,28,246,274,274,3,Malam
14970,2012-09-20,1,9,22,0,4,1,1,0.54,0.5152,0.73,0.1045,35,252,287,287,3,Malam
14971,2012-09-20,1,9,23,0,4,1,1,0.54,0.5152,0.68,0.1045,17,137,154,154,3,Malam
14972,2012-09-21,1,9,0,0,5,1,1,0.54,0.5152,0.68,0.0,13,53,66,66,3,
14973,2012-09-21,1,9,1,0,5,1,1,0.52,0.5,0.72,0.0,11,38,49,49,3,Pagi
14974,2012-09-21,1,9,2,0,5,1,1,0.52,0.5,0.72,0.0,6,8,14,14,3,Pagi
14975,2012-09-21,1,9,3,0,5,1,1,0.5,0.4848,0.77,0.0896,1,11,12,12,3,Pagi
14976,2012-09-21,1,9,4,0,5,1,1,0.5,0.4848,0.77,0.0,1,9,10,10,3,Pagi
14977,2012-09-21,1,9,5,0,5,1,1,0.5,0.4848,0.82,0.0,2,47,49,49,3,Pagi
14978,2012-09-21,1,9,6,0,5,1,1,0.5,0.4848,0.77,0.0896,19,146,165,165,3,Pagi
14979,2012-09-21,1,9,7,0,5,1,1,0.52,0.5,0.77,0.0,35,468,503,503,3,Siang
14980,2012-09-21,1,9,8,0,5,1,1,0.54,0.5152,0.73,0.1343,31,726,757,757,3,Siang
14981,2012-09-21,1,9,9,0,5,1,1,0.58,0.5455,0.68,0.1343,35,348,383,383,3,Siang
14982,2012-09-21,1,9,10,0,5,1,1,0.62,0.6061,0.61,0.2239,44,181,225,225,3,Siang
14983,2012-09-21,1,9,11,0,5,1,1,0.66,0.6212,0.57,0.2239,79,242,321,321,3,Siang
14984,2012-09-21,1,9,12,0,5,1,1,0.68,0.6364,0.57,0.1642,84,305,389,389,3,Siang
14985,2012-09-21,1,9,13,0,5,1,1,0.7,0.6515,0.54,0.1642,105,316,421,421,3,Sore
14986,2012-09-21,1,9,14,0,5,1,1,0.7,0.6515,0.54,0.2985,113,299,412,412,3,Sore
14987,2012-09-21,1,9,15,0,5,1,1,0.7,0.6515,0.54,0.2239,90,333,423,423,3,Sore
14988,2012-09-21,1,9,16,0,5,1,1,0.7,0.6515,0.54,0.194,103,464,567,567,3,Sore
14989,2012-09-21,1,9,17,0,5,1,1,0.68,0.6364,0.57,0.2836,107,739,846,846,3,Sore
14990,2012-09-21,1,9,18,0,5,1,1,0.66,0.6212,0.61,0.2537,106,699,805,805,3,Sore
14991,2012-09-21,1,9,19,0,5,1,1,0.64,0.6061,0.65,0.2537,95,493,588,588,3,Malam
14992,2012-09-21,1,9,20,0,5,1,1,0.62,0.6061,0.69,0.194,54,315,369,369,3,Malam
14993,2012-09-21,1,9,21,0,5,1,1,0.6,0.5909,0.73,0.2537,46,266,312,312,3,Malam
14994,2012-09-21,1,9,22,0,5,1,1,0.6,0.5909,0.73,0.194,47,248,295,295,3,Malam
14995,2012-09-21,1,9,23,0,5,1,1,0.6,0.5909,0.73,0.3284,23,163,186,186,3,Malam
14996,2012-09-22,1,9,0,0,6,0,1,0.6,0.5909,0.73,0.2836,32,140,172,172,3,
14997,2012-09-22,1,9,1,0,6,0,1,0.58,0.5455,0.83,0.2985,18,106,124,124,3,Pagi
14998,2012-09-22,1,9,2,0,6,0,1,0.56,0.5303,0.88,0.2537,10,73,83,83,3,Pagi
14999,2012-09-22,1,9,3,0,6,0,1,0.56,0.5303,0.83,0.2836,6,39,45,45,3,Pagi
15000,2012-09-22,1,9,4,0,6,0,1,0.56,0.5303,0.83,0.2836,5,10,15,15,3,Pagi
15001,2012-09-22,1,9,5,0,6,0,1,0.56,0.5303,0.83,0.3284,2,15,17,17,3,Pagi
15002,2012-09-22,1,9,6,0,6,0,1,0.56,0.5303,0.83,0.2985,6,35,41,41,3,Pagi
15003,2012-09-22,1,9,7,0,6,0,1,0.58,0.5455,0.78,0.2537,7,70,77,77,3,Siang
15004,2012-09-22,1,9,8,0,6,0,1,0.6,0.5909,0.73,0.2985,21,197,218,218,3,Siang
15005,2012-09-22,1,9,9,0,6,0,1,0.64,0.6061,0.69,0.2537,88,289,377,377,3,Siang
15006,2012-09-22,1,9,10,0,6,0,1,0.66,0.6212,0.65,0.3284,124,350,474,474,3,Siang
15007,2012-09-22,1,9,11,0,6,0,1,0.7,0.6515,0.58,0.2836,189,437,626,626,3,Siang
15008,2012-09-22,1,9,12,0,6,0,1,0.72,0.6667,0.54,0.2985,228,460,688,688,3,Siang
15009,2012-09-22,1,9,13,0,6,0,1,0.74,0.6667,0.51,0.3582,273,434,707,707,3,Sore
15010,2012-09-22,1,9,14,0,6,0,1,0.76,0.6818,0.48,0.2836,250,404,654,654,3,Sore
15011,2012-09-22,1,9,15,0,6,0,1,0.74,0.6667,0.48,0.3881,307,443,750,750,3,Sore
15012,2012-09-22,1,9,16,0,6,0,1,0.74,0.6667,0.51,0.3284,253,427,680,680,3,Sore
15013,2012-09-22,1,9,17,0,6,0,1,0.74,0.6667,0.51,0.3284,195,451,646,646,3,Sore
15014,2012-09-22,1,9,18,0,6,0,1,0.72,0.6667,0.54,0.2836,171,427,598,598,3,Sore
15015,2012-09-22,1,9,19,0,6,0,1,0.7,0.6515,0.58,0.194,99,308,407,407,3,Malam
15016,2012-09-22,1,9,20,0,6,0,1,0.7,0.6515,0.54,0.2537,76,249,325,325,3,Malam
15017,2012-09-22,1,9,21,0,6,0,1,0.64,0.6212,0.57,0.2537,59,202,261,261,3,Malam
15018,2012-09-22,1,9,22,0,6,0,1,0.62,0.6212,0.57,0.194,59,180,239,239,3,Malam
15019,2012-09-22,1,9,23,0,6,0,1,0.62,0.6212,0.5,0.194,34,137,171,171,3,Malam
15020,2012-09-23,1,9,0,0,0,0,1,0.62,0.6212,0.38,0.2537,34,146,180,180,4,
15021,2012-09-23,1,9,1,0,0,0,1,0.54,0.5152,0.52,0.3582,23,119,142,142,4,Pagi
15022,2012-09-23,1,9,2,0,0,0,1,0.52,0.5,0.48,0.2537,18,77,95,95,4,Pagi
15023,2012-09-23,1,9,3,0,0,0,1,0.48,0.4697,0.55,0.2985,13,41,54,54,4,Pagi
15024,2012-09-23,1,9,4,0,0,0,1,0.46,0.4545,0.55,0.2239,1,9,10,10,4,Pagi
15025,2012-09-23,1,9,5,0,0,0,1,0.46,0.4545,0.59,0.2537,1,5,6,6,4,Pagi
15026,2012-09-23,1,9,6,0,0,0,1,0.44,0.4394,0.62,0.2537,5,11,16,16,4,Pagi
15027,2012-09-23,1,9,7,0,0,0,1,0.46,0.4545,0.59,0.2239,9,48,57,57,4,Siang
15028,2012-09-23,1,9,8,0,0,0,1,0.48,0.4697,0.55,0.3582,38,137,175,175,4,Siang
15029,2012-09-23,1,9,9,0,0,0,1,0.5,0.4848,0.51,0.3284,71,205,276,276,4,Siang
15030,2012-09-23,1,9,10,0,0,0,1,0.54,0.5152,0.45,0.2537,138,351,489,489,4,Siang
15031,2012-09-23,1,9,11,0,0,0,1,0.56,0.5303,0.46,0.2537,186,384,570,570,4,Siang
15032,2012-09-23,1,9,12,0,0,0,1,0.56,0.5303,0.43,0.1045,250,526,776,776,4,Siang
15033,2012-09-23,1,9,13,0,0,0,1,0.6,0.6212,0.38,0.1642,257,445,702,702,4,Sore
15034,2012-09-23,1,9,14,0,0,0,1,0.6,0.6212,0.38,0.194,266,400,666,666,4,Sore
15035,2012-09-23,1,9,15,0,0,0,1,0.6,0.6212,0.33,0.2239,265,375,640,640,4,Sore
15036,2012-09-23,1,9,16,0,0,0,1,0.6,0.6212,0.33,0.3284,254,437,691,691,4,Sore
15037,2012-09-23,1,9,17,0,0,0,1,0.56,0.5303,0.35,0.2985,227,496,723,723,4,Sore
15038,2012-09-23,1,9,18,0,0,0,1,0.54,0.5152,0.37,0.194,135,405,540,540,4,Sore
15039,2012-09-23,1,9,19,0,0,0,1,0.52,0.5,0.42,0.1642,82,331,413,413,4,Malam
15040,2012-09-23,1,9,20,0,0,0,1,0.52,0.5,0.42,0.1642,60,192,252,252,4,Malam
15041,2012-09-23,1,9,21,0,0,0,2,0.52,0.5,0.48,0.1045,51,145,196,196,4,Malam
15042,2012-09-23,1,9,22,0,0,0,1,0.52,0.5,0.48,0.0,40,98,138,138,4,Malam
15043,2012-09-23,1,9,23,0,0,0,2,0.5,0.4848,0.59,0.1045,30,70,100,100,4,Malam
15044,2012-09-24,1,9,0,0,1,1,1,0.46,0.4545,0.63,0.194,10,54,64,64,4,
15045,2012-09-24,1,9,1,0,1,1,1,0.46,0.4545,0.67,0.1343,6,12,18,18,4,Pagi
15046,2012-09-24,1,9,2,0,1,1,2,0.46,0.4545,0.63,0.1343,0,8,8,8,4,Pagi
15047,2012-09-24,1,9,3,0,1,1,1,0.46,0.4545,0.63,0.1642,0,5,5,5,4,Pagi
15048,2012-09-24,1,9,4,0,1,1,1,0.44,0.4394,0.67,0.1045,0,8,8,8,4,Pagi
15049,2012-09-24,1,9,5,0,1,1,1,0.46,0.4545,0.63,0.0,2,35,37,37,4,Pagi
15050,2012-09-24,1,9,6,0,1,1,1,0.46,0.4545,0.59,0.0,6,162,168,168,4,Pagi
15051,2012-09-24,1,9,7,0,1,1,1,0.46,0.4545,0.67,0.1343,17,513,530,530,4,Siang
15052,2012-09-24,1,9,8,0,1,1,1,0.5,0.4848,0.55,0.194,31,719,750,750,4,Siang
15053,2012-09-24,1,9,9,0,1,1,1,0.52,0.5,0.52,0.194,42,286,328,328,4,Siang
15054,2012-09-24,1,9,10,0,1,1,1,0.54,0.5152,0.49,0.2239,52,146,198,198,4,Siang
15055,2012-09-24,1,9,11,0,1,1,1,0.56,0.5303,0.37,0.194,71,167,238,238,4,Siang
15056,2012-09-24,1,9,12,0,1,1,1,0.56,0.5303,0.35,0.2985,77,265,342,342,4,Siang
15057,2012-09-24,1,9,13,0,1,1,1,0.6,0.6212,0.31,0.2985,80,248,328,328,4,Sore
15058,2012-09-24,1,9,14,0,1,1,1,0.6,0.6061,0.28,0.0,77,226,303,303,4,Sore
15059,2012-09-24,1,9,15,0,1,1,1,0.6,0.6212,0.31,0.0,84,216,300,300,4,Sore
15060,2012-09-24,1,9,16,0,1,1,1,0.58,0.5455,0.3,0.2537,99,417,516,516,4,Sore
15061,2012-09-24,1,9,17,0,1,1,1,0.58,0.5455,0.3,0.0,89,809,898,898,4,Sore
15062,2012-09-24,1,9,18,0,1,1,1,0.54,0.5152,0.37,0.1642,95,758,853,853,4,Sore
15063,2012-09-24,1,9,19,0,1,1,1,0.52,0.5,0.39,0.1343,56,534,590,590,4,Malam
15064,2012-09-24,1,9,20,0,1,1,1,0.52,0.5,0.52,0.1045,52,380,432,432,4,Malam
15065,2012-09-24,1,9,21,0,1,1,1,0.5,0.4848,0.51,0.1343,26,230,256,256,4,Malam
15066,2012-09-24,1,9,22,0,1,1,1,0.5,0.4848,0.51,0.2239,18,154,172,172,4,Malam
15067,2012-09-24,1,9,23,0,1,1,1,0.46,0.4545,0.63,0.1343,11,83,94,94,4,Malam
15068,2012-09-25,1,9,0,0,2,1,1,0.46,0.4545,0.67,0.1642,8,56,64,64,4,
15069,2012-09-25,1,9,1,0,2,1,1,0.44,0.4394,0.72,0.1343,2,11,13,13,4,Pagi
15070,2012-09-25,1,9,2,0,2,1,1,0.42,0.4242,0.77,0.1343,5,9,14,14,4,Pagi
15071,2012-09-25,1,9,3,0,2,1,1,0.42,0.4242,0.71,0.0896,2,3,5,5,4,Pagi
15072,2012-09-25,1,9,4,0,2,1,1,0.42,0.4242,0.71,0.1343,2,7,9,9,4,Pagi
15073,2012-09-25,1,9,5,0,2,1,1,0.42,0.4242,0.77,0.0896,1,46,47,47,4,Pagi
15074,2012-09-25,1,9,6,0,2,1,1,0.44,0.4394,0.77,0.2239,5,189,194,194,4,Pagi
15075,2012-09-25,1,9,7,0,2,1,1,0.44,0.4394,0.77,0.194,17,539,556,556,4,Siang
15076,2012-09-25,1,9,8,0,2,1,1,0.48,0.4697,0.67,0.194,41,764,805,805,4,Siang
15077,2012-09-25,1,9,9,0,2,1,1,0.54,0.5152,0.56,0.2537,28,381,409,409,4,Siang
15078,2012-09-25,1,9,10,0,2,1,1,0.56,0.5303,0.52,0.2985,45,125,170,170,4,Siang
15079,2012-09-25,1,9,11,0,2,1,1,0.6,0.6212,0.46,0.2985,63,155,218,218,4,Siang
15080,2012-09-25,1,9,12,0,2,1,1,0.62,0.6212,0.43,0.2836,69,233,302,302,4,Siang
15081,2012-09-25,1,9,13,0,2,1,1,0.64,0.6212,0.47,0.2537,48,257,305,305,4,Sore
15082,2012-09-25,1,9,14,0,2,1,1,0.66,0.6212,0.39,0.3284,80,213,293,293,4,Sore
15083,2012-09-25,1,9,15,0,2,1,1,0.66,0.6212,0.36,0.3284,56,247,303,303,4,Sore
15084,2012-09-25,1,9,16,0,2,1,1,0.66,0.6212,0.39,0.2985,59,436,495,495,4,Sore
15085,2012-09-25,1,9,17,0,2,1,1,0.66,0.6212,0.39,0.2836,107,860,967,967,4,Sore
15086,2012-09-25,1,9,18,0,2,1,1,0.64,0.6212,0.41,0.2239,64,758,822,822,4,Sore
15087,2012-09-25,1,9,19,0,2,1,1,0.62,0.6212,0.5,0.2537,49,490,539,539,4,Malam
15088,2012-09-25,1,9,20,0,2,1,1,0.6,0.6212,0.56,0.2985,37,388,425,425,4,Malam
15089,2012-09-25,1,9,21,0,2,1,1,0.6,0.6212,0.56,0.2985,34,263,297,297,4,Malam
15090,2012-09-25,1,9,22,0,2,1,1,0.6,0.6212,0.56,0.2836,14,174,188,188,4,Malam
15091,2012-09-25,1,9,23,0,2,1,1,0.6,0.6212,0.56,0.3284,9,89,98,98,4,Malam
15092,2012-09-26,1,9,0,0,3,1,1,0.58,0.5455,0.64,0.2985,6,34,40,40,4,
15093,2012-09-26,1,9,1,0,3,1,1,0.58,0.5455,0.64,0.3284,10,19,29,29,4,Pagi
15094,2012-09-26,1,9,2,0,3,1,2,0.58,0.5455,0.64,0.2836,2,15,17,17,4,Pagi
15095,2012-09-26,1,9,3,0,3,1,2,0.58,0.5455,0.64,0.2836,4,6,10,10,4,Pagi
15096,2012-09-26,1,9,4,0,3,1,1,0.56,0.5303,0.73,0.2537,2,12,14,14,4,Pagi
15097,2012-09-26,1,9,5,0,3,1,1,0.56,0.5303,0.73,0.2239,1,35,36,36,4,Pagi
15098,2012-09-26,1,9,6,0,3,1,1,0.54,0.5152,0.73,0.194,3,179,182,182,4,Pagi
15099,2012-09-26,1,9,7,0,3,1,1,0.54,0.5152,0.77,0.1343,9,523,532,532,4,Siang
15100,2012-09-26,1,9,8,0,3,1,1,0.56,0.5303,0.73,0.2985,30,808,838,838,4,Siang
15101,2012-09-26,1,9,9,0,3,1,1,0.6,0.6061,0.64,0.194,27,307,334,334,4,Siang
15102,2012-09-26,1,9,10,0,3,1,1,0.6,0.5909,0.73,0.2836,29,156,185,185,4,Siang
15103,2012-09-26,1,9,11,0,3,1,1,0.64,0.6212,0.61,0.2537,46,181,227,227,4,Siang
15104,2012-09-26,1,9,12,0,3,1,1,0.68,0.6364,0.61,0.2239,56,260,316,316,4,Siang
15105,2012-09-26,1,9,13,0,3,1,1,0.7,0.6515,0.58,0.2239,67,273,340,340,4,Sore
15106,2012-09-26,1,9,14,0,3,1,1,0.74,0.6667,0.48,0.2836,60,217,277,277,4,Sore
15107,2012-09-26,1,9,15,0,3,1,1,0.74,0.6667,0.48,0.2985,69,231,300,300,4,Sore
15108,2012-09-26,1,9,16,0,3,1,1,0.74,0.6667,0.45,0.2836,71,397,468,468,4,Sore
15109,2012-09-26,1,9,17,0,3,1,1,0.74,0.6667,0.48,0.2985,77,876,953,953,4,Sore
15110,2012-09-26,1,9,18,0,3,1,1,0.74,0.6667,0.48,0.2239,69,815,884,884,4,Sore
15111,2012-09-26,1,9,19,0,3,1,1,0.7,0.6515,0.54,0.1642,38,589,627,627,4,Malam
15112,2012-09-26,1,9,20,0,3,1,1,0.66,0.6212,0.69,0.194,45,389,434,434,4,Malam
15113,2012-09-26,1,9,21,0,3,1,1,0.66,0.6212,0.65,0.194,32,328,360,360,4,Malam
15114,2012-09-26,1,9,22,0,3,1,3,0.62,0.6061,0.69,0.194,21,194,215,215,4,Malam
15115,2012-09-26,1,9,23,0,3,1,2,0.6,0.5758,0.78,0.2537,13,102,115,115,4,Malam
15116,2012-09-27,1,9,0,0,4,1,1,0.6,0.5758,0.78,0.0896,5,60,65,65,4,
15117,2012-09-27,1,9,1,0,4,1,1,0.6,0.5758,0.78,0.0896,5,16,21,21,4,Pagi
15118,2012-09-27,1,9,2,0,4,1,1,0.6,0.5758,0.78,0.0896,3,13,16,16,4,Pagi
15119,2012-09-27,1,9,3,0,4,1,1,0.6,0.5758,0.78,0.0,0,7,7,7,4,Pagi
15120,2012-09-27,1,9,4,0,4,1,1,0.56,0.5303,0.94,0.1343,2,6,8,8,4,Pagi
15121,2012-09-27,1,9,5,0,4,1,1,0.58,0.5455,0.83,0.0,2,64,66,66,4,Pagi
15122,2012-09-27,1,9,6,0,4,1,1,0.56,0.5303,0.88,0.0896,5,164,169,169,4,Pagi
15123,2012-09-27,1,9,7,0,4,1,1,0.6,0.5758,0.78,0.0,12,546,558,558,4,Siang
15124,2012-09-27,1,9,8,0,4,1,1,0.62,0.6061,0.71,0.0896,20,774,794,794,4,Siang
15125,2012-09-27,1,9,9,0,4,1,1,0.66,0.6212,0.65,0.0,30,305,335,335,4,Siang
15126,2012-09-27,1,9,10,0,4,1,2,0.7,0.6515,0.51,0.2836,40,168,208,208,4,Siang
15127,2012-09-27,1,9,11,0,4,1,2,0.72,0.6667,0.51,0.1642,67,227,294,294,4,Siang
15128,2012-09-27,1,9,12,0,4,1,2,0.74,0.6667,0.48,0.1343,63,272,335,335,4,Siang
15129,2012-09-27,1,9,13,0,4,1,2,0.74,0.6667,0.48,0.0,61,265,326,326,4,Sore
15130,2012-09-27,1,9,14,0,4,1,2,0.76,0.6818,0.45,0.0896,44,214,258,258,4,Sore
15131,2012-09-27,1,9,15,0,4,1,2,0.76,0.6818,0.45,0.0,41,255,296,296,4,Sore
15132,2012-09-27,1,9,16,0,4,1,2,0.72,0.6667,0.58,0.3284,73,399,472,472,4,Sore
15133,2012-09-27,1,9,17,0,4,1,2,0.66,0.6212,0.69,0.2985,87,818,905,905,4,Sore
15134,2012-09-27,1,9,18,0,4,1,2,0.66,0.6212,0.69,0.2239,77,822,899,899,4,Sore
15135,2012-09-27,1,9,19,0,4,1,1,0.66,0.6212,0.65,0.1343,48,511,559,559,4,Malam
15136,2012-09-27,1,9,20,0,4,1,2,0.64,0.6061,0.69,0.2239,45,412,457,457,4,Malam
15137,2012-09-27,1,9,21,0,4,1,3,0.62,0.5758,0.83,0.2985,18,235,253,253,4,Malam
15138,2012-09-27,1,9,22,0,4,1,3,0.62,0.5758,0.83,0.2985,2,45,47,47,4,Malam
15139,2012-09-27,1,9,23,0,4,1,3,0.62,0.5758,0.83,0.1642,1,44,45,45,4,Malam
15140,2012-09-28,1,9,0,0,5,1,3,0.6,0.5455,0.88,0.1642,2,15,17,17,4,
15141,2012-09-28,1,9,1,0,5,1,3,0.6,0.5455,0.88,0.0,0,13,13,13,4,Pagi
15142,2012-09-28,1,9,2,0,5,1,3,0.6,0.5455,0.88,0.2985,1,9,10,10,4,Pagi
15143,2012-09-28,1,9,3,0,5,1,2,0.6,0.5606,0.83,0.1343,0,7,7,7,4,Pagi
15144,2012-09-28,1,9,4,0,5,1,3,0.56,0.5303,0.88,0.1045,2,10,12,12,4,Pagi
15145,2012-09-28,1,9,5,0,5,1,1,0.56,0.5303,0.88,0.0,1,37,38,38,4,Pagi
15146,2012-09-28,1,9,6,0,5,1,2,0.56,0.5303,0.94,0.0896,2,136,138,138,4,Pagi
15147,2012-09-28,1,9,7,0,5,1,2,0.56,0.5303,0.94,0.0,10,384,394,394,4,Siang
15148,2012-09-28,1,9,8,0,5,1,1,0.6,0.5606,0.83,0.0896,31,674,705,705,4,Siang
15149,2012-09-28,1,9,9,0,5,1,2,0.62,0.5758,0.83,0.1045,27,399,426,426,4,Siang
15150,2012-09-28,1,9,10,0,5,1,2,0.64,0.5909,0.78,0.1343,51,194,245,245,4,Siang
15151,2012-09-28,1,9,11,0,5,1,2,0.66,0.6212,0.69,0.0,109,252,361,361,4,Siang
15152,2012-09-28,1,9,12,0,5,1,2,0.7,0.6515,0.54,0.2537,94,286,380,380,4,Siang
15153,2012-09-28,1,9,13,0,5,1,2,0.7,0.6515,0.51,0.2537,106,304,410,410,4,Sore
15154,2012-09-28,1,9,14,0,5,1,2,0.7,0.6515,0.54,0.2537,105,294,399,399,4,Sore
15155,2012-09-28,1,9,15,0,5,1,2,0.68,0.6364,0.54,0.2836,104,288,392,392,4,Sore
15156,2012-09-28,1,9,16,0,5,1,2,0.66,0.6212,0.5,0.2239,83,419,502,502,4,Sore
15157,2012-09-28,1,9,17,0,5,1,2,0.66,0.6212,0.54,0.2985,101,707,808,808,4,Sore
15158,2012-09-28,1,9,18,0,5,1,2,0.64,0.6212,0.5,0.2239,58,609,667,667,4,Sore
15159,2012-09-28,1,9,19,0,5,1,3,0.62,0.6212,0.5,0.2537,38,470,508,508,4,Malam
15160,2012-09-28,1,9,20,0,5,1,3,0.6,0.6212,0.53,0.1642,32,304,336,336,4,Malam
15161,2012-09-28,1,9,21,0,5,1,3,0.6,0.6212,0.53,0.194,32,205,237,237,4,Malam
15162,2012-09-28,1,9,22,0,5,1,2,0.58,0.5455,0.53,0.2239,30,190,220,220,4,Malam
15163,2012-09-28,1,9,23,0,5,1,2,0.56,0.5303,0.56,0.194,26,164,190,190,4,Malam
15164,2012-09-29,1,9,0,0,6,0,1,0.54,0.5152,0.6,0.2239,15,134,149,149,4,
15165,2012-09-29,1,9,1,0,6,0,1,0.54,0.5152,0.6,0.2239,12,89,101,101,4,Pagi
15166,2012-09-29,1,9,2,0,6,0,2,0.54,0.5152,0.56,0.2239,12,80,92,92,4,Pagi
15167,2012-09-29,1,9,3,0,6,0,2,0.52,0.5,0.59,0.194,4,25,29,29,4,Pagi
15168,2012-09-29,1,9,4,0,6,0,1,0.52,0.5,0.59,0.2537,6,8,14,14,4,Pagi
15169,2012-09-29,1,9,5,0,6,0,1,0.5,0.4848,0.63,0.194,2,13,15,15,4,Pagi
15170,2012-09-29,1,9,6,0,6,0,1,0.5,0.4848,0.63,0.2537,4,33,37,37,4,Pagi
15171,2012-09-29,1,9,7,0,6,0,1,0.48,0.4697,0.67,0.2836,12,61,73,73,4,Siang
15172,2012-09-29,1,9,8,0,6,0,1,0.5,0.4848,0.68,0.2836,37,174,211,211,4,Siang
15173,2012-09-29,1,9,9,0,6,0,1,0.5,0.4848,0.63,0.194,69,263,332,332,4,Siang
15174,2012-09-29,1,9,10,0,6,0,1,0.54,0.5152,0.56,0.2537,134,338,472,472,4,Siang
15175,2012-09-29,1,9,11,0,6,0,1,0.56,0.5303,0.52,0.2836,217,446,663,663,4,Siang
15176,2012-09-29,1,9,12,0,6,0,1,0.62,0.6212,0.41,0.2985,191,491,682,682,4,Siang
15177,2012-09-29,1,9,13,0,6,0,1,0.62,0.6212,0.41,0.2985,233,453,686,686,4,Sore
15178,2012-09-29,1,9,14,0,6,0,1,0.6,0.6212,0.4,0.2537,302,448,750,750,4,Sore
15179,2012-09-29,1,9,15,0,6,0,1,0.6,0.6212,0.43,0.2537,271,456,727,727,4,Sore
15180,2012-09-29,1,9,16,0,6,0,1,0.62,0.6212,0.41,0.2537,275,447,722,722,4,Sore
15181,2012-09-29,1,9,17,0,6,0,1,0.6,0.6212,0.38,0.3582,256,456,712,712,4,Sore
15182,2012-09-29,1,9,18,0,6,0,1,0.56,0.5303,0.46,0.194,174,420,594,594,4,Sore
15183,2012-09-29,1,9,19,0,6,0,1,0.52,0.5,0.55,0.1642,119,351,470,470,4,Malam
15184,2012-09-29,1,9,20,0,6,0,1,0.52,0.5,0.55,0.194,88,227,315,315,4,Malam
15185,2012-09-29,1,9,21,0,6,0,1,0.52,0.5,0.55,0.1343,73,219,292,292,4,Malam
15186,2012-09-29,1,9,22,0,6,0,1,0.5,0.4848,0.63,0.1045,48,173,221,221,4,Malam
15187,2012-09-29,1,9,23,0,6,0,1,0.5,0.4848,0.59,0.0896,35,161,196,196,4,Malam
15188,2012-09-30,1,9,0,0,0,0,1,0.5,0.4848,0.59,0.0,35,112,147,147,4,
15189,2012-09-30,1,9,1,0,0,0,1,0.5,0.4848,0.59,0.0,31,85,116,116,4,Pagi
15190,2012-09-30,1,9,2,0,0,0,1,0.48,0.4697,0.63,0.0,21,71,92,92,4,Pagi
15191,2012-09-30,1,9,3,0,0,0,1,0.46,0.4545,0.67,0.0896,17,41,58,58,4,Pagi
15192,2012-09-30,1,9,4,0,0,0,1,0.46,0.4545,0.67,0.0896,1,6,7,7,4,Pagi
15193,2012-09-30,1,9,5,0,0,0,1,0.44,0.4394,0.72,0.0,1,9,10,10,4,Pagi
15194,2012-09-30,1,9,6,0,0,0,1,0.44,0.4394,0.72,0.0896,2,20,22,22,4,Pagi
15195,2012-09-30,1,9,7,0,0,0,1,0.44,0.4394,0.77,0.0,14,43,57,57,4,Siang
15196,2012-09-30,1,9,8,0,0,0,1,0.48,0.4697,0.67,0.1045,18,126,144,144,4,Siang
15197,2012-09-30,1,9,9,0,0,0,1,0.52,0.5,0.63,0.1045,74,211,285,285,4,Siang
15198,2012-09-30,1,9,10,0,0,0,1,0.58,0.5455,0.46,0.1642,160,319,479,479,4,Siang
15199,2012-09-30,1,9,11,0,0,0,1,0.6,0.6212,0.43,0.2239,222,369,591,591,4,Siang
15200,2012-09-30,1,9,12,0,0,0,1,0.62,0.6212,0.41,0.2985,206,474,680,680,4,Siang
15201,2012-09-30,1,9,13,0,0,0,1,0.62,0.6212,0.41,0.2537,180,414,594,594,4,Sore
15202,2012-09-30,1,9,14,0,0,0,1,0.62,0.6212,0.41,0.2537,208,404,612,612,4,Sore
15203,2012-09-30,1,9,15,0,0,0,1,0.64,0.6212,0.36,0.2537,230,419,649,649,4,Sore
15204,2012-09-30,1,9,16,0,0,0,1,0.64,0.6212,0.36,0.2239,202,446,648,648,4,Sore
15205,2012-09-30,1,9,17,0,0,0,1,0.62,0.6212,0.35,0.2836,195,380,575,575,4,Sore
15206,2012-09-30,1,9,18,0,0,0,1,0.52,0.5,0.59,0.4478,91,310,401,401,4,Sore
15207,2012-09-30,1,9,19,0,0,0,3,0.5,0.4848,0.72,0.1343,34,223,257,257,4,Malam
15208,2012-09-30,1,9,20,0,0,0,3,0.5,0.4848,0.72,0.1343,31,163,194,194,4,Malam
15209,2012-09-30,1,9,21,0,0,0,1,0.5,0.4848,0.68,0.0,19,104,123,123,4,Malam
15210,2012-09-30,1,9,22,0,0,0,1,0.48,0.4697,0.72,0.0,15,76,91,91,4,Malam
15211,2012-09-30,1,9,23,0,0,0,1,0.48,0.4697,0.72,0.0896,8,49,57,57,4,Malam
15212,2012-10-01,1,10,0,0,1,1,1,0.46,0.4545,0.72,0.1045,6,39,45,45,4,
15213,2012-10-01,1,10,1,0,1,1,1,0.44,0.4394,0.77,0.0896,5,13,18,18,4,Pagi
15214,2012-10-01,1,10,2,0,1,1,1,0.46,0.4545,0.72,0.0,6,6,12,12,4,Pagi
15215,2012-10-01,1,10,3,0,1,1,1,0.44,0.4394,0.77,0.0,1,6,7,7,4,Pagi
15216,2012-10-01,1,10,4,0,1,1,1,0.42,0.4242,0.82,0.1045,0,10,10,10,4,Pagi
15217,2012-10-01,1,10,5,0,1,1,1,0.44,0.4394,0.77,0.0,2,34,36,36,4,Pagi
15218,2012-10-01,1,10,6,0,1,1,1,0.44,0.4394,0.77,0.1045,8,147,155,155,4,Pagi
15219,2012-10-01,1,10,7,0,1,1,1,0.44,0.4394,0.77,0.1642,13,470,483,483,4,Siang
15220,2012-10-01,1,10,8,0,1,1,2,0.46,0.4545,0.77,0.1045,40,744,784,784,4,Siang
15221,2012-10-01,1,10,9,0,1,1,2,0.52,0.5,0.63,0.0,26,314,340,340,4,Siang
15222,2012-10-01,1,10,10,0,1,1,1,0.54,0.5152,0.56,0.0,44,135,179,179,4,Siang
15223,2012-10-01,1,10,11,0,1,1,1,0.58,0.5455,0.46,0.0,76,196,272,272,4,Siang
15224,2012-10-01,1,10,12,0,1,1,2,0.6,0.6212,0.43,0.1642,61,262,323,323,4,Siang
15225,2012-10-01,1,10,13,0,1,1,2,0.6,0.6212,0.43,0.1642,80,225,305,305,4,Sore
15226,2012-10-01,1,10,14,0,1,1,2,0.6,0.6212,0.43,0.1045,51,193,244,244,4,Sore
15227,2012-10-01,1,10,15,0,1,1,2,0.62,0.6212,0.43,0.1343,95,234,329,329,4,Sore
15228,2012-10-01,1,10,16,0,1,1,2,0.62,0.6212,0.46,0.2537,51,408,459,459,4,Sore
15229,2012-10-01,1,10,17,0,1,1,3,0.56,0.5303,0.6,0.2537,65,791,856,856,4,Sore
15230,2012-10-01,1,10,18,0,1,1,3,0.56,0.5303,0.64,0.1045,42,571,613,613,4,Sore
15231,2012-10-01,1,10,19,0,1,1,2,0.54,0.5152,0.68,0.1045,33,483,516,516,4,Malam
15232,2012-10-01,1,10,20,0,1,1,3,0.54,0.5152,0.68,0.0,11,251,262,262,4,Malam
15233,2012-10-01,1,10,21,0,1,1,2,0.54,0.5152,0.73,0.1343,13,205,218,218,4,Malam
15234,2012-10-01,1,10,22,0,1,1,3,0.54,0.5152,0.77,0.0896,17,190,207,207,4,Malam
15235,2012-10-01,1,10,23,0,1,1,3,0.54,0.5152,0.77,0.0,17,88,105,105,4,Malam
15236,2012-10-02,1,10,0,0,2,1,2,0.56,0.5303,0.73,0.0,1,30,31,31,4,
15237,2012-10-02,1,10,1,0,2,1,2,0.54,0.5152,0.77,0.1045,0,11,11,11,4,Pagi
15238,2012-10-02,1,10,2,0,2,1,2,0.54,0.5152,0.77,0.1045,0,2,2,2,4,Pagi
15239,2012-10-02,1,10,3,0,2,1,2,0.54,0.5152,0.88,0.194,1,4,5,5,4,Pagi
15240,2012-10-02,1,10,4,0,2,1,2,0.56,0.5303,0.83,0.0896,2,8,10,10,4,Pagi
15241,2012-10-02,1,10,5,0,2,1,2,0.56,0.5303,0.83,0.1343,1,42,43,43,4,Pagi
15242,2012-10-02,1,10,6,0,2,1,3,0.58,0.5455,0.83,0.1045,3,176,179,179,4,Pagi
15243,2012-10-02,1,10,7,0,2,1,3,0.58,0.5455,0.83,0.1045,4,256,260,260,4,Siang
15244,2012-10-02,1,10,8,0,2,1,3,0.6,0.5455,0.88,0.0,6,128,134,134,4,Siang
15245,2012-10-02,1,10,9,0,2,1,3,0.58,0.5455,0.88,0.1343,3,83,86,86,4,Siang
15246,2012-10-02,1,10,10,0,2,1,3,0.58,0.5455,0.88,0.1343,3,42,45,45,4,Siang
15247,2012-10-02,1,10,11,0,2,1,3,0.58,0.5455,0.94,0.1343,7,92,99,99,4,Siang
15248,2012-10-02,1,10,12,0,2,1,2,0.6,0.5455,0.88,0.194,6,98,104,104,4,Siang
15249,2012-10-02,1,10,13,0,2,1,2,0.6,0.5455,0.88,0.1343,6,148,154,154,4,Sore
15250,2012-10-02,1,10,14,0,2,1,3,0.6,0.5455,0.88,0.1343,16,147,163,163,4,Sore
15251,2012-10-02,1,10,15,0,2,1,3,0.62,0.5758,0.83,0.1343,14,195,209,209,4,Sore
15252,2012-10-02,1,10,16,0,2,1,3,0.62,0.5606,0.88,0.1343,46,328,374,374,4,Sore
15253,2012-10-02,1,10,17,0,2,1,3,0.62,0.5606,0.88,0.1045,38,677,715,715,4,Sore
15254,2012-10-02,1,10,18,0,2,1,3,0.62,0.5455,0.94,0.0896,48,639,687,687,4,Sore
15255,2012-10-02,1,10,19,0,2,1,3,0.62,0.5455,0.94,0.0,27,368,395,395,4,Malam
15256,2012-10-02,1,10,20,0,2,1,3,0.62,0.5455,0.94,0.1343,20,286,306,306,4,Malam
15257,2012-10-02,1,10,21,0,2,1,3,0.62,0.5455,0.94,0.1045,24,265,289,289,4,Malam
15258,2012-10-02,1,10,22,0,2,1,2,0.62,0.5455,0.94,0.1045,28,212,240,240,4,Malam
15259,2012-10-02,1,10,23,0,2,1,2,0.62,0.5455,0.94,0.0,11,87,98,98,4,Malam
15260,2012-10-03,1,10,0,0,3,1,3,0.62,0.5455,0.94,0.0,5,47,52,52,4,
15261,2012-10-03,1,10,1,0,3,1,2,0.62,0.5455,0.94,0.0,3,16,19,19,4,Pagi
15262,2012-10-03,1,10,2,0,3,1,2,0.62,0.5455,0.94,0.0,2,7,9,9,4,Pagi
15263,2012-10-03,1,10,3,0,3,1,2,0.6,0.5152,0.94,0.0,0,7,7,7,4,Pagi
15264,2012-10-03,1,10,4,0,3,1,2,0.6,0.5,1.0,0.0,2,9,11,11,4,Pagi
15265,2012-10-03,1,10,5,0,3,1,2,0.62,0.5455,0.94,0.1045,2,32,34,34,4,Pagi
15266,2012-10-03,1,10,6,0,3,1,2,0.6,0.5152,0.94,0.1343,4,173,177,177,4,Pagi
15267,2012-10-03,1,10,7,0,3,1,2,0.6,0.5152,0.94,0.194,11,504,515,515,4,Siang
15268,2012-10-03,1,10,8,0,3,1,2,0.62,0.5606,0.88,0.1045,28,781,809,809,4,Siang
15269,2012-10-03,1,10,9,0,3,1,2,0.62,0.5758,0.83,0.194,30,332,362,362,4,Siang
15270,2012-10-03,1,10,10,0,3,1,1,0.66,0.6061,0.78,0.1642,29,146,175,175,4,Siang
15271,2012-10-03,1,10,11,0,3,1,1,0.66,0.6061,0.78,0.1642,52,178,230,230,4,Siang
15272,2012-10-03,1,10,12,0,3,1,2,0.7,0.6515,0.7,0.1045,69,289,358,358,4,Siang
15273,2012-10-03,1,10,13,0,3,1,2,0.7,0.6667,0.74,0.1045,55,224,279,279,4,Sore
15274,2012-10-03,1,10,14,0,3,1,2,0.72,0.6818,0.7,0.1642,56,195,251,251,4,Sore
15275,2012-10-03,1,10,15,0,3,1,2,0.72,0.6818,0.62,0.1642,59,260,319,319,4,Sore
15276,2012-10-03,1,10,16,0,3,1,2,0.72,0.6667,0.58,0.0,42,436,478,478,4,Sore
15277,2012-10-03,1,10,17,0,3,1,1,0.7,0.6515,0.65,0.0,84,833,917,917,4,Sore
15278,2012-10-03,1,10,18,0,3,1,1,0.7,0.6515,0.65,0.0,54,756,810,810,4,Sore
15279,2012-10-03,1,10,19,0,3,1,1,0.7,0.6515,0.65,0.0,49,544,593,593,4,Malam
15280,2012-10-03,1,10,20,0,3,1,1,0.7,0.6515,0.65,0.0,48,449,497,497,4,Malam
15281,2012-10-03,1,10,21,0,3,1,2,0.66,0.6212,0.74,0.0,14,195,209,209,4,Malam
15282,2012-10-03,1,10,22,0,3,1,1,0.66,0.6212,0.74,0.0,9,232,241,241,4,Malam
15283,2012-10-03,1,10,23,0,3,1,2,0.66,0.6061,0.78,0.0,21,199,220,220,4,Malam
15284,2012-10-04,1,10,0,0,4,1,3,0.64,0.5758,0.89,0.0,11,65,76,76,4,
15285,2012-10-04,1,10,1,0,4,1,2,0.62,0.5455,0.94,0.0,2,23,25,25,4,Pagi
15286,2012-10-04,1,10,2,0,4,1,1,0.64,0.5758,0.89,0.0,3,10,13,13,4,Pagi
15287,2012-10-04,1,10,3,0,4,1,2,0.62,0.5606,0.88,0.0,5,6,11,11,4,Pagi
15288,2012-10-04,1,10,4,0,4,1,2,0.64,0.5758,0.89,0.0,0,10,10,10,4,Pagi
15289,2012-10-04,1,10,5,0,4,1,3,0.64,0.5758,0.89,0.1045,2,37,39,39,4,Pagi
15290,2012-10-04,1,10,6,0,4,1,3,0.62,0.5455,0.94,0.0896,1,132,133,133,4,Pagi
15291,2012-10-04,1,10,7,0,4,1,2,0.64,0.5758,0.89,0.0896,12,379,391,391,4,Siang
15292,2012-10-04,1,10,8,0,4,1,1,0.64,0.5758,0.89,0.0,27,711,738,738,4,Siang
15293,2012-10-04,1,10,9,0,4,1,2,0.64,0.5758,0.89,0.194,40,319,359,359,4,Siang
15294,2012-10-04,1,10,10,0,4,1,2,0.66,0.6061,0.83,0.1343,27,150,177,177,4,Siang
15295,2012-10-04,1,10,11,0,4,1,2,0.7,0.6515,0.7,0.1045,38,176,214,214,4,Siang
15296,2012-10-04,1,10,12,0,4,1,2,0.72,0.6667,0.54,0.194,57,231,288,288,4,Siang
15297,2012-10-04,1,10,13,0,4,1,2,0.72,0.6667,0.58,0.3284,63,231,294,294,4,Sore
15298,2012-10-04,1,10,14,0,4,1,1,0.7,0.6515,0.61,0.2537,56,211,267,267,4,Sore
15299,2012-10-04,1,10,15,0,4,1,1,0.72,0.6667,0.54,0.2836,77,248,325,325,4,Sore
15300,2012-10-04,1,10,16,0,4,1,1,0.7,0.6515,0.54,0.2836,86,411,497,497,4,Sore
15301,2012-10-04,1,10,17,0,4,1,1,0.7,0.6515,0.51,0.2239,112,789,901,901,4,Sore
15302,2012-10-04,1,10,18,0,4,1,1,0.66,0.6212,0.57,0.1045,75,812,887,887,4,Sore
15303,2012-10-04,1,10,19,0,4,1,1,0.66,0.6212,0.57,0.1045,67,467,534,534,4,Malam
15304,2012-10-04,1,10,20,0,4,1,1,0.64,0.6061,0.65,0.1045,50,391,441,441,4,Malam
15305,2012-10-04,1,10,21,0,4,1,1,0.62,0.6061,0.69,0.0,33,288,321,321,4,Malam
15306,2012-10-04,1,10,22,0,4,1,1,0.64,0.6212,0.47,0.1343,29,203,232,232,4,Malam
15307,2012-10-04,1,10,23,0,4,1,1,0.6,0.6212,0.56,0.0896,18,137,155,155,4,Malam
15308,2012-10-05,1,10,0,0,5,1,1,0.56,0.5303,0.73,0.0,16,86,102,102,4,
15309,2012-10-05,1,10,1,0,5,1,1,0.54,0.5152,0.68,0.1045,3,43,46,46,4,Pagi
15310,2012-10-05,1,10,2,0,5,1,1,0.54,0.5152,0.73,0.0896,1,10,11,11,4,Pagi
15311,2012-10-05,1,10,3,0,5,1,1,0.54,0.5152,0.73,0.0,5,11,16,16,4,Pagi
15312,2012-10-05,1,10,4,0,5,1,1,0.54,0.5152,0.77,0.0,0,11,11,11,4,Pagi
15313,2012-10-05,1,10,5,0,5,1,1,0.52,0.5,0.77,0.0,0,41,41,41,4,Pagi
15314,2012-10-05,1,10,6,0,5,1,1,0.52,0.5,0.83,0.0,4,133,137,137,4,Pagi
15315,2012-10-05,1,10,7,0,5,1,1,0.52,0.5,0.83,0.1045,11,417,428,428,4,Siang
15316,2012-10-05,1,10,8,0,5,1,1,0.58,0.5455,0.64,0.0,36,749,785,785,4,Siang
15317,2012-10-05,1,10,9,0,5,1,1,0.6,0.6061,0.6,0.0896,58,326,384,384,4,Siang
15318,2012-10-05,1,10,10,0,5,1,1,0.66,0.6212,0.54,0.0,68,192,260,260,4,Siang
15319,2012-10-05,1,10,11,0,5,1,1,0.7,0.6515,0.48,0.194,90,214,304,304,4,Siang
15320,2012-10-05,1,10,12,0,5,1,1,0.72,0.6515,0.42,0.1642,161,307,468,468,4,Siang
15321,2012-10-05,1,10,13,0,5,1,1,0.7,0.6515,0.48,0.0,117,307,424,424,4,Sore
15322,2012-10-05,1,10,14,0,5,1,1,0.74,0.6515,0.37,0.2239,113,287,400,400,4,Sore
15323,2012-10-05,1,10,15,0,5,1,1,0.72,0.6515,0.39,0.2537,150,320,470,470,4,Sore
15324,2012-10-05,1,10,16,0,5,1,1,0.72,0.6515,0.37,0.0,153,481,634,634,4,Sore
15325,2012-10-05,1,10,17,0,5,1,1,0.7,0.6364,0.42,0.1642,158,742,900,900,4,Sore
15326,2012-10-05,1,10,18,0,5,1,1,0.64,0.6212,0.57,0.1343,106,655,761,761,4,Sore
15327,2012-10-05,1,10,19,0,5,1,1,0.62,0.5909,0.73,0.1642,67,433,500,500,4,Malam
15328,2012-10-05,1,10,20,0,5,1,1,0.6,0.5758,0.78,0.1343,66,306,372,372,4,Malam
15329,2012-10-05,1,10,21,0,5,1,1,0.6,0.5909,0.69,0.2239,47,220,267,267,4,Malam
15330,2012-10-05,1,10,22,0,5,1,1,0.6,0.5909,0.73,0.2836,63,201,264,264,4,Malam
15331,2012-10-05,1,10,23,0,5,1,1,0.58,0.5455,0.78,0.2239,23,148,171,171,4,Malam
15332,2012-10-06,1,10,0,0,6,0,1,0.56,0.5303,0.83,0.1642,37,154,191,191,4,
15333,2012-10-06,1,10,1,0,6,0,1,0.56,0.5303,0.83,0.2537,25,116,141,141,4,Pagi
15334,2012-10-06,1,10,2,0,6,0,1,0.56,0.5303,0.78,0.194,13,62,75,75,4,Pagi
15335,2012-10-06,1,10,3,0,6,0,1,0.54,0.5152,0.77,0.2239,2,54,56,56,4,Pagi
15336,2012-10-06,1,10,4,0,6,0,1,0.54,0.5152,0.83,0.2537,4,7,11,11,4,Pagi
15337,2012-10-06,1,10,5,0,6,0,1,0.54,0.5152,0.83,0.194,2,8,10,10,4,Pagi
15338,2012-10-06,1,10,6,0,6,0,1,0.54,0.5152,0.88,0.2537,2,28,30,30,4,Pagi
15339,2012-10-06,1,10,7,0,6,0,1,0.54,0.5152,0.83,0.2985,13,71,84,84,4,Siang
15340,2012-10-06,1,10,8,0,6,0,1,0.56,0.5303,0.83,0.194,22,184,206,206,4,Siang
15341,2012-10-06,1,10,9,0,6,0,1,0.6,0.5909,0.73,0.194,130,265,395,395,4,Siang
15342,2012-10-06,1,10,10,0,6,0,1,0.62,0.6061,0.69,0.2836,198,341,539,539,4,Siang
15343,2012-10-06,1,10,11,0,6,0,1,0.64,0.6061,0.65,0.2537,258,389,647,647,4,Siang
15344,2012-10-06,1,10,12,0,6,0,1,0.7,0.6515,0.54,0.1045,362,381,743,743,4,Siang
15345,2012-10-06,1,10,13,0,6,0,2,0.64,0.6212,0.57,0.5224,310,400,710,710,4,Sore
15346,2012-10-06,1,10,14,0,6,0,2,0.6,0.6212,0.56,0.4179,269,307,576,576,4,Sore
15347,2012-10-06,1,10,15,0,6,0,1,0.6,0.6212,0.46,0.4179,279,341,620,620,4,Sore
15348,2012-10-06,1,10,16,0,6,0,1,0.6,0.6212,0.43,0.5224,317,342,659,659,4,Sore
15349,2012-10-06,1,10,17,0,6,0,1,0.54,0.5152,0.49,0.3881,268,342,610,610,4,Sore
15350,2012-10-06,1,10,18,0,6,0,1,0.52,0.5,0.48,0.4179,183,312,495,495,4,Sore
15351,2012-10-06,1,10,19,0,6,0,1,0.48,0.4697,0.55,0.2239,102,239,341,341,4,Malam
15352,2012-10-06,1,10,20,0,6,0,1,0.48,0.4697,0.55,0.2537,75,172,247,247,4,Malam
15353,2012-10-06,1,10,21,0,6,0,1,0.46,0.4545,0.59,0.1343,78,137,215,215,4,Malam
15354,2012-10-06,1,10,22,0,6,0,1,0.44,0.4394,0.62,0.1343,45,140,185,185,4,Malam
15355,2012-10-06,1,10,23,0,6,0,1,0.44,0.4394,0.62,0.1343,37,142,179,179,4,Malam
15356,2012-10-07,1,10,0,0,0,0,1,0.44,0.4394,0.62,0.1642,28,99,127,127,4,
15357,2012-10-07,1,10,1,0,0,0,1,0.44,0.4394,0.54,0.2239,29,80,109,109,4,Pagi
15358,2012-10-07,1,10,2,0,0,0,1,0.42,0.4242,0.62,0.1343,10,64,74,74,4,Pagi
15359,2012-10-07,1,10,3,0,0,0,2,0.44,0.4394,0.62,0.1343,5,17,22,22,4,Pagi
15360,2012-10-07,1,10,4,0,0,0,2,0.44,0.4394,0.54,0.2537,5,6,11,11,4,Pagi
15361,2012-10-07,1,10,5,0,0,0,2,0.44,0.4394,0.54,0.1343,2,8,10,10,4,Pagi
15362,2012-10-07,1,10,6,0,0,0,2,0.44,0.4394,0.54,0.194,4,19,23,23,4,Pagi
15363,2012-10-07,1,10,7,0,0,0,3,0.42,0.4242,0.58,0.1642,6,29,35,35,4,Siang
15364,2012-10-07,1,10,8,0,0,0,3,0.42,0.4242,0.67,0.1343,11,51,62,62,4,Siang
15365,2012-10-07,1,10,9,0,0,0,3,0.4,0.4091,0.71,0.1343,16,70,86,86,4,Siang
15366,2012-10-07,1,10,10,0,0,0,2,0.42,0.4242,0.67,0.194,41,144,185,185,4,Siang
15367,2012-10-07,1,10,11,0,0,0,2,0.42,0.4242,0.71,0.1045,76,260,336,336,4,Siang
15368,2012-10-07,1,10,12,0,0,0,2,0.42,0.4242,0.71,0.0,100,292,392,392,4,Siang
15369,2012-10-07,1,10,13,0,0,0,2,0.44,0.4394,0.72,0.0896,80,240,320,320,4,Sore
15370,2012-10-07,1,10,14,0,0,0,2,0.44,0.4394,0.67,0.0,71,243,314,314,4,Sore
15371,2012-10-07,1,10,15,0,0,0,3,0.42,0.4242,0.77,0.1343,74,232,306,306,4,Sore
15372,2012-10-07,1,10,16,0,0,0,3,0.4,0.4091,0.82,0.1642,87,246,333,333,4,Sore
15373,2012-10-07,1,10,17,0,0,0,3,0.4,0.4091,0.82,0.2239,35,122,157,157,4,Sore
15374,2012-10-07,1,10,18,0,0,0,3,0.4,0.4091,0.82,0.194,24,82,106,106,4,Sore
15375,2012-10-07,1,10,19,0,0,0,2,0.4,0.4091,0.82,0.1045,17,97,114,114,4,Malam
15376,2012-10-07,1,10,20,0,0,0,1,0.4,0.4091,0.82,0.1343,19,97,116,116,4,Malam
15377,2012-10-07,1,10,21,0,0,0,1,0.38,0.3939,0.87,0.1045,22,91,113,113,4,Malam
15378,2012-10-07,1,10,22,0,0,0,1,0.38,0.3939,0.87,0.1343,7,72,79,79,4,Malam
15379,2012-10-07,1,10,23,0,0,0,1,0.36,0.3485,0.93,0.1343,12,68,80,80,4,Malam
15380,2012-10-08,1,10,0,1,1,0,1,0.38,0.3939,0.76,0.2836,7,44,51,51,4,
15381,2012-10-08,1,10,1,1,1,0,1,0.34,0.3333,0.87,0.1642,2,35,37,37,4,Pagi
15382,2012-10-08,1,10,2,1,1,0,1,0.34,0.3333,0.81,0.194,3,12,15,15,4,Pagi
15383,2012-10-08,1,10,3,1,1,0,1,0.34,0.3485,0.81,0.1045,2,8,10,10,4,Pagi
15384,2012-10-08,1,10,4,1,1,0,1,0.32,0.3333,0.87,0.1343,1,6,7,7,4,Pagi
15385,2012-10-08,1,10,5,1,1,0,1,0.34,0.3182,0.76,0.2239,2,17,19,19,4,Pagi
15386,2012-10-08,1,10,6,1,1,0,1,0.34,0.3485,0.76,0.1045,5,54,59,59,4,Pagi
15387,2012-10-08,1,10,7,1,1,0,2,0.34,0.3333,0.76,0.1642,3,151,154,154,4,Siang
15388,2012-10-08,1,10,8,1,1,0,2,0.36,0.3485,0.71,0.2239,23,374,397,397,4,Siang
15389,2012-10-08,1,10,9,1,1,0,2,0.38,0.3939,0.66,0.1642,59,273,332,332,4,Siang
15390,2012-10-08,1,10,10,1,1,0,2,0.38,0.3939,0.68,0.1343,69,229,298,298,4,Siang
15391,2012-10-08,1,10,11,1,1,0,2,0.4,0.4091,0.62,0.0896,72,236,308,308,4,Siang
15392,2012-10-08,1,10,12,1,1,0,2,0.42,0.4242,0.63,0.1642,74,267,341,341,4,Siang
15393,2012-10-08,1,10,13,1,1,0,2,0.42,0.4242,0.62,0.194,82,323,405,405,4,Sore
15394,2012-10-08,1,10,14,1,1,0,2,0.42,0.4242,0.58,0.1045,121,299,420,420,4,Sore
15395,2012-10-08,1,10,15,1,1,0,3,0.42,0.4242,0.58,0.194,76,294,370,370,4,Sore
15396,2012-10-08,1,10,16,1,1,0,3,0.42,0.4242,0.58,0.194,61,316,377,377,4,Sore
15397,2012-10-08,1,10,17,1,1,0,2,0.42,0.4242,0.66,0.2537,81,416,497,497,4,Sore
15398,2012-10-08,1,10,18,1,1,0,2,0.42,0.4242,0.66,0.2836,41,415,456,456,4,Sore
15399,2012-10-08,1,10,19,1,1,0,2,0.4,0.4091,0.71,0.2537,38,333,371,371,4,Malam
15400,2012-10-08,1,10,20,1,1,0,3,0.4,0.4091,0.71,0.2239,20,207,227,227,4,Malam
15401,2012-10-08,1,10,21,1,1,0,2,0.4,0.4091,0.76,0.2239,17,134,151,151,4,Malam
15402,2012-10-08,1,10,22,1,1,0,3,0.4,0.4091,0.76,0.2537,6,101,107,107,4,Malam
15403,2012-10-08,1,10,23,1,1,0,2,0.4,0.4091,0.71,0.2239,9,60,69,69,4,Malam
15404,2012-10-09,1,10,0,0,2,1,2,0.38,0.3939,0.82,0.2239,9,22,31,31,4,
15405,2012-10-09,1,10,1,0,2,1,3,0.36,0.3485,0.87,0.2239,0,13,13,13,4,Pagi
15406,2012-10-09,1,10,2,0,2,1,3,0.36,0.3333,0.87,0.2537,2,5,7,7,4,Pagi
15407,2012-10-09,1,10,3,0,2,1,3,0.36,0.3333,0.87,0.2836,0,3,3,3,4,Pagi
15408,2012-10-09,1,10,4,0,2,1,3,0.36,0.3485,0.87,0.1642,1,6,7,7,4,Pagi
15409,2012-10-09,1,10,5,0,2,1,2,0.38,0.3939,0.82,0.194,0,19,19,19,4,Pagi
15410,2012-10-09,1,10,6,0,2,1,2,0.38,0.3939,0.82,0.2537,2,141,143,143,4,Pagi
15411,2012-10-09,1,10,7,0,2,1,1,0.38,0.3939,0.83,0.2537,5,357,362,362,4,Siang
15412,2012-10-09,1,10,8,0,2,1,2,0.42,0.4242,0.8,0.194,15,698,713,713,4,Siang
15413,2012-10-09,1,10,9,0,2,1,2,0.42,0.4242,0.77,0.2239,37,345,382,382,4,Siang
15414,2012-10-09,1,10,10,0,2,1,2,0.44,0.4394,0.75,0.2239,33,131,164,164,4,Siang
15415,2012-10-09,1,10,11,0,2,1,2,0.48,0.4697,0.69,0.194,37,156,193,193,4,Siang
15416,2012-10-09,1,10,12,0,2,1,2,0.48,0.4697,0.69,0.194,43,217,260,260,4,Siang
15417,2012-10-09,1,10,13,0,2,1,2,0.5,0.4848,0.67,0.1343,54,184,238,238,4,Sore
15418,2012-10-09,1,10,14,0,2,1,2,0.54,0.5152,0.64,0.194,43,201,244,244,4,Sore
15419,2012-10-09,1,10,15,0,2,1,2,0.52,0.5,0.63,0.1642,59,195,254,254,4,Sore
15420,2012-10-09,1,10,16,0,2,1,2,0.5,0.4848,0.72,0.1642,70,354,424,424,4,Sore
15421,2012-10-09,1,10,17,0,2,1,2,0.52,0.5,0.68,0.1642,73,733,806,806,4,Sore
15422,2012-10-09,1,10,18,0,2,1,2,0.5,0.4848,0.72,0.2239,26,758,784,784,4,Sore
15423,2012-10-09,1,10,19,0,2,1,2,0.5,0.4848,0.72,0.1642,31,483,514,514,4,Malam
15424,2012-10-09,1,10,20,0,2,1,2,0.5,0.4848,0.72,0.1642,30,330,360,360,4,Malam
15425,2012-10-09,1,10,21,0,2,1,2,0.48,0.4697,0.77,0.1343,16,209,225,225,4,Malam
15426,2012-10-09,1,10,22,0,2,1,2,0.48,0.4697,0.77,0.0896,7,155,162,162,4,Malam
15427,2012-10-09,1,10,23,0,2,1,2,0.48,0.4697,0.77,0.0896,8,76,84,84,4,Malam
15428,2012-10-10,1,10,0,0,3,1,2,0.46,0.4545,0.88,0.0896,0,33,33,33,4,
15429,2012-10-10,1,10,1,0,3,1,2,0.46,0.4545,0.88,0.0,2,6,8,8,4,Pagi
15430,2012-10-10,1,10,2,0,3,1,2,0.46,0.4545,0.88,0.0,2,6,8,8,4,Pagi
15431,2012-10-10,1,10,3,0,3,1,2,0.46,0.4545,0.88,0.0,0,6,6,6,4,Pagi
15432,2012-10-10,1,10,4,0,3,1,2,0.46,0.4545,0.88,0.1045,0,6,6,6,4,Pagi
15433,2012-10-10,1,10,5,0,3,1,2,0.46,0.4545,0.88,0.0896,2,38,40,40,4,Pagi
15434,2012-10-10,1,10,6,0,3,1,2,0.46,0.4545,0.88,0.0896,3,172,175,175,4,Pagi
15435,2012-10-10,1,10,7,0,3,1,1,0.46,0.4545,0.82,0.1045,9,498,507,507,4,Siang
15436,2012-10-10,1,10,8,0,3,1,1,0.5,0.4848,0.77,0.1642,33,806,839,839,4,Siang
15437,2012-10-10,1,10,9,0,3,1,1,0.54,0.5152,0.6,0.2836,35,331,366,366,4,Siang
15438,2012-10-10,1,10,10,0,3,1,1,0.56,0.5303,0.52,0.2985,27,190,217,217,4,Siang
15439,2012-10-10,1,10,11,0,3,1,1,0.54,0.5152,0.52,0.194,53,238,291,291,4,Siang
15440,2012-10-10,1,10,12,0,3,1,1,0.54,0.5152,0.56,0.2239,78,312,390,390,4,Siang
15441,2012-10-10,1,10,13,0,3,1,1,0.56,0.5303,0.49,0.0,60,237,297,297,4,Sore
15442,2012-10-10,1,10,14,0,3,1,1,0.6,0.6212,0.4,0.1642,63,208,271,271,4,Sore
15443,2012-10-10,1,10,15,0,3,1,1,0.6,0.6212,0.4,0.1642,58,261,319,319,4,Sore
15444,2012-10-10,1,10,16,0,3,1,1,0.6,0.6212,0.4,0.2239,92,474,566,566,4,Sore
15445,2012-10-10,1,10,17,0,3,1,1,0.58,0.5455,0.43,0.2239,91,857,948,948,4,Sore
15446,2012-10-10,1,10,18,0,3,1,2,0.56,0.5303,0.49,0.1642,57,787,844,844,4,Sore
15447,2012-10-10,1,10,19,0,3,1,2,0.56,0.5303,0.46,0.5821,32,534,566,566,4,Malam
15448,2012-10-10,1,10,20,0,3,1,1,0.52,0.5,0.48,0.4925,21,371,392,392,4,Malam
15449,2012-10-10,1,10,21,0,3,1,1,0.5,0.4848,0.51,0.3582,18,251,269,269,4,Malam
15450,2012-10-10,1,10,22,0,3,1,1,0.46,0.4545,0.55,0.2985,27,170,197,197,4,Malam
15451,2012-10-10,1,10,23,0,3,1,1,0.44,0.4394,0.58,0.194,17,119,136,136,4,Malam
15452,2012-10-11,1,10,0,0,4,1,1,0.44,0.4394,0.51,0.1343,1,41,42,42,4,
15453,2012-10-11,1,10,1,0,4,1,1,0.44,0.4394,0.47,0.194,1,10,11,11,4,Pagi
15454,2012-10-11,1,10,2,0,4,1,1,0.42,0.4242,0.5,0.1343,4,7,11,11,4,Pagi
15455,2012-10-11,1,10,3,0,4,1,1,0.42,0.4242,0.47,0.2985,0,3,3,3,4,Pagi
15456,2012-10-11,1,10,4,0,4,1,1,0.4,0.4091,0.5,0.2537,0,10,10,10,4,Pagi
15457,2012-10-11,1,10,5,0,4,1,1,0.36,0.3485,0.5,0.1642,0,42,42,42,4,Pagi
15458,2012-10-11,1,10,6,0,4,1,1,0.36,0.3485,0.5,0.1642,1,158,159,159,4,Pagi
15459,2012-10-11,1,10,7,0,4,1,1,0.36,0.3333,0.5,0.2537,11,467,478,478,4,Siang
15460,2012-10-11,1,10,8,0,4,1,1,0.38,0.3939,0.46,0.3881,25,773,798,798,4,Siang
15461,2012-10-11,1,10,9,0,4,1,1,0.4,0.4091,0.43,0.3881,27,328,355,355,4,Siang
15462,2012-10-11,1,10,10,0,4,1,1,0.44,0.4394,0.41,0.3582,39,165,204,204,4,Siang
15463,2012-10-11,1,10,11,0,4,1,1,0.46,0.4545,0.36,0.0,76,175,251,251,4,Siang
15464,2012-10-11,1,10,12,0,4,1,1,0.46,0.4545,0.36,0.0,47,279,326,326,4,Siang
15465,2012-10-11,1,10,13,0,4,1,1,0.5,0.4848,0.31,0.1045,48,243,291,291,4,Sore
15466,2012-10-11,1,10,14,0,4,1,1,0.52,0.5,0.32,0.0896,78,270,348,348,4,Sore
15467,2012-10-11,1,10,15,0,4,1,1,0.52,0.5,0.34,0.1642,102,358,460,460,4,Sore
15468,2012-10-11,1,10,16,0,4,1,1,0.5,0.4848,0.36,0.1343,68,413,481,481,4,Sore
15469,2012-10-11,1,10,17,0,4,1,1,0.5,0.4848,0.39,0.2836,90,737,827,827,4,Sore
15470,2012-10-11,1,10,18,0,4,1,1,0.46,0.4545,0.44,0.1642,64,628,692,692,4,Sore
15471,2012-10-11,1,10,19,0,4,1,1,0.44,0.4394,0.51,0.1343,81,662,743,743,4,Malam
15472,2012-10-11,1,10,20,0,4,1,1,0.42,0.4242,0.62,0.1642,27,388,415,415,4,Malam
15473,2012-10-11,1,10,21,0,4,1,1,0.42,0.4242,0.62,0.1343,24,236,260,260,4,Malam
15474,2012-10-11,1,10,22,0,4,1,1,0.4,0.4091,0.66,0.1642,10,167,177,177,4,Malam
15475,2012-10-11,1,10,23,0,4,1,1,0.42,0.4242,0.58,0.0896,10,176,186,186,4,Malam
15476,2012-10-12,1,10,0,0,5,1,1,0.4,0.4091,0.66,0.1045,8,60,68,68,4,
15477,2012-10-12,1,10,1,0,5,1,1,0.4,0.4091,0.66,0.0896,8,29,37,37,4,Pagi
15478,2012-10-12,1,10,2,0,5,1,1,0.4,0.4091,0.66,0.0896,0,16,16,16,4,Pagi
15479,2012-10-12,1,10,3,0,5,1,1,0.36,0.3636,0.76,0.0896,0,6,6,6,4,Pagi
15480,2012-10-12,1,10,4,0,5,1,1,0.36,0.3636,0.76,0.1045,0,8,8,8,4,Pagi
15481,2012-10-12,1,10,5,0,5,1,1,0.36,0.3636,0.81,0.0896,2,33,35,35,4,Pagi
15482,2012-10-12,1,10,6,0,5,1,1,0.34,0.3485,0.81,0.0896,3,140,143,143,4,Pagi
15483,2012-10-12,1,10,7,0,5,1,1,0.36,0.3636,0.81,0.0896,8,384,392,392,4,Siang
15484,2012-10-12,1,10,8,0,5,1,1,0.42,0.4242,0.71,0.0896,34,711,745,745,4,Siang
15485,2012-10-12,1,10,9,0,5,1,1,0.5,0.4848,0.39,0.2985,26,374,400,400,4,Siang
15486,2012-10-12,1,10,10,0,5,1,1,0.52,0.5,0.36,0.2985,75,200,275,275,4,Siang
15487,2012-10-12,1,10,11,0,5,1,1,0.54,0.5152,0.37,0.3582,61,252,313,313,4,Siang
15488,2012-10-12,1,10,12,0,5,1,1,0.54,0.5152,0.39,0.4627,75,312,387,387,4,Siang
15489,2012-10-12,1,10,13,0,5,1,1,0.56,0.5303,0.37,0.3881,81,300,381,381,4,Sore
15490,2012-10-12,1,10,14,0,5,1,1,0.56,0.5303,0.37,0.4627,109,262,371,371,4,Sore
15491,2012-10-12,1,10,15,0,5,1,1,0.52,0.5,0.42,0.4478,138,317,455,455,4,Sore
15492,2012-10-12,1,10,16,0,5,1,1,0.46,0.4545,0.41,0.3582,108,412,520,520,4,Sore
15493,2012-10-12,1,10,17,0,5,1,1,0.46,0.4545,0.38,0.3881,131,706,837,837,4,Sore
15494,2012-10-12,1,10,18,0,5,1,1,0.44,0.4394,0.38,0.2985,76,566,642,642,4,Sore
15495,2012-10-12,1,10,19,0,5,1,1,0.42,0.4242,0.41,0.2239,40,453,493,493,4,Malam
15496,2012-10-12,1,10,20,0,5,1,1,0.42,0.4242,0.47,0.1343,28,280,308,308,4,Malam
15497,2012-10-12,1,10,21,0,5,1,1,0.4,0.4091,0.54,0.194,21,169,190,190,4,Malam
15498,2012-10-12,1,10,22,0,5,1,1,0.4,0.4091,0.47,0.2985,17,143,160,160,4,Malam
15499,2012-10-12,1,10,23,0,5,1,1,0.36,0.3485,0.57,0.194,11,89,100,100,4,Malam
15500,2012-10-13,1,10,0,0,6,0,1,0.36,0.3636,0.57,0.0896,31,218,249,249,4,
15501,2012-10-13,1,10,1,0,6,0,1,0.34,0.3333,0.53,0.1343,23,123,146,146,4,Pagi
15502,2012-10-13,1,10,2,0,6,0,1,0.34,0.3333,0.53,0.194,7,60,67,67,4,Pagi
15503,2012-10-13,1,10,3,0,6,0,1,0.32,0.303,0.66,0.2239,2,13,15,15,4,Pagi
15504,2012-10-13,1,10,4,0,6,0,1,0.3,0.303,0.65,0.1642,2,9,11,11,4,Pagi
15505,2012-10-13,1,10,5,0,6,0,1,0.3,0.2879,0.61,0.194,0,11,11,11,4,Pagi
15506,2012-10-13,1,10,6,0,6,0,1,0.3,0.2879,0.61,0.194,5,23,28,28,4,Pagi
15507,2012-10-13,1,10,7,0,6,0,1,0.3,0.303,0.61,0.1642,10,60,70,70,4,Siang
15508,2012-10-13,1,10,8,0,6,0,1,0.34,0.3485,0.53,0.1045,23,151,174,174,4,Siang
15509,2012-10-13,1,10,9,0,6,0,1,0.36,0.3636,0.5,0.0896,46,220,266,266,4,Siang
15510,2012-10-13,1,10,10,0,6,0,1,0.4,0.4091,0.43,0.0,82,265,347,347,4,Siang
15511,2012-10-13,1,10,11,0,6,0,1,0.42,0.4242,0.35,0.1343,192,335,527,527,4,Siang
15512,2012-10-13,1,10,12,0,6,0,1,0.44,0.4394,0.35,0.0,202,371,573,573,4,Siang
15513,2012-10-13,1,10,13,0,6,0,1,0.46,0.4545,0.36,0.194,235,435,670,670,4,Sore
15514,2012-10-13,1,10,14,0,6,0,1,0.48,0.4697,0.33,0.194,243,354,597,597,4,Sore
15515,2012-10-13,1,10,15,0,6,0,1,0.5,0.4848,0.36,0.194,251,364,615,615,4,Sore
15516,2012-10-13,1,10,16,0,6,0,1,0.5,0.4848,0.31,0.194,294,343,637,637,4,Sore
15517,2012-10-13,1,10,17,0,6,0,1,0.46,0.4545,0.38,0.1642,193,335,528,528,4,Sore
15518,2012-10-13,1,10,18,0,6,0,1,0.46,0.4545,0.44,0.1343,174,299,473,473,4,Sore
15519,2012-10-13,1,10,19,0,6,0,1,0.44,0.4394,0.44,0.1642,73,259,332,332,4,Malam
15520,2012-10-13,1,10,20,0,6,0,1,0.4,0.4091,0.54,0.0896,57,198,255,255,4,Malam
15521,2012-10-13,1,10,21,0,6,0,1,0.4,0.4091,0.58,0.194,47,157,204,204,4,Malam
15522,2012-10-13,1,10,22,0,6,0,1,0.4,0.4091,0.62,0.0,33,156,189,189,4,Malam
15523,2012-10-13,1,10,23,0,6,0,1,0.42,0.4242,0.58,0.2985,27,98,125,125,4,Malam
15524,2012-10-14,1,10,0,0,0,0,1,0.4,0.4091,0.71,0.2537,8,103,111,111,4,
15525,2012-10-14,1,10,1,0,0,0,1,0.42,0.4242,0.77,0.2836,16,96,112,112,4,Pagi
15526,2012-10-14,1,10,2,0,0,0,1,0.4,0.4091,0.76,0.0896,8,58,66,66,4,Pagi
15527,2012-10-14,1,10,3,0,0,0,1,0.42,0.4242,0.77,0.2985,3,25,28,28,4,Pagi
15528,2012-10-14,1,10,4,0,0,0,1,0.42,0.4242,0.77,0.2836,2,10,12,12,4,Pagi
15529,2012-10-14,1,10,5,0,0,0,1,0.4,0.4091,0.82,0.194,5,6,11,11,4,Pagi
15530,2012-10-14,1,10,6,0,0,0,1,0.4,0.4091,0.82,0.1642,4,20,24,24,4,Pagi
15531,2012-10-14,1,10,7,0,0,0,1,0.42,0.4242,0.82,0.2239,7,44,51,51,4,Siang
15532,2012-10-14,1,10,8,0,0,0,1,0.44,0.4394,0.77,0.194,28,104,132,132,4,Siang
15533,2012-10-14,1,10,9,0,0,0,2,0.48,0.4697,0.67,0.2836,62,161,223,223,4,Siang
15534,2012-10-14,1,10,10,0,0,0,1,0.54,0.5152,0.56,0.194,150,278,428,428,4,Siang
15535,2012-10-14,1,10,11,0,0,0,1,0.56,0.5303,0.52,0.2985,156,338,494,494,4,Siang
15536,2012-10-14,1,10,12,0,0,0,1,0.62,0.6212,0.46,0.3284,200,362,562,562,4,Siang
15537,2012-10-14,1,10,13,0,0,0,1,0.64,0.6212,0.41,0.4478,218,401,619,619,4,Sore
15538,2012-10-14,1,10,14,0,0,0,1,0.66,0.6212,0.39,0.4179,249,368,617,617,4,Sore
15539,2012-10-14,1,10,15,0,0,0,1,0.66,0.6212,0.39,0.4179,213,355,568,568,4,Sore
15540,2012-10-14,1,10,16,0,0,0,1,0.64,0.6212,0.41,0.2985,203,378,581,581,4,Sore
15541,2012-10-14,1,10,17,0,0,0,1,0.64,0.6212,0.44,0.194,193,346,539,539,4,Sore
15542,2012-10-14,1,10,18,0,0,0,1,0.58,0.5455,0.6,0.2537,134,319,453,453,4,Sore
15543,2012-10-14,1,10,19,0,0,0,1,0.56,0.5303,0.64,0.2239,68,268,336,336,4,Malam
15544,2012-10-14,1,10,20,0,0,0,1,0.54,0.5152,0.73,0.2239,48,198,246,246,4,Malam
15545,2012-10-14,1,10,21,0,0,0,1,0.56,0.5303,0.73,0.4478,40,156,196,196,4,Malam
15546,2012-10-14,1,10,22,0,0,0,1,0.56,0.5303,0.73,0.3881,38,87,125,125,4,Malam
15547,2012-10-14,1,10,23,0,0,0,2,0.56,0.5303,0.68,0.2836,27,78,105,105,4,Malam
15548,2012-10-15,1,10,0,0,1,1,2,0.56,0.5303,0.73,0.2537,17,31,48,48,4,
15549,2012-10-15,1,10,1,0,1,1,2,0.58,0.5455,0.64,0.3881,5,24,29,29,4,Pagi
15550,2012-10-15,1,10,2,0,1,1,2,0.58,0.5455,0.64,0.3582,1,5,6,6,4,Pagi
15551,2012-10-15,1,10,3,0,1,1,2,0.56,0.5303,0.73,0.2537,2,2,4,4,4,Pagi
15552,2012-10-15,1,10,4,0,1,1,2,0.56,0.5303,0.68,0.2239,1,9,10,10,4,Pagi
15553,2012-10-15,1,10,5,0,1,1,2,0.56,0.5303,0.73,0.2836,2,38,40,40,4,Pagi
15554,2012-10-15,1,10,6,0,1,1,2,0.56,0.5303,0.73,0.2985,6,141,147,147,4,Pagi
15555,2012-10-15,1,10,7,0,1,1,2,0.58,0.5455,0.68,0.3284,15,461,476,476,4,Siang
15556,2012-10-15,1,10,8,0,1,1,2,0.6,0.6061,0.64,0.3881,24,713,737,737,4,Siang
15557,2012-10-15,1,10,9,0,1,1,3,0.6,0.5909,0.69,0.3881,31,328,359,359,4,Siang
15558,2012-10-15,1,10,10,0,1,1,2,0.6,0.5909,0.73,0.3881,43,125,168,168,4,Siang
15559,2012-10-15,1,10,11,0,1,1,2,0.6,0.5909,0.73,0.3881,88,175,263,263,4,Siang
15560,2012-10-15,1,10,12,0,1,1,3,0.6,0.5758,0.78,0.3284,73,211,284,284,4,Siang
15561,2012-10-15,1,10,13,0,1,1,2,0.56,0.5303,0.88,0.2239,37,109,146,146,4,Sore
15562,2012-10-15,1,10,14,0,1,1,2,0.6,0.5758,0.78,0.2836,57,128,185,185,4,Sore
15563,2012-10-15,1,10,15,0,1,1,1,0.6,0.5758,0.78,0.3284,70,190,260,260,4,Sore
15564,2012-10-15,1,10,16,0,1,1,1,0.56,0.5303,0.64,0.2985,76,371,447,447,4,Sore
15565,2012-10-15,1,10,17,0,1,1,1,0.56,0.5303,0.64,0.2537,96,670,766,766,4,Sore
15566,2012-10-15,1,10,18,0,1,1,3,0.54,0.5152,0.77,0.1343,52,540,592,592,4,Sore
15567,2012-10-15,1,10,19,0,1,1,3,0.52,0.5,0.83,0.0896,12,227,239,239,4,Malam
15568,2012-10-15,1,10,20,0,1,1,2,0.52,0.5,0.72,0.3881,19,237,256,256,4,Malam
15569,2012-10-15,1,10,21,0,1,1,1,0.52,0.5,0.59,0.3284,16,190,206,206,4,Malam
15570,2012-10-15,1,10,22,0,1,1,1,0.5,0.4848,0.59,0.2836,8,118,126,126,4,Malam
15571,2012-10-15,1,10,23,0,1,1,1,0.46,0.4545,0.63,0.2239,9,72,81,81,4,Malam
15572,2012-10-16,1,10,0,0,2,1,1,0.46,0.4545,0.63,0.3881,3,45,48,48,4,
15573,2012-10-16,1,10,1,0,2,1,1,0.44,0.4394,0.67,0.194,4,9,13,13,4,Pagi
15574,2012-10-16,1,10,2,0,2,1,1,0.44,0.4394,0.67,0.1343,2,1,3,3,4,Pagi
15575,2012-10-16,1,10,3,0,2,1,1,0.42,0.4242,0.67,0.1045,0,2,2,2,4,Pagi
15576,2012-10-16,1,10,4,0,2,1,1,0.42,0.4242,0.67,0.1642,0,7,7,7,4,Pagi
15577,2012-10-16,1,10,5,0,2,1,1,0.42,0.4242,0.67,0.2537,5,47,52,52,4,Pagi
15578,2012-10-16,1,10,6,0,2,1,1,0.42,0.4242,0.67,0.1642,4,168,172,172,4,Pagi
15579,2012-10-16,1,10,7,0,2,1,1,0.42,0.4242,0.67,0.0896,20,505,525,525,4,Siang
15580,2012-10-16,1,10,8,0,2,1,1,0.44,0.4394,0.62,0.0,35,800,835,835,4,Siang
15581,2012-10-16,1,10,9,0,2,1,1,0.48,0.4697,0.55,0.2537,32,323,355,355,4,Siang
15582,2012-10-16,1,10,10,0,2,1,1,0.5,0.4848,0.48,0.2836,65,157,222,222,4,Siang
15583,2012-10-16,1,10,11,0,2,1,1,0.5,0.4848,0.45,0.4179,56,172,228,228,4,Siang
15584,2012-10-16,1,10,12,0,2,1,2,0.52,0.5,0.45,0.3284,69,256,325,325,4,Siang
15585,2012-10-16,1,10,13,0,2,1,1,0.52,0.5,0.45,0.2836,68,260,328,328,4,Sore
15586,2012-10-16,1,10,14,0,2,1,1,0.54,0.5152,0.39,0.2537,94,214,308,308,4,Sore
15587,2012-10-16,1,10,15,0,2,1,1,0.54,0.5152,0.41,0.3284,76,270,346,346,4,Sore
15588,2012-10-16,1,10,16,0,2,1,1,0.54,0.5152,0.39,0.2836,79,367,446,446,4,Sore
15589,2012-10-16,1,10,17,0,2,1,1,0.52,0.5,0.39,0.194,104,839,943,943,4,Sore
15590,2012-10-16,1,10,18,0,2,1,1,0.5,0.4848,0.42,0.1642,71,767,838,838,4,Sore
15591,2012-10-16,1,10,19,0,2,1,1,0.48,0.4697,0.48,0.0,40,491,531,531,4,Malam
15592,2012-10-16,1,10,20,0,2,1,1,0.46,0.4545,0.55,0.0,35,397,432,432,4,Malam
15593,2012-10-16,1,10,21,0,2,1,1,0.46,0.4545,0.63,0.0,19,176,195,195,4,Malam
15594,2012-10-16,1,10,22,0,2,1,1,0.4,0.4091,0.71,0.0896,18,163,181,181,4,Malam
15595,2012-10-16,1,10,23,0,2,1,1,0.4,0.4091,0.71,0.0,23,176,199,199,4,Malam
15596,2012-10-17,1,10,0,0,3,1,1,0.38,0.3939,0.76,0.0,1,48,49,49,4,
15597,2012-10-17,1,10,1,0,3,1,1,0.38,0.3939,0.76,0.0,3,14,17,17,4,Pagi
15598,2012-10-17,1,10,2,0,3,1,1,0.38,0.3939,0.76,0.0,4,12,16,16,4,Pagi
15599,2012-10-17,1,10,3,0,3,1,1,0.36,0.3788,0.87,0.0,0,7,7,7,4,Pagi
15600,2012-10-17,1,10,4,0,3,1,1,0.36,0.3636,0.81,0.0896,0,4,4,4,4,Pagi
15601,2012-10-17,1,10,5,0,3,1,2,0.36,0.3788,0.81,0.0,2,39,41,41,4,Pagi
15602,2012-10-17,1,10,6,0,3,1,1,0.38,0.3939,0.82,0.0,7,171,178,178,4,Pagi
15603,2012-10-17,1,10,7,0,3,1,1,0.36,0.3636,0.81,0.1045,15,449,464,464,4,Siang
15604,2012-10-17,1,10,8,0,3,1,2,0.4,0.4091,0.76,0.0,38,779,817,817,4,Siang
15605,2012-10-17,1,10,9,0,3,1,2,0.42,0.4242,0.77,0.0,38,344,382,382,4,Siang
15606,2012-10-17,1,10,10,0,3,1,2,0.46,0.4545,0.67,0.0,60,168,228,228,4,Siang
15607,2012-10-17,1,10,11,0,3,1,2,0.5,0.4848,0.51,0.0896,78,156,234,234,4,Siang
15608,2012-10-17,1,10,12,0,3,1,2,0.52,0.5,0.48,0.1642,71,261,332,332,4,Siang
15609,2012-10-17,1,10,13,0,3,1,2,0.54,0.5152,0.49,0.1343,73,237,310,310,4,Sore
15610,2012-10-17,1,10,14,0,3,1,2,0.56,0.5303,0.43,0.1642,82,188,270,270,4,Sore
15611,2012-10-17,1,10,15,0,3,1,2,0.58,0.5455,0.43,0.2239,62,239,301,301,4,Sore
15612,2012-10-17,1,10,16,0,3,1,1,0.56,0.5303,0.52,0.194,70,396,466,466,4,Sore
15613,2012-10-17,1,10,17,0,3,1,1,0.54,0.5152,0.56,0.1045,122,766,888,888,4,Sore
15614,2012-10-17,1,10,18,0,3,1,1,0.52,0.5,0.59,0.1642,90,794,884,884,4,Sore
15615,2012-10-17,1,10,19,0,3,1,1,0.5,0.4848,0.72,0.194,49,467,516,516,4,Malam
15616,2012-10-17,1,10,20,0,3,1,1,0.5,0.4848,0.72,0.1343,54,360,414,414,4,Malam
15617,2012-10-17,1,10,21,0,3,1,1,0.46,0.4545,0.82,0.194,28,301,329,329,4,Malam
15618,2012-10-17,1,10,22,0,3,1,1,0.46,0.4545,0.88,0.2537,17,198,215,215,4,Malam
15619,2012-10-17,1,10,23,0,3,1,1,0.46,0.4545,0.88,0.2239,15,84,99,99,4,Malam
15620,2012-10-18,1,10,0,0,4,1,1,0.46,0.4545,0.88,0.194,4,53,57,57,4,
15621,2012-10-18,1,10,1,0,4,1,1,0.46,0.4545,0.82,0.2239,0,14,14,14,4,Pagi
15622,2012-10-18,1,10,2,0,4,1,1,0.46,0.4545,0.82,0.194,1,13,14,14,4,Pagi
15623,2012-10-18,1,10,3,0,4,1,1,0.44,0.4394,0.88,0.2239,0,5,5,5,4,Pagi
15624,2012-10-18,1,10,4,0,4,1,1,0.44,0.4394,0.88,0.2239,0,5,5,5,4,Pagi
15625,2012-10-18,1,10,5,0,4,1,1,0.44,0.4394,0.82,0.2239,1,41,42,42,4,Pagi
15626,2012-10-18,1,10,6,0,4,1,1,0.44,0.4394,0.88,0.2985,3,150,153,153,4,Pagi
15627,2012-10-18,1,10,7,0,4,1,1,0.44,0.4394,0.88,0.2537,20,488,508,508,4,Siang
15628,2012-10-18,1,10,8,0,4,1,1,0.46,0.4545,0.82,0.2537,31,803,834,834,4,Siang
15629,2012-10-18,1,10,9,0,4,1,2,0.5,0.4848,0.77,0.1642,41,346,387,387,4,Siang
15630,2012-10-18,1,10,10,0,4,1,2,0.52,0.5,0.68,0.2239,60,158,218,218,4,Siang
15631,2012-10-18,1,10,11,0,4,1,2,0.56,0.5303,0.56,0.2239,79,189,268,268,4,Siang
15632,2012-10-18,1,10,12,0,4,1,2,0.6,0.6212,0.53,0.2537,93,284,377,377,4,Siang
15633,2012-10-18,1,10,13,0,4,1,1,0.62,0.6212,0.53,0.3582,96,236,332,332,4,Sore
15634,2012-10-18,1,10,14,0,4,1,2,0.62,0.6212,0.5,0.2985,94,191,285,285,4,Sore
15635,2012-10-18,1,10,15,0,4,1,2,0.6,0.6061,0.6,0.194,69,284,353,353,4,Sore
15636,2012-10-18,1,10,16,0,4,1,1,0.6,0.6212,0.56,0.2836,94,356,450,450,4,Sore
15637,2012-10-18,1,10,17,0,4,1,2,0.58,0.5455,0.64,0.3284,102,788,890,890,4,Sore
15638,2012-10-18,1,10,18,0,4,1,2,0.56,0.5303,0.64,0.3284,68,720,788,788,4,Sore
15639,2012-10-18,1,10,19,0,4,1,2,0.56,0.5303,0.68,0.2985,42,471,513,513,4,Malam
15640,2012-10-18,1,10,20,0,4,1,2,0.56,0.5303,0.68,0.2537,39,348,387,387,4,Malam
15641,2012-10-18,1,10,21,0,4,1,2,0.54,0.5152,0.77,0.194,38,245,283,283,4,Malam
15642,2012-10-18,1,10,22,0,4,1,2,0.54,0.5152,0.83,0.194,27,202,229,229,4,Malam
15643,2012-10-18,1,10,23,0,4,1,2,0.54,0.5152,0.83,0.0,6,111,117,117,4,Malam
15644,2012-10-19,1,10,0,0,5,1,2,0.56,0.5303,0.83,0.1045,5,51,56,56,4,
15645,2012-10-19,1,10,1,0,5,1,3,0.54,0.5152,0.88,0.0,4,12,16,16,4,Pagi
15646,2012-10-19,1,10,2,0,5,1,2,0.54,0.5152,0.88,0.0,1,9,10,10,4,Pagi
15647,2012-10-19,1,10,3,0,5,1,2,0.56,0.5303,0.83,0.0,0,5,5,5,4,Pagi
15648,2012-10-19,1,10,4,0,5,1,2,0.56,0.5303,0.83,0.0,1,5,6,6,4,Pagi
15649,2012-10-19,1,10,5,0,5,1,2,0.54,0.5152,0.88,0.0,1,35,36,36,4,Pagi
15650,2012-10-19,1,10,6,0,5,1,3,0.54,0.5152,0.94,0.1642,5,126,131,131,4,Pagi
15651,2012-10-19,1,10,7,0,5,1,3,0.54,0.5152,0.94,0.0,5,149,154,154,4,Siang
15652,2012-10-19,1,10,8,0,5,1,2,0.54,0.5152,0.94,0.1045,20,447,467,467,4,Siang
15653,2012-10-19,1,10,9,0,5,1,2,0.54,0.5152,0.94,0.1045,26,363,389,389,4,Siang
15654,2012-10-19,1,10,10,0,5,1,2,0.58,0.5455,0.88,0.194,26,198,224,224,4,Siang
15655,2012-10-19,1,10,11,0,5,1,1,0.6,0.5606,0.83,0.194,41,211,252,252,4,Siang
15656,2012-10-19,1,10,12,0,5,1,1,0.64,0.6061,0.69,0.2239,74,258,332,332,4,Siang
15657,2012-10-19,1,10,13,0,5,1,1,0.62,0.5909,0.73,0.2239,87,288,375,375,4,Sore
15658,2012-10-19,1,10,14,0,5,1,1,0.66,0.6212,0.61,0.2537,88,277,365,365,4,Sore
15659,2012-10-19,1,10,15,0,5,1,1,0.64,0.6061,0.65,0.2985,93,302,395,395,4,Sore
15660,2012-10-19,1,10,16,0,5,1,3,0.62,0.6061,0.69,0.3582,131,434,565,565,4,Sore
15661,2012-10-19,1,10,17,0,5,1,3,0.62,0.6061,0.69,0.3582,48,377,425,425,4,Sore
15662,2012-10-19,1,10,18,0,5,1,1,0.56,0.5303,0.83,0.1045,21,212,233,233,4,Sore
15663,2012-10-19,1,10,19,0,5,1,1,0.54,0.5152,0.88,0.1642,19,213,232,232,4,Malam
15664,2012-10-19,1,10,20,0,5,1,1,0.52,0.5,0.77,0.194,13,216,229,229,4,Malam
15665,2012-10-19,1,10,21,0,5,1,1,0.5,0.4848,0.77,0.0,17,189,206,206,4,Malam
15666,2012-10-19,1,10,22,0,5,1,1,0.5,0.4848,0.77,0.0896,14,176,190,190,4,Malam
15667,2012-10-19,1,10,23,0,5,1,1,0.46,0.4545,0.88,0.1045,13,118,131,131,4,Malam
15668,2012-10-20,1,10,0,0,6,0,1,0.46,0.4545,0.82,0.1343,13,110,123,123,4,
15669,2012-10-20,1,10,1,0,6,0,1,0.46,0.4545,0.72,0.1343,2,93,95,95,4,Pagi
15670,2012-10-20,1,10,2,0,6,0,1,0.44,0.4394,0.77,0.1045,9,69,78,78,4,Pagi
15671,2012-10-20,1,10,3,0,6,0,1,0.42,0.4242,0.77,0.1343,2,27,29,29,4,Pagi
15672,2012-10-20,1,10,4,0,6,0,1,0.44,0.4394,0.72,0.0,9,9,18,18,4,Pagi
15673,2012-10-20,1,10,5,0,6,0,1,0.4,0.4091,0.82,0.0,6,7,13,13,4,Pagi
15674,2012-10-20,1,10,6,0,6,0,1,0.42,0.4242,0.71,0.0,5,26,31,31,4,Pagi
15675,2012-10-20,1,10,7,0,6,0,1,0.4,0.4091,0.82,0.0,6,59,65,65,4,Siang
15676,2012-10-20,1,10,8,0,6,0,1,0.46,0.4545,0.67,0.1343,29,164,193,193,4,Siang
15677,2012-10-20,1,10,9,0,6,0,1,0.5,0.4848,0.59,0.1343,106,257,363,363,4,Siang
15678,2012-10-20,1,10,10,0,6,0,1,0.52,0.5,0.52,0.1343,111,312,423,423,4,Siang
15679,2012-10-20,1,10,11,0,6,0,1,0.54,0.5152,0.52,0.2239,204,408,612,612,4,Siang
15680,2012-10-20,1,10,12,0,6,0,1,0.56,0.5303,0.46,0.1045,267,436,703,703,4,Siang
15681,2012-10-20,1,10,13,0,6,0,1,0.56,0.5303,0.43,0.1642,273,441,714,714,4,Sore
15682,2012-10-20,1,10,14,0,6,0,1,0.56,0.5303,0.4,0.0,335,376,711,711,4,Sore
15683,2012-10-20,1,10,15,0,6,0,1,0.56,0.5303,0.43,0.0,308,403,711,711,4,Sore
15684,2012-10-20,1,10,16,0,6,0,1,0.54,0.5152,0.42,0.2836,325,366,691,691,4,Sore
15685,2012-10-20,1,10,17,0,6,0,1,0.54,0.5152,0.37,0.2239,347,384,731,731,4,Sore
15686,2012-10-20,1,10,18,0,6,0,1,0.52,0.5,0.39,0.2239,165,356,521,521,4,Sore
15687,2012-10-20,1,10,19,0,6,0,1,0.5,0.4848,0.45,0.1343,77,268,345,345,4,Malam
15688,2012-10-20,1,10,20,0,6,0,1,0.5,0.4848,0.39,0.2239,61,198,259,259,4,Malam
15689,2012-10-20,1,10,21,0,6,0,1,0.46,0.4545,0.47,0.2239,72,224,296,296,4,Malam
15690,2012-10-20,1,10,22,0,6,0,1,0.44,0.4394,0.51,0.1045,47,155,202,202,4,Malam
15691,2012-10-20,1,10,23,0,6,0,1,0.42,0.4242,0.58,0.0,27,136,163,163,4,Malam
15692,2012-10-21,1,10,0,0,0,0,1,0.44,0.4394,0.54,0.1642,35,119,154,154,4,
15693,2012-10-21,1,10,1,0,0,0,1,0.42,0.4242,0.58,0.2239,20,97,117,117,4,Pagi
15694,2012-10-21,1,10,2,0,0,0,1,0.4,0.4091,0.62,0.1642,44,88,132,132,4,Pagi
15695,2012-10-21,1,10,3,0,0,0,1,0.38,0.3939,0.66,0.0896,12,29,41,41,4,Pagi
15696,2012-10-21,1,10,4,0,0,0,1,0.36,0.3485,0.71,0.1642,8,13,21,21,4,Pagi
15697,2012-10-21,1,10,5,0,0,0,1,0.38,0.3939,0.66,0.0896,6,4,10,10,4,Pagi
15698,2012-10-21,1,10,6,0,0,0,1,0.4,0.4091,0.62,0.0,8,18,26,26,4,Pagi
15699,2012-10-21,1,10,7,0,0,0,1,0.4,0.4091,0.62,0.0,13,43,56,56,4,Siang
15700,2012-10-21,1,10,8,0,0,0,1,0.42,0.4242,0.67,0.0,39,104,143,143,4,Siang
15701,2012-10-21,1,10,9,0,0,0,1,0.46,0.4545,0.55,0.1642,77,192,269,269,4,Siang
15702,2012-10-21,1,10,10,0,0,0,1,0.5,0.4848,0.48,0.2985,167,276,443,443,4,Siang
15703,2012-10-21,1,10,11,0,0,0,1,0.52,0.5,0.44,0.3284,191,356,547,547,4,Siang
15704,2012-10-21,1,10,12,0,0,0,1,0.54,0.5152,0.39,0.3284,236,439,675,675,4,Siang
15705,2012-10-21,1,10,13,0,0,0,1,0.56,0.5303,0.37,0.2537,243,383,626,626,4,Sore
15706,2012-10-21,1,10,14,0,0,0,1,0.56,0.5303,0.35,0.194,235,405,640,640,4,Sore
15707,2012-10-21,1,10,15,0,0,0,1,0.56,0.5303,0.35,0.3284,240,383,623,623,4,Sore
15708,2012-10-21,1,10,16,0,0,0,1,0.54,0.5152,0.37,0.2239,182,409,591,591,4,Sore
15709,2012-10-21,1,10,17,0,0,0,1,0.52,0.5,0.39,0.2537,153,338,491,491,4,Sore
15710,2012-10-21,1,10,18,0,0,0,1,0.52,0.5,0.39,0.194,71,342,413,413,4,Sore
15711,2012-10-21,1,10,19,0,0,0,1,0.5,0.4848,0.42,0.1642,50,216,266,266,4,Malam
15712,2012-10-21,1,10,20,0,0,0,1,0.48,0.4697,0.44,0.194,35,160,195,195,4,Malam
15713,2012-10-21,1,10,21,0,0,0,1,0.42,0.4242,0.54,0.1642,42,124,166,166,4,Malam
15714,2012-10-21,1,10,22,0,0,0,1,0.42,0.4242,0.54,0.0,18,95,113,113,4,Malam
15715,2012-10-21,1,10,23,0,0,0,1,0.44,0.4394,0.54,0.0,7,59,66,66,4,Malam
15716,2012-10-22,1,10,0,0,1,1,1,0.4,0.4091,0.62,0.0,3,28,31,31,4,
15717,2012-10-22,1,10,1,0,1,1,1,0.4,0.4091,0.71,0.0,0,11,11,11,4,Pagi
15718,2012-10-22,1,10,2,0,1,1,1,0.38,0.3939,0.71,0.0,1,4,5,5,4,Pagi
15719,2012-10-22,1,10,3,0,1,1,1,0.4,0.4091,0.62,0.0,1,5,6,6,4,Pagi
15720,2012-10-22,1,10,4,0,1,1,1,0.38,0.3939,0.66,0.0,1,6,7,7,4,Pagi
15721,2012-10-22,1,10,5,0,1,1,1,0.38,0.3939,0.76,0.0896,2,44,46,46,4,Pagi
15722,2012-10-22,1,10,6,0,1,1,1,0.36,0.3636,0.76,0.0896,4,140,144,144,4,Pagi
15723,2012-10-22,1,10,7,0,1,1,1,0.38,0.3939,0.66,0.0896,15,437,452,452,4,Siang
15724,2012-10-22,1,10,8,0,1,1,1,0.44,0.4394,0.67,0.0,32,696,728,728,4,Siang
15725,2012-10-22,1,10,9,0,1,1,1,0.46,0.4545,0.63,0.0896,25,335,360,360,4,Siang
15726,2012-10-22,1,10,10,0,1,1,1,0.5,0.4848,0.55,0.0,51,161,212,212,4,Siang
15727,2012-10-22,1,10,11,0,1,1,1,0.56,0.5303,0.37,0.1642,63,148,211,211,4,Siang
15728,2012-10-22,1,10,12,0,1,1,1,0.58,0.5455,0.35,0.0,52,231,283,283,4,Siang
15729,2012-10-22,1,10,13,0,1,1,1,0.62,0.6212,0.29,0.1642,88,227,315,315,4,Sore
15730,2012-10-22,1,10,14,0,1,1,1,0.62,0.6061,0.27,0.194,73,209,282,282,4,Sore
15731,2012-10-22,1,10,15,0,1,1,1,0.64,0.6212,0.29,0.1642,74,222,296,296,4,Sore
15732,2012-10-22,1,10,16,0,1,1,1,0.62,0.6212,0.33,0.1642,80,444,524,524,4,Sore
15733,2012-10-22,1,10,17,0,1,1,1,0.62,0.6212,0.33,0.1045,84,838,922,922,4,Sore
15734,2012-10-22,1,10,18,0,1,1,1,0.54,0.5152,0.64,0.1045,60,726,786,786,4,Sore
15735,2012-10-22,1,10,19,0,1,1,1,0.52,0.5,0.52,0.1045,36,478,514,514,4,Malam
15736,2012-10-22,1,10,20,0,1,1,1,0.5,0.4848,0.59,0.1045,21,382,403,403,4,Malam
15737,2012-10-22,1,10,21,0,1,1,1,0.48,0.4697,0.67,0.0896,19,155,174,174,4,Malam
15738,2012-10-22,1,10,22,0,1,1,1,0.46,0.4545,0.82,0.1343,25,158,183,183,4,Malam
15739,2012-10-22,1,10,23,0,1,1,1,0.46,0.4545,0.82,0.1045,20,143,163,163,4,Malam
15740,2012-10-23,1,10,0,0,2,1,1,0.46,0.4545,0.88,0.1642,5,32,37,37,4,
15741,2012-10-23,1,10,1,0,2,1,1,0.46,0.4545,0.77,0.1642,1,16,17,17,4,Pagi
15742,2012-10-23,1,10,2,0,2,1,1,0.44,0.4394,0.88,0.1343,1,6,7,7,4,Pagi
15743,2012-10-23,1,10,3,0,2,1,1,0.44,0.4394,0.77,0.1343,0,1,1,1,4,Pagi
15744,2012-10-23,1,10,4,0,2,1,1,0.42,0.4242,0.77,0.1045,1,6,7,7,4,Pagi
15745,2012-10-23,1,10,5,0,2,1,1,0.44,0.4394,0.77,0.0896,1,49,50,50,4,Pagi
15746,2012-10-23,1,10,6,0,2,1,1,0.4,0.4091,0.82,0.0896,6,152,158,158,4,Pagi
15747,2012-10-23,1,10,7,0,2,1,2,0.44,0.4394,0.77,0.1045,12,519,531,531,4,Siang
15748,2012-10-23,1,10,8,0,2,1,2,0.46,0.4545,0.72,0.0896,28,733,761,761,4,Siang
15749,2012-10-23,1,10,9,0,2,1,2,0.5,0.4848,0.72,0.1045,29,305,334,334,4,Siang
15750,2012-10-23,1,10,10,0,2,1,1,0.54,0.5152,0.6,0.0,50,171,221,221,4,Siang
15751,2012-10-23,1,10,11,0,2,1,1,0.6,0.6212,0.53,0.0,52,201,253,253,4,Siang
15752,2012-10-23,1,10,12,0,2,1,2,0.62,0.6212,0.46,0.0896,80,298,378,378,4,Siang
15753,2012-10-23,1,10,13,0,2,1,2,0.64,0.6212,0.44,0.0,59,244,303,303,4,Sore
15754,2012-10-23,1,10,14,0,2,1,1,0.68,0.6364,0.41,0.1642,67,229,296,296,4,Sore
15755,2012-10-23,1,10,15,0,2,1,1,0.68,0.6364,0.41,0.2239,76,270,346,346,4,Sore
15756,2012-10-23,1,10,16,0,2,1,1,0.68,0.6364,0.44,0.0896,108,433,541,541,4,Sore
15757,2012-10-23,1,10,17,0,2,1,1,0.68,0.6364,0.41,0.0,67,871,938,938,4,Sore
15758,2012-10-23,1,10,18,0,2,1,1,0.62,0.6212,0.53,0.0896,64,762,826,826,4,Sore
15759,2012-10-23,1,10,19,0,2,1,1,0.62,0.6212,0.57,0.0896,25,457,482,482,4,Malam
15760,2012-10-23,1,10,20,0,2,1,1,0.58,0.5455,0.64,0.1343,45,334,379,379,4,Malam
15761,2012-10-23,1,10,21,0,2,1,1,0.56,0.5303,0.68,0.0,35,260,295,295,4,Malam
15762,2012-10-23,1,10,22,0,2,1,1,0.56,0.5303,0.68,0.1045,20,174,194,194,4,Malam
15763,2012-10-23,1,10,23,0,2,1,1,0.54,0.5152,0.73,0.1045,9,102,111,111,4,Malam
15764,2012-10-24,1,10,0,0,3,1,1,0.54,0.5152,0.73,0.0896,7,39,46,46,4,
15765,2012-10-24,1,10,1,0,3,1,1,0.54,0.5152,0.68,0.0,4,23,27,27,4,Pagi
15766,2012-10-24,1,10,2,0,3,1,1,0.54,0.5152,0.68,0.0,0,6,6,6,4,Pagi
15767,2012-10-24,1,10,3,0,3,1,1,0.5,0.4848,0.77,0.0896,0,4,4,4,4,Pagi
15768,2012-10-24,1,10,4,0,3,1,1,0.5,0.4848,0.77,0.0896,1,5,6,6,4,Pagi
15769,2012-10-24,1,10,5,0,3,1,1,0.5,0.4848,0.82,0.0,1,52,53,53,4,Pagi
15770,2012-10-24,1,10,6,0,3,1,1,0.48,0.4697,0.82,0.1045,11,162,173,173,4,Pagi
15771,2012-10-24,1,10,7,0,3,1,1,0.5,0.4848,0.88,0.0896,20,506,526,526,4,Siang
15772,2012-10-24,1,10,8,0,3,1,2,0.52,0.5,0.83,0.1045,24,777,801,801,4,Siang
15773,2012-10-24,1,10,9,0,3,1,2,0.52,0.5,0.77,0.0896,24,349,373,373,4,Siang
15774,2012-10-24,1,10,10,0,3,1,2,0.54,0.5152,0.73,0.0,29,142,171,171,4,Siang
15775,2012-10-24,1,10,11,0,3,1,1,0.58,0.5455,0.64,0.0,47,189,236,236,4,Siang
15776,2012-10-24,1,10,12,0,3,1,1,0.62,0.6061,0.61,0.0896,48,268,316,316,4,Siang
15777,2012-10-24,1,10,13,0,3,1,1,0.66,0.6212,0.54,0.0,65,241,306,306,4,Sore
15778,2012-10-24,1,10,14,0,3,1,1,0.74,0.6515,0.3,0.2537,64,237,301,301,4,Sore
15779,2012-10-24,1,10,15,0,3,1,1,0.7,0.6364,0.39,0.1045,63,245,308,308,4,Sore
15780,2012-10-24,1,10,16,0,3,1,1,0.74,0.6515,0.33,0.1343,67,465,532,532,4,Sore
15781,2012-10-24,1,10,17,0,3,1,1,0.66,0.6212,0.47,0.0,87,876,963,963,4,Sore
15782,2012-10-24,1,10,18,0,3,1,1,0.66,0.6212,0.44,0.0,63,795,858,858,4,Sore
15783,2012-10-24,1,10,19,0,3,1,2,0.64,0.6212,0.53,0.0896,50,522,572,572,4,Malam
15784,2012-10-24,1,10,20,0,3,1,2,0.62,0.6061,0.61,0.0896,45,396,441,441,4,Malam
15785,2012-10-24,1,10,21,0,3,1,2,0.62,0.6061,0.61,0.1045,33,280,313,313,4,Malam
15786,2012-10-24,1,10,22,0,3,1,2,0.6,0.6061,0.64,0.1343,30,208,238,238,4,Malam
15787,2012-10-24,1,10,23,0,3,1,2,0.58,0.5455,0.68,0.0896,12,111,123,123,4,Malam
15788,2012-10-25,1,10,0,0,4,1,2,0.6,0.6061,0.64,0.1045,19,57,76,76,4,
15789,2012-10-25,1,10,1,0,4,1,1,0.58,0.5455,0.68,0.0,6,22,28,28,4,Pagi
15790,2012-10-25,1,10,2,0,4,1,1,0.54,0.5152,0.77,0.0,3,15,18,18,4,Pagi
15791,2012-10-25,1,10,3,0,4,1,2,0.52,0.5,0.88,0.1343,0,8,8,8,4,Pagi
15792,2012-10-25,1,10,4,0,4,1,2,0.52,0.5,0.88,0.1045,1,4,5,5,4,Pagi
15793,2012-10-25,1,10,5,0,4,1,2,0.52,0.5,0.88,0.1642,2,53,55,55,4,Pagi
15794,2012-10-25,1,10,6,0,4,1,2,0.52,0.5,0.88,0.194,3,168,171,171,4,Pagi
15795,2012-10-25,1,10,7,0,4,1,2,0.52,0.5,0.88,0.194,18,477,495,495,4,Siang
15796,2012-10-25,1,10,8,0,4,1,2,0.52,0.5,0.83,0.1642,33,746,779,779,4,Siang
15797,2012-10-25,1,10,9,0,4,1,2,0.52,0.5,0.83,0.194,23,320,343,343,4,Siang
15798,2012-10-25,1,10,10,0,4,1,2,0.54,0.5152,0.83,0.1343,53,172,225,225,4,Siang
15799,2012-10-25,1,10,11,0,4,1,2,0.54,0.5152,0.83,0.1045,57,181,238,238,4,Siang
15800,2012-10-25,1,10,12,0,4,1,2,0.56,0.5303,0.78,0.1045,61,258,319,319,4,Siang
15801,2012-10-25,1,10,13,0,4,1,2,0.56,0.5303,0.78,0.0,49,264,313,313,4,Sore
15802,2012-10-25,1,10,14,0,4,1,1,0.6,0.5909,0.73,0.1343,71,214,285,285,4,Sore
15803,2012-10-25,1,10,15,0,4,1,1,0.62,0.6061,0.65,0.1343,63,242,305,305,4,Sore
15804,2012-10-25,1,10,16,0,4,1,1,0.6,0.5909,0.69,0.1642,92,407,499,499,4,Sore
15805,2012-10-25,1,10,17,0,4,1,1,0.6,0.5909,0.69,0.1642,112,774,886,886,4,Sore
15806,2012-10-25,1,10,18,0,4,1,1,0.56,0.5303,0.83,0.1045,77,732,809,809,4,Sore
15807,2012-10-25,1,10,19,0,4,1,1,0.54,0.5152,0.83,0.194,45,497,542,542,4,Malam
15808,2012-10-25,1,10,20,0,4,1,2,0.52,0.5,0.88,0.1343,28,319,347,347,4,Malam
15809,2012-10-25,1,10,21,0,4,1,2,0.52,0.5,0.88,0.1343,24,247,271,271,4,Malam
15810,2012-10-25,1,10,22,0,4,1,2,0.54,0.5152,0.83,0.0896,22,185,207,207,4,Malam
15811,2012-10-25,1,10,23,0,4,1,2,0.54,0.5152,0.83,0.1343,13,122,135,135,4,Malam
15812,2012-10-26,1,10,0,0,5,1,2,0.54,0.5152,0.77,0.0,6,65,71,71,4,
15813,2012-10-26,1,10,1,0,5,1,2,0.52,0.5,0.88,0.0896,4,32,36,36,4,Pagi
15814,2012-10-26,1,10,2,0,5,1,2,0.52,0.5,0.88,0.1045,4,15,19,19,4,Pagi
15815,2012-10-26,1,10,3,0,5,1,2,0.52,0.5,0.88,0.1642,5,8,13,13,4,Pagi
15816,2012-10-26,1,10,4,0,5,1,2,0.52,0.5,0.88,0.1642,1,4,5,5,4,Pagi
15817,2012-10-26,1,10,5,0,5,1,2,0.52,0.5,0.88,0.1045,3,47,50,50,4,Pagi
15818,2012-10-26,1,10,6,0,5,1,2,0.52,0.5,0.88,0.0896,2,142,144,144,4,Pagi
15819,2012-10-26,1,10,7,0,5,1,2,0.52,0.5,0.88,0.1045,13,408,421,421,4,Siang
15820,2012-10-26,1,10,8,0,5,1,2,0.54,0.5152,0.88,0.1343,20,714,734,734,4,Siang
15821,2012-10-26,1,10,9,0,5,1,2,0.54,0.5152,0.88,0.1343,56,347,403,403,4,Siang
15822,2012-10-26,1,10,10,0,5,1,2,0.54,0.5152,0.88,0.1045,41,156,197,197,4,Siang
15823,2012-10-26,1,10,11,0,5,1,2,0.56,0.5303,0.78,0.1642,68,222,290,290,4,Siang
15824,2012-10-26,1,10,12,0,5,1,2,0.58,0.5455,0.73,0.194,90,302,392,392,4,Siang
15825,2012-10-26,1,10,13,0,5,1,2,0.58,0.5455,0.68,0.1343,77,260,337,337,4,Sore
15826,2012-10-26,1,10,14,0,5,1,2,0.6,0.6061,0.64,0.1343,99,252,351,351,4,Sore
15827,2012-10-26,1,10,15,0,5,1,2,0.62,0.6061,0.61,0.1045,142,306,448,448,4,Sore
15828,2012-10-26,1,10,16,0,5,1,2,0.58,0.5455,0.73,0.1642,137,445,582,582,4,Sore
15829,2012-10-26,1,10,17,0,5,1,2,0.56,0.5303,0.76,0.194,125,692,817,817,4,Sore
15830,2012-10-26,1,10,18,0,5,1,2,0.56,0.5303,0.78,0.1343,81,584,665,665,4,Sore
15831,2012-10-26,1,10,19,0,5,1,2,0.54,0.5152,0.83,0.1642,72,399,471,471,4,Malam
15832,2012-10-26,1,10,20,0,5,1,2,0.54,0.5152,0.83,0.1642,40,271,311,311,4,Malam
15833,2012-10-26,1,10,21,0,5,1,2,0.54,0.5152,0.77,0.1343,40,252,292,292,4,Malam
15834,2012-10-26,1,10,22,0,5,1,2,0.52,0.5,0.83,0.1343,37,180,217,217,4,Malam
15835,2012-10-26,1,10,23,0,5,1,1,0.52,0.5,0.83,0.1642,19,159,178,178,4,Malam
15836,2012-10-27,1,10,0,0,6,0,1,0.5,0.4848,0.88,0.1343,10,132,142,142,4,
15837,2012-10-27,1,10,1,0,6,0,2,0.5,0.4848,0.88,0.1343,23,123,146,146,4,Pagi
15838,2012-10-27,1,10,2,0,6,0,2,0.5,0.4848,0.88,0.194,19,71,90,90,4,Pagi
15839,2012-10-27,1,10,3,0,6,0,1,0.5,0.4848,0.88,0.1642,5,21,26,26,4,Pagi
15840,2012-10-27,1,10,4,0,6,0,2,0.5,0.4848,0.88,0.1642,1,12,13,13,4,Pagi
15841,2012-10-27,1,10,5,0,6,0,2,0.5,0.4848,0.82,0.194,2,7,9,9,4,Pagi
15842,2012-10-27,1,10,6,0,6,0,2,0.5,0.4848,0.82,0.194,2,29,31,31,4,Pagi
15843,2012-10-27,1,10,7,0,6,0,1,0.48,0.4697,0.83,0.194,7,79,86,86,4,Siang
15844,2012-10-27,1,10,8,0,6,0,1,0.5,0.4848,0.77,0.2537,26,187,213,213,4,Siang
15845,2012-10-27,1,10,9,0,6,0,1,0.5,0.4848,0.77,0.2537,88,240,328,328,4,Siang
15846,2012-10-27,1,10,10,0,6,0,1,0.54,0.5152,0.73,0.2836,165,314,479,479,4,Siang
15847,2012-10-27,1,10,11,0,6,0,1,0.56,0.5303,0.64,0.2836,197,388,585,585,4,Siang
15848,2012-10-27,1,10,12,0,6,0,1,0.6,0.6212,0.53,0.2537,264,404,668,668,4,Siang
15849,2012-10-27,1,10,13,0,6,0,1,0.6,0.6212,0.43,0.2537,310,450,760,760,4,Sore
15850,2012-10-27,1,10,14,0,6,0,1,0.6,0.6212,0.46,0.2537,325,425,750,750,4,Sore
15851,2012-10-27,1,10,15,0,6,0,2,0.56,0.5303,0.6,0.2836,310,401,711,711,4,Sore
15852,2012-10-27,1,10,16,0,6,0,2,0.56,0.5303,0.64,0.2836,257,355,612,612,4,Sore
15853,2012-10-27,1,10,17,0,6,0,2,0.56,0.5303,0.64,0.2836,248,370,618,618,4,Sore
15854,2012-10-27,1,10,18,0,6,0,2,0.56,0.5303,0.64,0.2836,138,318,456,456,4,Sore
15855,2012-10-27,1,10,19,0,6,0,2,0.52,0.5,0.72,0.2239,67,233,300,300,4,Malam
15856,2012-10-27,1,10,20,0,6,0,2,0.52,0.5,0.72,0.2239,58,238,296,296,4,Malam
15857,2012-10-27,1,10,21,0,6,0,2,0.52,0.5,0.72,0.2239,49,160,209,209,4,Malam
15858,2012-10-27,1,10,22,0,6,0,2,0.52,0.5,0.72,0.2537,41,116,157,157,4,Malam
15859,2012-10-27,1,10,23,0,6,0,2,0.52,0.5,0.68,0.3881,31,136,167,167,4,Malam
15860,2012-10-28,1,10,0,0,0,0,3,0.52,0.5,0.68,0.2985,20,97,117,117,4,
15861,2012-10-28,1,10,1,0,0,0,2,0.5,0.4848,0.72,0.2836,22,111,133,133,4,Pagi
15862,2012-10-28,1,10,2,0,0,0,2,0.5,0.4848,0.68,0.2985,17,99,116,116,4,Pagi
15863,2012-10-28,1,10,3,0,0,0,2,0.5,0.4848,0.63,0.3284,18,61,79,79,4,Pagi
15864,2012-10-28,1,10,4,0,0,0,2,0.5,0.4848,0.63,0.3582,1,19,20,20,4,Pagi
15865,2012-10-28,1,10,5,0,0,0,2,0.5,0.4848,0.63,0.2985,6,22,28,28,4,Pagi
15866,2012-10-28,1,10,6,0,0,0,2,0.5,0.4848,0.59,0.3284,7,32,39,39,4,Pagi
15867,2012-10-28,1,10,7,0,0,0,2,0.5,0.4848,0.59,0.2985,17,48,65,65,4,Siang
15868,2012-10-28,1,10,8,0,0,0,2,0.5,0.4848,0.59,0.5522,55,118,173,173,4,Siang
15869,2012-10-28,1,10,9,0,0,0,2,0.5,0.4848,0.55,0.4179,124,206,330,330,4,Siang
15870,2012-10-28,1,10,10,0,0,0,2,0.48,0.4697,0.51,0.4179,120,314,434,434,4,Siang
15871,2012-10-28,1,10,11,0,0,0,2,0.5,0.4848,0.51,0.3881,110,352,462,462,4,Siang
15872,2012-10-28,1,10,12,0,0,0,2,0.48,0.4697,0.59,0.4925,118,373,491,491,4,Siang
15873,2012-10-28,1,10,13,0,0,0,2,0.48,0.4697,0.59,0.4179,75,316,391,391,4,Sore
15874,2012-10-28,1,10,14,0,0,0,2,0.5,0.4848,0.59,0.4478,98,304,402,402,4,Sore
15875,2012-10-28,1,10,15,0,0,0,2,0.5,0.4848,0.63,0.4925,76,225,301,301,4,Sore
15876,2012-10-28,1,10,16,0,0,0,3,0.48,0.4697,0.67,0.4627,42,251,293,293,4,Sore
15877,2012-10-28,1,10,17,0,0,0,3,0.46,0.4545,0.77,0.5224,37,188,225,225,4,Sore
15878,2012-10-28,1,10,18,0,0,0,3,0.42,0.4242,0.94,0.4925,18,136,154,154,4,Sore
15879,2012-10-28,1,10,19,0,0,0,3,0.42,0.4242,0.94,0.3582,7,47,54,54,4,Malam
15880,2012-10-28,1,10,20,0,0,0,3,0.42,0.4242,0.94,0.4627,4,51,55,55,4,Malam
15881,2012-10-28,1,10,21,0,0,0,3,0.44,0.4394,0.88,0.4179,2,44,46,46,4,Malam
15882,2012-10-28,1,10,22,0,0,0,3,0.44,0.4394,0.88,0.3582,2,35,37,37,4,Malam
15883,2012-10-28,1,10,23,0,0,0,3,0.42,0.4242,0.94,0.3582,2,12,14,14,4,Malam
15884,2012-10-29,1,10,0,0,1,1,3,0.44,0.4394,0.88,0.3582,2,20,22,22,4,
15885,2012-10-30,1,10,13,0,2,1,3,0.3,0.2727,0.81,0.3582,11,105,116,116,4,Sore
15886,2012-10-30,1,10,14,0,2,1,3,0.3,0.2727,0.81,0.3582,8,118,126,126,4,Sore
15887,2012-10-30,1,10,15,0,2,1,3,0.3,0.2879,0.87,0.2537,10,114,124,124,4,Sore
15888,2012-10-30,1,10,16,0,2,1,3,0.3,0.2879,0.87,0.2537,15,83,98,98,4,Sore
15889,2012-10-30,1,10,17,0,2,1,3,0.3,0.2879,0.87,0.2239,19,105,124,124,4,Sore
15890,2012-10-30,1,10,18,0,2,1,3,0.3,0.303,0.87,0.1343,4,139,143,143,4,Sore
15891,2012-10-30,1,10,19,0,2,1,2,0.5,0.4848,0.68,0.194,6,109,115,115,4,Malam
15892,2012-10-30,1,10,20,0,2,1,2,0.3,0.2879,0.81,0.194,5,76,81,81,4,Malam
15893,2012-10-30,1,10,21,0,2,1,2,0.3,0.3182,0.87,0.1045,4,60,64,64,4,Malam
15894,2012-10-30,1,10,22,0,2,1,1,0.3,0.303,0.81,0.1343,2,64,66,66,4,Malam
15895,2012-10-30,1,10,23,0,2,1,1,0.3,0.303,0.81,0.1343,3,36,39,39,4,Malam
15896,2012-10-31,1,10,0,0,3,1,2,0.3,0.3182,0.81,0.1045,0,16,16,16,4,
15897,2012-10-31,1,10,1,0,3,1,2,0.3,0.3182,0.81,0.0896,0,8,8,8,4,Pagi
15898,2012-10-31,1,10,2,0,3,1,2,0.3,0.303,0.81,0.1343,0,7,7,7,4,Pagi
15899,2012-10-31,1,10,3,0,3,1,2,0.3,0.3182,0.81,0.1045,0,3,3,3,4,Pagi
15900,2012-10-31,1,10,4,0,3,1,2,0.3,0.2879,0.87,0.194,0,5,5,5,4,Pagi
15901,2012-10-31,1,10,5,0,3,1,2,0.3,0.303,0.81,0.1343,0,24,24,24,4,Pagi
15902,2012-10-31,1,10,6,0,3,1,1,0.3,0.303,0.81,0.1642,0,116,116,116,4,Pagi
15903,2012-10-31,1,10,7,0,3,1,2,0.3,0.303,0.87,0.1343,3,334,337,337,4,Siang
15904,2012-10-31,1,10,8,0,3,1,1,0.32,0.3333,0.81,0.1343,6,615,621,621,4,Siang
15905,2012-10-31,1,10,9,0,3,1,1,0.34,0.3333,0.76,0.1343,17,280,297,297,4,Siang
15906,2012-10-31,1,10,10,0,3,1,1,0.36,0.3333,0.71,0.2836,21,147,168,168,4,Siang
15907,2012-10-31,1,10,11,0,3,1,2,0.36,0.3485,0.66,0.2239,37,152,189,189,4,Siang
15908,2012-10-31,1,10,12,0,3,1,1,0.4,0.4091,0.58,0.194,44,197,241,241,4,Siang
15909,2012-10-31,1,10,13,0,3,1,1,0.42,0.4242,0.5,0.2239,22,191,213,213,4,Sore
15910,2012-10-31,1,10,14,0,3,1,2,0.42,0.4242,0.5,0.2239,45,179,224,224,4,Sore
15911,2012-10-31,1,10,15,0,3,1,1,0.42,0.4242,0.54,0.1642,33,197,230,230,4,Sore
15912,2012-10-31,1,10,16,0,3,1,2,0.42,0.4242,0.54,0.2239,51,373,424,424,4,Sore
15913,2012-10-31,1,10,17,0,3,1,2,0.4,0.4091,0.58,0.1642,39,684,723,723,4,Sore
15914,2012-10-31,1,10,18,0,3,1,2,0.4,0.4091,0.58,0.1642,28,556,584,584,4,Sore
15915,2012-10-31,1,10,19,0,3,1,2,0.4,0.4091,0.5,0.194,27,383,410,410,4,Malam
15916,2012-10-31,1,10,20,0,3,1,2,0.4,0.4091,0.5,0.194,9,259,268,268,4,Malam
15917,2012-10-31,1,10,21,0,3,1,2,0.4,0.4091,0.5,0.194,12,180,192,192,4,Malam
15918,2012-10-31,1,10,22,0,3,1,1,0.36,0.3485,0.57,0.1343,18,147,165,165,4,Malam
15919,2012-10-31,1,10,23,0,3,1,1,0.36,0.3636,0.57,0.0896,7,94,101,101,4,Malam
15920,2012-11-01,1,11,0,0,4,1,1,0.36,0.3636,0.57,0.0896,8,52,60,60,4,
15921,2012-11-01,1,11,1,0,4,1,1,0.3,0.3182,0.75,0.1045,8,22,30,30,4,Pagi
15922,2012-11-01,1,11,2,0,4,1,1,0.32,0.3333,0.66,0.1343,10,10,20,20,4,Pagi
15923,2012-11-01,1,11,3,0,4,1,1,0.34,0.3333,0.61,0.1343,5,10,15,15,4,Pagi
15924,2012-11-01,1,11,4,0,4,1,2,0.34,0.3485,0.66,0.1045,2,8,10,10,4,Pagi
15925,2012-11-01,1,11,5,0,4,1,1,0.34,0.3333,0.66,0.1343,1,39,40,40,4,Pagi
15926,2012-11-01,1,11,6,0,4,1,1,0.34,0.3333,0.61,0.1642,2,146,148,148,4,Pagi
15927,2012-11-01,1,11,7,0,4,1,2,0.36,0.3485,0.57,0.1642,6,414,420,420,4,Siang
15928,2012-11-01,1,11,8,0,4,1,2,0.36,0.3788,0.56,0.1045,12,668,680,680,4,Siang
15929,2012-11-01,1,11,9,0,4,1,3,0.36,0.3636,0.57,0.1045,21,310,331,331,4,Siang
15930,2012-11-01,1,11,10,0,4,1,3,0.36,0.3485,0.62,0.194,13,133,146,146,4,Siang
15931,2012-11-01,1,11,11,0,4,1,3,0.36,0.3485,0.62,0.194,14,156,170,170,4,Siang
15932,2012-11-01,1,11,12,0,4,1,3,0.38,0.3939,0.62,0.1642,23,198,221,221,4,Siang
15933,2012-11-01,1,11,13,0,4,1,2,0.4,0.4091,0.58,0.1642,49,199,248,248,4,Sore
15934,2012-11-01,1,11,14,0,4,1,2,0.4,0.4091,0.5,0.2239,31,154,185,185,4,Sore
15935,2012-11-01,1,11,15,0,4,1,2,0.4,0.4091,0.54,0.1642,35,179,214,214,4,Sore
15936,2012-11-01,1,11,16,0,4,1,2,0.4,0.4091,0.54,0.1642,31,313,344,344,4,Sore
15937,2012-11-01,1,11,17,0,4,1,3,0.4,0.4091,0.5,0.2239,37,652,689,689,4,Sore
15938,2012-11-01,1,11,18,0,4,1,2,0.4,0.4091,0.5,0.1642,50,628,678,678,4,Sore
15939,2012-11-01,1,11,19,0,4,1,2,0.4,0.4091,0.5,0.1642,28,424,452,452,4,Malam
15940,2012-11-01,1,11,20,0,4,1,2,0.38,0.3939,0.54,0.2537,16,280,296,296,4,Malam
15941,2012-11-01,1,11,21,0,4,1,2,0.38,0.3939,0.54,0.1343,29,238,267,267,4,Malam
15942,2012-11-01,1,11,22,0,4,1,1,0.36,0.3485,0.57,0.1642,27,175,202,202,4,Malam
15943,2012-11-01,1,11,23,0,4,1,1,0.34,0.3333,0.57,0.1642,8,112,120,120,4,Malam
15944,2012-11-02,1,11,0,0,5,1,1,0.34,0.3333,0.57,0.1642,10,40,50,50,4,
15945,2012-11-02,1,11,1,0,5,1,1,0.32,0.3182,0.66,0.1642,5,19,24,24,4,Pagi
15946,2012-11-02,1,11,2,0,5,1,1,0.32,0.3182,0.66,0.1642,3,7,10,10,4,Pagi
15947,2012-11-02,1,11,3,0,5,1,1,0.3,0.303,0.7,0.1642,0,3,3,3,4,Pagi
15948,2012-11-02,1,11,4,0,5,1,1,0.3,0.3182,0.7,0.1045,1,6,7,7,4,Pagi
15949,2012-11-02,1,11,5,0,5,1,2,0.32,0.3182,0.66,0.1642,1,25,26,26,4,Pagi
15950,2012-11-02,1,11,6,0,5,1,1,0.3,0.303,0.7,0.1642,2,120,122,122,4,Pagi
15951,2012-11-02,1,11,7,0,5,1,2,0.3,0.303,0.7,0.1343,8,349,357,357,4,Siang
15952,2012-11-02,1,11,8,0,5,1,1,0.32,0.3333,0.57,0.1045,31,656,687,687,4,Siang
15953,2012-11-02,1,11,9,0,5,1,1,0.34,0.3485,0.53,0.1045,27,355,382,382,4,Siang
15954,2012-11-02,1,11,10,0,5,1,1,0.38,0.3939,0.46,0.2985,21,183,204,204,4,Siang
15955,2012-11-02,1,11,11,0,5,1,1,0.42,0.4242,0.41,0.4179,42,179,221,221,4,Siang
15956,2012-11-02,1,11,12,0,5,1,1,0.42,0.4242,0.41,0.3582,52,240,292,292,4,Siang
15957,2012-11-02,1,11,13,0,5,1,1,0.4,0.4091,0.43,0.3582,64,230,294,294,4,Sore
15958,2012-11-02,1,11,14,0,5,1,2,0.4,0.4091,0.4,0.4925,63,199,262,262,4,Sore
15959,2012-11-02,1,11,15,0,5,1,2,0.4,0.4091,0.4,0.4179,51,255,306,306,4,Sore
15960,2012-11-02,1,11,16,0,5,1,1,0.38,0.3939,0.4,0.3284,48,373,421,421,4,Sore
15961,2012-11-02,1,11,17,0,5,1,1,0.38,0.3939,0.4,0.3284,57,581,638,638,4,Sore
15962,2012-11-02,1,11,18,0,5,1,2,0.38,0.3939,0.43,0.3284,32,490,522,522,4,Sore
15963,2012-11-02,1,11,19,0,5,1,2,0.38,0.3939,0.43,0.2985,38,336,374,374,4,Malam
15964,2012-11-02,1,11,20,0,5,1,2,0.36,0.3333,0.46,0.4179,14,207,221,221,4,Malam
15965,2012-11-02,1,11,21,0,5,1,2,0.36,0.3333,0.46,0.3582,23,133,156,156,4,Malam
15966,2012-11-02,1,11,22,0,5,1,1,0.36,0.3333,0.46,0.2537,14,135,149,149,4,Malam
15967,2012-11-02,1,11,23,0,5,1,1,0.34,0.303,0.53,0.2985,11,108,119,119,4,Malam
15968,2012-11-03,1,11,0,0,6,0,1,0.34,0.3333,0.53,0.1642,9,99,108,108,4,
15969,2012-11-03,1,11,1,0,6,0,2,0.34,0.303,0.49,0.3284,6,83,89,89,4,Pagi
15970,2012-11-03,1,11,2,0,6,0,2,0.34,0.3182,0.49,0.2537,10,36,46,46,4,Pagi
15971,2012-11-03,1,11,3,0,6,0,2,0.34,0.3182,0.49,0.2537,6,22,28,28,4,Pagi
15972,2012-11-03,1,11,4,0,6,0,2,0.32,0.303,0.49,0.2985,8,8,16,16,4,Pagi
15973,2012-11-03,1,11,5,0,6,0,2,0.32,0.303,0.49,0.2537,1,8,9,9,4,Pagi
15974,2012-11-03,1,11,6,0,6,0,2,0.32,0.3182,0.49,0.194,4,17,21,21,4,Pagi
15975,2012-11-03,1,11,7,0,6,0,2,0.32,0.303,0.49,0.2537,1,58,59,59,4,Siang
15976,2012-11-03,1,11,8,0,6,0,2,0.34,0.303,0.46,0.2985,10,132,142,142,4,Siang
15977,2012-11-03,1,11,9,0,6,0,2,0.34,0.303,0.49,0.2985,31,188,219,219,4,Siang
15978,2012-11-03,1,11,10,0,6,0,1,0.36,0.3333,0.46,0.3881,68,260,328,328,4,Siang
15979,2012-11-03,1,11,11,0,6,0,2,0.36,0.3333,0.46,0.3881,56,284,340,340,4,Siang
15980,2012-11-03,1,11,12,0,6,0,2,0.36,0.3182,0.46,0.4627,74,320,394,394,4,Siang
15981,2012-11-03,1,11,13,0,6,0,2,0.36,0.3333,0.46,0.3582,110,339,449,449,4,Sore
15982,2012-11-03,1,11,14,0,6,0,2,0.36,0.3333,0.5,0.3284,136,319,455,455,4,Sore
15983,2012-11-03,1,11,15,0,6,0,2,0.36,0.3182,0.46,0.4478,117,331,448,448,4,Sore
15984,2012-11-03,1,11,16,0,6,0,2,0.36,0.3333,0.46,0.3284,108,292,400,400,4,Sore
15985,2012-11-03,1,11,17,0,6,0,2,0.36,0.3333,0.46,0.2985,112,298,410,410,4,Sore
15986,2012-11-03,1,11,18,0,6,0,2,0.36,0.3333,0.46,0.2836,58,239,297,297,4,Sore
15987,2012-11-03,1,11,19,0,6,0,1,0.36,0.3485,0.5,0.1642,22,217,239,239,4,Malam
15988,2012-11-03,1,11,20,0,6,0,1,0.34,0.3333,0.53,0.1343,23,158,181,181,4,Malam
15989,2012-11-03,1,11,21,0,6,0,1,0.34,0.3485,0.53,0.1045,31,135,166,166,4,Malam
15990,2012-11-03,1,11,22,0,6,0,1,0.32,0.3333,0.57,0.1045,13,133,146,146,4,Malam
15991,2012-11-03,1,11,23,0,6,0,1,0.32,0.3333,0.57,0.1045,15,133,148,148,4,Malam
15992,2012-11-04,1,11,0,0,0,0,1,0.3,0.3182,0.61,0.1045,5,97,102,102,4,
15993,2012-11-04,1,11,1,0,0,0,1,0.26,0.2879,0.81,0.0896,26,139,165,165,4,Pagi
15994,2012-11-04,1,11,2,0,0,0,1,0.3,0.3333,0.65,0.0,6,31,37,37,4,Pagi
15995,2012-11-04,1,11,3,0,0,0,1,0.28,0.2879,0.61,0.1045,1,10,11,11,4,Pagi
15996,2012-11-04,1,11,4,0,0,0,1,0.26,0.2727,0.65,0.1343,2,7,9,9,4,Pagi
15997,2012-11-04,1,11,5,0,0,0,1,0.26,0.2727,0.65,0.1045,0,5,5,5,4,Pagi
15998,2012-11-04,1,11,6,0,0,0,1,0.28,0.2879,0.61,0.1343,2,14,16,16,4,Pagi
15999,2012-11-04,1,11,7,0,0,0,1,0.26,0.2727,0.65,0.1045,11,39,50,50,4,Siang
16000,2012-11-04,1,11,8,0,0,0,1,0.3,0.303,0.56,0.1343,34,115,149,149,4,Siang
16001,2012-11-04,1,11,9,0,0,0,1,0.32,0.3333,0.53,0.0,56,161,217,217,4,Siang
16002,2012-11-04,1,11,10,0,0,0,1,0.34,0.3333,0.49,0.194,73,287,360,360,4,Siang
16003,2012-11-04,1,11,11,0,0,0,1,0.38,0.3939,0.46,0.2239,134,311,445,445,4,Siang
16004,2012-11-04,1,11,12,0,0,0,1,0.38,0.3939,0.46,0.2239,150,354,504,504,4,Siang
16005,2012-11-04,1,11,13,0,0,0,1,0.4,0.4091,0.43,0.2239,122,371,493,493,4,Sore
16006,2012-11-04,1,11,14,0,0,0,1,0.4,0.4091,0.4,0.194,149,360,509,509,4,Sore
16007,2012-11-04,1,11,15,0,0,0,1,0.4,0.4091,0.4,0.2239,149,300,449,449,4,Sore
16008,2012-11-04,1,11,16,0,0,0,1,0.4,0.4091,0.4,0.3284,119,316,435,435,4,Sore
16009,2012-11-04,1,11,17,0,0,0,1,0.36,0.3485,0.43,0.194,57,270,327,327,4,Sore
16010,2012-11-04,1,11,18,0,0,0,1,0.36,0.3485,0.43,0.2239,31,206,237,237,4,Sore
16011,2012-11-04,1,11,19,0,0,0,1,0.36,0.3333,0.43,0.2537,24,203,227,227,4,Malam
16012,2012-11-04,1,11,20,0,0,0,1,0.32,0.2879,0.53,0.3582,7,134,141,141,4,Malam
16013,2012-11-04,1,11,21,0,0,0,1,0.3,0.2727,0.52,0.2985,16,71,87,87,4,Malam
16014,2012-11-04,1,11,22,0,0,0,1,0.3,0.2879,0.52,0.2836,15,64,79,79,4,Malam
16015,2012-11-04,1,11,23,0,0,0,2,0.3,0.303,0.56,0.1642,12,41,53,53,4,Malam
16016,2012-11-05,1,11,0,0,1,1,2,0.3,0.2879,0.56,0.194,3,20,23,23,4,
16017,2012-11-05,1,11,1,0,1,1,2,0.3,0.303,0.56,0.1642,0,8,8,8,4,Pagi
16018,2012-11-05,1,11,2,0,1,1,2,0.3,0.303,0.56,0.1642,2,4,6,6,4,Pagi
16019,2012-11-05,1,11,3,0,1,1,2,0.3,0.2879,0.56,0.2239,1,3,4,4,4,Pagi
16020,2012-11-05,1,11,4,0,1,1,2,0.3,0.2879,0.52,0.2537,5,11,16,16,4,Pagi
16021,2012-11-05,1,11,5,0,1,1,2,0.3,0.2727,0.52,0.3284,1,38,39,39,4,Pagi
16022,2012-11-05,1,11,6,0,1,1,2,0.3,0.2879,0.49,0.2836,4,135,139,139,4,Pagi
16023,2012-11-05,1,11,7,0,1,1,2,0.3,0.2879,0.49,0.2537,8,453,461,461,4,Siang
16024,2012-11-05,1,11,8,0,1,1,2,0.3,0.2879,0.49,0.2239,19,629,648,648,4,Siang
16025,2012-11-05,1,11,9,0,1,1,2,0.3,0.2879,0.52,0.2836,18,239,257,257,4,Siang
16026,2012-11-05,1,11,10,0,1,1,1,0.32,0.303,0.49,0.2836,30,112,142,142,4,Siang
16027,2012-11-05,1,11,11,0,1,1,1,0.34,0.3182,0.46,0.2239,31,119,150,150,4,Siang
16028,2012-11-05,1,11,12,0,1,1,1,0.36,0.3333,0.43,0.3284,38,206,244,244,4,Siang
16029,2012-11-05,1,11,13,0,1,1,1,0.36,0.3333,0.4,0.2537,39,183,222,222,4,Sore
16030,2012-11-05,1,11,14,0,1,1,1,0.38,0.3939,0.4,0.1642,31,165,196,196,4,Sore
16031,2012-11-05,1,11,15,0,1,1,1,0.38,0.3939,0.4,0.2836,24,207,231,231,4,Sore
16032,2012-11-05,1,11,16,0,1,1,1,0.36,0.3333,0.43,0.2836,35,325,360,360,4,Sore
16033,2012-11-05,1,11,17,0,1,1,1,0.34,0.3182,0.46,0.2239,34,604,638,638,4,Sore
16034,2012-11-05,1,11,18,0,1,1,1,0.34,0.3182,0.46,0.2239,19,523,542,542,4,Sore
16035,2012-11-05,1,11,19,0,1,1,1,0.32,0.3182,0.49,0.1642,11,361,372,372,4,Malam
16036,2012-11-05,1,11,20,0,1,1,1,0.32,0.303,0.49,0.2537,13,228,241,241,4,Malam
16037,2012-11-05,1,11,21,0,1,1,1,0.3,0.2879,0.52,0.2836,8,144,152,152,4,Malam
16038,2012-11-05,1,11,22,0,1,1,1,0.28,0.2727,0.56,0.194,4,111,115,115,4,Malam
16039,2012-11-05,1,11,23,0,1,1,1,0.26,0.2727,0.6,0.1343,0,53,53,53,4,Malam
16040,2012-11-06,1,11,0,0,2,1,1,0.24,0.2576,0.6,0.1045,1,18,19,19,4,
16041,2012-11-06,1,11,1,0,2,1,1,0.24,0.2424,0.6,0.1642,0,8,8,8,4,Pagi
16042,2012-11-06,1,11,2,0,2,1,1,0.24,0.2576,0.65,0.0896,0,2,2,2,4,Pagi
16043,2012-11-06,1,11,3,0,2,1,1,0.22,0.2424,0.64,0.1045,0,4,4,4,4,Pagi
16044,2012-11-06,1,11,4,0,2,1,1,0.22,0.2576,0.69,0.0896,0,7,7,7,4,Pagi
16045,2012-11-06,1,11,5,0,2,1,2,0.22,0.2273,0.64,0.194,1,40,41,41,4,Pagi
16046,2012-11-06,1,11,6,0,2,1,1,0.22,0.2273,0.69,0.1343,6,143,149,149,4,Pagi
16047,2012-11-06,1,11,7,0,2,1,1,0.2,0.2121,0.69,0.1642,9,378,387,387,4,Siang
16048,2012-11-06,1,11,8,0,2,1,1,0.22,0.2273,0.69,0.1642,20,568,588,588,4,Siang
16049,2012-11-06,1,11,9,0,2,1,1,0.26,0.2576,0.6,0.1642,25,338,363,363,4,Siang
16050,2012-11-06,1,11,10,0,2,1,1,0.3,0.2879,0.49,0.194,41,189,230,230,4,Siang
16051,2012-11-06,1,11,11,0,2,1,1,0.32,0.3333,0.45,0.1343,39,177,216,216,4,Siang
16052,2012-11-06,1,11,12,0,2,1,1,0.32,0.3333,0.45,0.1343,31,217,248,248,4,Siang
16053,2012-11-06,1,11,13,0,2,1,1,0.34,0.3333,0.46,0.1343,46,232,278,278,4,Sore
16054,2012-11-06,1,11,14,0,2,1,1,0.36,0.3636,0.4,0.1045,44,196,240,240,4,Sore
16055,2012-11-06,1,11,15,0,2,1,1,0.34,0.3182,0.46,0.2537,45,227,272,272,4,Sore
16056,2012-11-06,1,11,16,0,2,1,1,0.34,0.3333,0.46,0.1642,33,369,402,402,4,Sore
16057,2012-11-06,1,11,17,0,2,1,1,0.32,0.303,0.53,0.2239,30,597,627,627,4,Sore
16058,2012-11-06,1,11,18,0,2,1,1,0.32,0.303,0.57,0.2985,20,477,497,497,4,Sore
16059,2012-11-06,1,11,19,0,2,1,1,0.3,0.2879,0.56,0.2239,15,356,371,371,4,Malam
16060,2012-11-06,1,11,20,0,2,1,1,0.3,0.2879,0.61,0.2239,10,218,228,228,4,Malam
16061,2012-11-06,1,11,21,0,2,1,2,0.3,0.2879,0.56,0.2537,14,137,151,151,4,Malam
16062,2012-11-06,1,11,22,0,2,1,2,0.3,0.2879,0.56,0.2239,17,136,153,153,4,Malam
16063,2012-11-06,1,11,23,0,2,1,1,0.3,0.2879,0.56,0.2239,19,186,205,205,4,Malam
16064,2012-11-07,1,11,0,0,3,1,2,0.3,0.2879,0.56,0.2836,49,234,283,283,4,
16065,2012-11-07,1,11,1,0,3,1,2,0.28,0.2727,0.61,0.2537,6,86,92,92,4,Pagi
16066,2012-11-07,1,11,2,0,3,1,2,0.28,0.2576,0.56,0.2985,6,68,74,74,4,Pagi
16067,2012-11-07,1,11,3,0,3,1,2,0.28,0.2576,0.52,0.3284,2,9,11,11,4,Pagi
16068,2012-11-07,1,11,4,0,3,1,2,0.28,0.2576,0.52,0.2985,0,9,9,9,4,Pagi
16069,2012-11-07,1,11,5,0,3,1,2,0.28,0.2576,0.52,0.3284,0,27,27,27,4,Pagi
16070,2012-11-07,1,11,6,0,3,1,2,0.26,0.2424,0.56,0.2836,3,115,118,118,4,Pagi
16071,2012-11-07,1,11,7,0,3,1,2,0.26,0.2273,0.56,0.2985,5,314,319,319,4,Siang
16072,2012-11-07,1,11,8,0,3,1,2,0.26,0.2424,0.6,0.2836,18,583,601,601,4,Siang
16073,2012-11-07,1,11,9,0,3,1,2,0.26,0.2424,0.6,0.2836,17,351,368,368,4,Siang
16074,2012-11-07,1,11,10,0,3,1,2,0.28,0.2576,0.56,0.2985,27,151,178,178,4,Siang
16075,2012-11-07,1,11,11,0,3,1,2,0.32,0.2879,0.51,0.3582,15,132,147,147,4,Siang
16076,2012-11-07,1,11,12,0,3,1,2,0.32,0.303,0.53,0.2836,24,188,212,212,4,Siang
16077,2012-11-07,1,11,13,0,3,1,2,0.32,0.303,0.53,0.2537,23,158,181,181,4,Sore
16078,2012-11-07,1,11,14,0,3,1,2,0.32,0.2879,0.53,0.3582,19,142,161,161,4,Sore
16079,2012-11-07,1,11,15,0,3,1,2,0.32,0.303,0.53,0.2985,20,178,198,198,4,Sore
16080,2012-11-07,1,11,16,0,3,1,2,0.32,0.2879,0.53,0.3582,23,250,273,273,4,Sore
16081,2012-11-07,1,11,17,0,3,1,2,0.32,0.2879,0.53,0.3881,16,501,517,517,4,Sore
16082,2012-11-07,1,11,18,0,3,1,2,0.32,0.2879,0.53,0.3582,17,448,465,465,4,Sore
16083,2012-11-07,1,11,19,0,3,1,2,0.3,0.2727,0.56,0.2985,17,302,319,319,4,Malam
16084,2012-11-07,1,11,20,0,3,1,2,0.32,0.303,0.49,0.3284,7,249,256,256,4,Malam
16085,2012-11-07,1,11,21,0,3,1,2,0.32,0.303,0.49,0.2985,5,121,126,126,4,Malam
16086,2012-11-07,1,11,22,0,3,1,3,0.3,0.2879,0.56,0.2537,4,56,60,60,4,Malam
16087,2012-11-07,1,11,23,0,3,1,3,0.28,0.2727,0.65,0.2239,3,37,40,40,4,Malam
16088,2012-11-08,1,11,0,0,4,1,3,0.28,0.2727,0.61,0.2239,1,14,15,15,4,
16089,2012-11-08,1,11,1,0,4,1,3,0.3,0.2727,0.52,0.3582,1,11,12,12,4,Pagi
16090,2012-11-08,1,11,2,0,4,1,2,0.3,0.2879,0.49,0.2239,1,5,6,6,4,Pagi
16091,2012-11-08,1,11,4,0,4,1,2,0.3,0.2879,0.45,0.2836,1,9,10,10,4,Pagi
16092,2012-11-08,1,11,5,0,4,1,2,0.3,0.2879,0.42,0.2239,0,35,35,35,4,Pagi
16093,2012-11-08,1,11,6,0,4,1,1,0.3,0.2879,0.39,0.2239,2,122,124,124,4,Pagi
16094,2012-11-08,1,11,7,0,4,1,1,0.28,0.2576,0.36,0.3881,12,411,423,423,4,Siang
16095,2012-11-08,1,11,8,0,4,1,1,0.3,0.2879,0.33,0.2836,16,652,668,668,4,Siang
16096,2012-11-08,1,11,9,0,4,1,1,0.32,0.2879,0.31,0.3582,22,253,275,275,4,Siang
16097,2012-11-08,1,11,10,0,4,1,1,0.32,0.303,0.31,0.3284,13,148,161,161,4,Siang
16098,2012-11-08,1,11,11,0,4,1,1,0.36,0.3333,0.29,0.3881,16,155,171,171,4,Siang
16099,2012-11-08,1,11,12,0,4,1,1,0.4,0.4091,0.24,0.4925,33,202,235,235,4,Siang
16100,2012-11-08,1,11,13,0,4,1,1,0.44,0.4394,0.18,0.4179,33,195,228,228,4,Sore
16101,2012-11-08,1,11,14,0,4,1,1,0.44,0.4394,0.18,0.4179,33,149,182,182,4,Sore
16102,2012-11-08,1,11,15,0,4,1,1,0.44,0.4394,0.18,0.4179,32,201,233,233,4,Sore
16103,2012-11-08,1,11,16,0,4,1,1,0.42,0.4242,0.16,0.3881,18,321,339,339,4,Sore
16104,2012-11-08,1,11,17,0,4,1,1,0.4,0.4091,0.2,0.2985,36,556,592,592,4,Sore
16105,2012-11-08,1,11,18,0,4,1,1,0.4,0.4091,0.24,0.4179,16,491,507,507,4,Sore
16106,2012-11-08,1,11,19,0,4,1,1,0.38,0.3939,0.27,0.3582,14,359,373,373,4,Malam
16107,2012-11-08,1,11,20,0,4,1,1,0.38,0.3939,0.29,0.4627,10,235,245,245,4,Malam
16108,2012-11-08,1,11,21,0,4,1,1,0.36,0.3333,0.37,0.3881,11,222,233,233,4,Malam
16109,2012-11-08,1,11,22,0,4,1,1,0.34,0.303,0.42,0.2985,14,147,161,161,4,Malam
16110,2012-11-08,1,11,23,0,4,1,1,0.34,0.303,0.46,0.3582,5,82,87,87,4,Malam
16111,2012-11-09,1,11,0,0,5,1,1,0.34,0.303,0.49,0.3284,9,46,55,55,4,
16112,2012-11-09,1,11,1,0,5,1,1,0.32,0.303,0.53,0.2836,3,17,20,20,4,Pagi
16113,2012-11-09,1,11,2,0,5,1,1,0.32,0.303,0.53,0.2537,1,11,12,12,4,Pagi
16114,2012-11-09,1,11,3,0,5,1,1,0.32,0.2879,0.53,0.4179,3,6,9,9,4,Pagi
16115,2012-11-09,1,11,4,0,5,1,1,0.32,0.2879,0.53,0.3582,0,14,14,14,4,Pagi
16116,2012-11-09,1,11,5,0,5,1,1,0.3,0.2879,0.56,0.194,2,25,27,27,4,Pagi
16117,2012-11-09,1,11,6,0,5,1,1,0.26,0.2727,0.65,0.1045,5,126,131,131,4,Pagi
16118,2012-11-09,1,11,7,0,5,1,1,0.26,0.2727,0.65,0.1343,9,332,341,341,4,Siang
16119,2012-11-09,1,11,8,0,5,1,1,0.32,0.3182,0.57,0.1642,25,668,693,693,4,Siang
16120,2012-11-09,1,11,9,0,5,1,1,0.34,0.303,0.53,0.4179,23,304,327,327,4,Siang
16121,2012-11-09,1,11,10,0,5,1,1,0.36,0.3333,0.5,0.3284,34,163,197,197,4,Siang
16122,2012-11-09,1,11,11,0,5,1,1,0.4,0.4091,0.47,0.2985,66,185,251,251,4,Siang
16123,2012-11-09,1,11,12,0,5,1,1,0.44,0.4394,0.41,0.3284,48,214,262,262,4,Siang
16124,2012-11-09,1,11,13,0,5,1,1,0.46,0.4545,0.38,0.2985,62,237,299,299,4,Sore
16125,2012-11-09,1,11,14,0,5,1,1,0.46,0.4545,0.38,0.194,67,207,274,274,4,Sore
16126,2012-11-09,1,11,15,0,5,1,1,0.46,0.4545,0.36,0.2239,78,278,356,356,4,Sore
16127,2012-11-09,1,11,16,0,5,1,1,0.46,0.4545,0.38,0.1642,57,377,434,434,4,Sore
16128,2012-11-09,1,11,17,0,5,1,1,0.42,0.4242,0.44,0.1343,61,593,654,654,4,Sore
16129,2012-11-09,1,11,18,0,5,1,1,0.42,0.4242,0.44,0.1045,46,450,496,496,4,Sore
16130,2012-11-09,1,11,19,0,5,1,1,0.34,0.3485,0.71,0.0896,30,331,361,361,4,Malam
16131,2012-11-09,1,11,20,0,5,1,1,0.36,0.3485,0.66,0.1343,20,235,255,255,4,Malam
16132,2012-11-09,1,11,21,0,5,1,1,0.34,0.3636,0.76,0.0,23,176,199,199,4,Malam
16133,2012-11-09,1,11,22,0,5,1,1,0.34,0.3485,0.71,0.1045,17,146,163,163,4,Malam
16134,2012-11-09,1,11,23,0,5,1,1,0.32,0.3333,0.81,0.0896,20,142,162,162,4,Malam
16135,2012-11-10,1,11,0,0,6,0,1,0.32,0.3333,0.76,0.0896,16,106,122,122,4,
16136,2012-11-10,1,11,1,0,6,0,1,0.3,0.3182,0.81,0.0896,8,68,76,76,4,Pagi
16137,2012-11-10,1,11,2,0,6,0,1,0.32,0.3485,0.81,0.0,2,42,44,44,4,Pagi
16138,2012-11-10,1,11,3,0,6,0,1,0.3,0.3333,0.81,0.0,9,11,20,20,4,Pagi
16139,2012-11-10,1,11,4,0,6,0,1,0.26,0.2727,0.87,0.1045,2,4,6,6,4,Pagi
16140,2012-11-10,1,11,5,0,6,0,1,0.28,0.3182,0.87,0.0,1,9,10,10,4,Pagi
16141,2012-11-10,1,11,6,0,6,0,1,0.24,0.2576,0.93,0.0896,5,11,16,16,4,Pagi
16142,2012-11-10,1,11,7,0,6,0,1,0.26,0.2727,0.87,0.1045,14,57,71,71,4,Siang
16143,2012-11-10,1,11,8,0,6,0,1,0.32,0.3485,0.76,0.0,16,130,146,146,4,Siang
16144,2012-11-10,1,11,9,0,6,0,1,0.36,0.3485,0.66,0.194,43,216,259,259,4,Siang
16145,2012-11-10,1,11,10,0,6,0,1,0.4,0.4091,0.58,0.0,86,264,350,350,4,Siang
16146,2012-11-10,1,11,11,0,6,0,1,0.4,0.4091,0.58,0.1045,143,323,466,466,4,Siang
16147,2012-11-10,1,11,12,0,6,0,1,0.48,0.4697,0.48,0.0,258,348,606,606,4,Siang
16148,2012-11-10,1,11,13,0,6,0,1,0.52,0.5,0.39,0.0,268,383,651,651,4,Sore
16149,2012-11-10,1,11,14,0,6,0,1,0.54,0.5152,0.37,0.0,280,347,627,627,4,Sore
16150,2012-11-10,1,11,15,0,6,0,1,0.52,0.5,0.45,0.0,216,351,567,567,4,Sore
16151,2012-11-10,1,11,16,0,6,0,1,0.54,0.5152,0.37,0.0,227,378,605,605,4,Sore
16152,2012-11-10,1,11,17,0,6,0,1,0.5,0.4848,0.45,0.194,183,318,501,501,4,Sore
16153,2012-11-10,1,11,18,0,6,0,1,0.44,0.4394,0.54,0.1343,103,256,359,359,4,Sore
16154,2012-11-10,1,11,19,0,6,0,1,0.46,0.4545,0.51,0.0896,55,228,283,283,4,Malam
16155,2012-11-10,1,11,20,0,6,0,1,0.44,0.4394,0.54,0.0,39,153,192,192,4,Malam
16156,2012-11-10,1,11,21,0,6,0,1,0.4,0.4091,0.66,0.0,51,169,220,220,4,Malam
16157,2012-11-10,1,11,22,0,6,0,1,0.38,0.3939,0.71,0.0896,39,154,193,193,4,Malam
16158,2012-11-10,1,11,23,0,6,0,1,0.36,0.3636,0.71,0.1045,26,120,146,146,4,Malam
16159,2012-11-11,1,11,0,0,0,0,1,0.34,0.3485,0.81,0.0896,14,110,124,124,4,
16160,2012-11-11,1,11,1,0,0,0,1,0.34,0.3485,0.76,0.0896,26,82,108,108,4,Pagi
16161,2012-11-11,1,11,2,0,0,0,1,0.32,0.3333,0.87,0.1045,12,58,70,70,4,Pagi
16162,2012-11-11,1,11,3,0,0,0,1,0.34,0.3636,0.81,0.0,9,39,48,48,4,Pagi
16163,2012-11-11,1,11,4,0,0,0,1,0.32,0.3333,0.81,0.1045,5,6,11,11,4,Pagi
16164,2012-11-11,1,11,5,0,0,0,1,0.3,0.303,0.87,0.1343,0,12,12,12,4,Pagi
16165,2012-11-11,1,11,6,0,0,0,1,0.3,0.3182,0.87,0.0896,3,16,19,19,4,Pagi
16166,2012-11-11,1,11,7,0,0,0,1,0.3,0.3182,0.89,0.0896,12,56,68,68,4,Siang
16167,2012-11-11,1,11,8,0,0,0,1,0.32,0.3333,0.87,0.1045,32,87,119,119,4,Siang
16168,2012-11-11,1,11,9,0,0,0,1,0.36,0.3788,0.77,0.0,94,179,273,273,4,Siang
16169,2012-11-11,1,11,10,0,0,0,1,0.4,0.4091,0.69,0.1045,133,272,405,405,4,Siang
16170,2012-11-11,1,11,11,0,0,0,1,0.46,0.4545,0.59,0.1343,180,324,504,504,4,Siang
16171,2012-11-11,1,11,12,0,0,0,1,0.5,0.4848,0.48,0.0896,195,390,585,585,4,Siang
16172,2012-11-11,1,11,13,0,0,0,1,0.54,0.5152,0.45,0.1045,262,424,686,686,4,Sore
16173,2012-11-11,1,11,14,0,0,0,1,0.6,0.6212,0.33,0.1642,292,362,654,654,4,Sore
16174,2012-11-11,1,11,15,0,0,0,1,0.56,0.5303,0.37,0.2239,304,420,724,724,4,Sore
16175,2012-11-11,1,11,16,0,0,0,1,0.54,0.5152,0.42,0.2239,260,393,653,653,4,Sore
16176,2012-11-11,1,11,17,0,0,0,1,0.54,0.5152,0.45,0.1642,151,342,493,493,4,Sore
16177,2012-11-11,1,11,18,0,0,0,1,0.52,0.5,0.45,0.1343,102,303,405,405,4,Sore
16178,2012-11-11,1,11,19,0,0,0,1,0.48,0.4697,0.55,0.1343,69,208,277,277,4,Malam
16179,2012-11-11,1,11,20,0,0,0,1,0.44,0.4394,0.62,0.1642,54,146,200,200,4,Malam
16180,2012-11-11,1,11,21,0,0,0,1,0.44,0.4394,0.67,0.2239,44,127,171,171,4,Malam
16181,2012-11-11,1,11,22,0,0,0,1,0.42,0.4242,0.71,0.194,21,113,134,134,4,Malam
16182,2012-11-11,1,11,23,0,0,0,1,0.42,0.4242,0.71,0.194,16,93,109,109,4,Malam
16183,2012-11-12,1,11,0,1,1,0,1,0.42,0.4242,0.71,0.1045,6,43,49,49,4,
16184,2012-11-12,1,11,1,1,1,0,1,0.4,0.4091,0.76,0.1642,4,26,30,30,4,Pagi
16185,2012-11-12,1,11,2,1,1,0,1,0.4,0.4091,0.76,0.1343,6,14,20,20,4,Pagi
16186,2012-11-12,1,11,3,1,1,0,1,0.4,0.4091,0.76,0.1343,1,3,4,4,4,Pagi
16187,2012-11-12,1,11,4,1,1,0,1,0.4,0.4091,0.76,0.0896,1,3,4,4,4,Pagi
16188,2012-11-12,1,11,5,1,1,0,1,0.38,0.3939,0.87,0.0,1,23,24,24,4,Pagi
16189,2012-11-12,1,11,6,1,1,0,1,0.38,0.3939,0.87,0.1045,7,64,71,71,4,Pagi
16190,2012-11-12,1,11,7,1,1,0,1,0.4,0.4091,0.87,0.0,16,248,264,264,4,Siang
16191,2012-11-12,1,11,8,1,1,0,1,0.42,0.4242,0.82,0.1642,50,490,540,540,4,Siang
16192,2012-11-12,1,11,9,1,1,0,1,0.44,0.4394,0.88,0.1045,60,337,397,397,4,Siang
16193,2012-11-12,1,11,10,1,1,0,1,0.48,0.4697,0.77,0.1642,82,184,266,266,4,Siang
16194,2012-11-12,1,11,11,1,1,0,1,0.52,0.5,0.72,0.1642,112,255,367,367,4,Siang
16195,2012-11-12,1,11,12,1,1,0,1,0.56,0.5303,0.64,0.2239,105,314,419,419,4,Siang
16196,2012-11-12,1,11,13,1,1,0,1,0.6,0.6061,0.6,0.2239,108,312,420,420,4,Sore
16197,2012-11-12,1,11,14,1,1,0,1,0.58,0.5455,0.6,0.2836,134,310,444,444,4,Sore
16198,2012-11-12,1,11,15,1,1,0,1,0.56,0.5303,0.64,0.2537,102,280,382,382,4,Sore
16199,2012-11-12,1,11,16,1,1,0,1,0.56,0.5303,0.64,0.1642,87,347,434,434,4,Sore
16200,2012-11-12,1,11,17,1,1,0,1,0.56,0.5303,0.64,0.2836,66,530,596,596,4,Sore
16201,2012-11-12,1,11,18,1,1,0,1,0.52,0.5,0.72,0.1343,65,486,551,551,4,Sore
16202,2012-11-12,1,11,19,1,1,0,1,0.54,0.5152,0.73,0.2836,30,323,353,353,4,Malam
16203,2012-11-12,1,11,20,1,1,0,2,0.52,0.5,0.77,0.2836,31,273,304,304,4,Malam
16204,2012-11-12,1,11,21,1,1,0,3,0.54,0.5152,0.73,0.2239,10,145,155,155,4,Malam
16205,2012-11-12,1,11,22,1,1,0,1,0.52,0.5,0.77,0.2537,12,100,112,112,4,Malam
16206,2012-11-12,1,11,23,1,1,0,2,0.54,0.5152,0.77,0.2239,1,62,63,63,4,Malam
16207,2012-11-13,1,11,0,0,2,1,2,0.52,0.5,0.83,0.2836,5,18,23,23,4,
16208,2012-11-13,1,11,1,0,2,1,3,0.44,0.4394,0.88,0.6418,0,5,5,5,4,Pagi
16209,2012-11-13,1,11,2,0,2,1,3,0.36,0.3182,0.87,0.4478,7,4,11,11,4,Pagi
16210,2012-11-13,1,11,3,0,2,1,3,0.36,0.3333,0.87,0.3582,2,3,5,5,4,Pagi
16211,2012-11-13,1,11,4,0,2,1,2,0.36,0.3333,0.81,0.3881,0,9,9,9,4,Pagi
16212,2012-11-13,1,11,5,0,2,1,2,0.34,0.3182,0.87,0.2836,0,18,18,18,4,Pagi
16213,2012-11-13,1,11,6,0,2,1,3,0.32,0.2879,0.81,0.4627,2,48,50,50,4,Pagi
16214,2012-11-13,1,11,7,0,2,1,3,0.32,0.303,0.87,0.2537,1,106,107,107,4,Siang
16215,2012-11-13,1,11,8,0,2,1,3,0.32,0.303,0.87,0.2537,4,207,211,211,4,Siang
16216,2012-11-13,1,11,9,0,2,1,3,0.32,0.303,0.81,0.3284,1,109,110,110,4,Siang
16217,2012-11-13,1,11,10,0,2,1,3,0.3,0.2727,0.75,0.3881,10,84,94,94,4,Siang
16218,2012-11-13,1,11,11,0,2,1,1,0.32,0.303,0.7,0.2537,22,133,155,155,4,Siang
16219,2012-11-13,1,11,12,0,2,1,1,0.34,0.3182,0.61,0.2836,16,180,196,196,4,Siang
16220,2012-11-13,1,11,13,0,2,1,1,0.34,0.3182,0.53,0.2537,30,188,218,218,4,Sore
16221,2012-11-13,1,11,14,0,2,1,1,0.38,0.3939,0.46,0.3881,34,169,203,203,4,Sore
16222,2012-11-13,1,11,15,0,2,1,1,0.4,0.4091,0.4,0.2985,33,184,217,217,4,Sore
16223,2012-11-13,1,11,16,0,2,1,1,0.38,0.3939,0.4,0.2985,28,282,310,310,4,Sore
16224,2012-11-13,1,11,17,0,2,1,1,0.34,0.303,0.49,0.3582,33,575,608,608,4,Sore
16225,2012-11-13,1,11,18,0,2,1,1,0.34,0.3182,0.49,0.2836,45,514,559,559,4,Sore
16226,2012-11-13,1,11,19,0,2,1,1,0.32,0.2879,0.49,0.3582,12,344,356,356,4,Malam
16227,2012-11-13,1,11,20,0,2,1,1,0.3,0.2727,0.49,0.3582,12,211,223,223,4,Malam
16228,2012-11-13,1,11,21,0,2,1,1,0.3,0.2727,0.49,0.3582,9,178,187,187,4,Malam
16229,2012-11-13,1,11,22,0,2,1,1,0.26,0.2273,0.56,0.3284,15,120,135,135,4,Malam
16230,2012-11-13,1,11,23,0,2,1,1,0.26,0.2273,0.56,0.2985,6,78,84,84,4,Malam
16231,2012-11-14,1,11,0,0,3,1,1,0.26,0.2424,0.56,0.2836,4,20,24,24,4,
16232,2012-11-14,1,11,1,0,3,1,1,0.24,0.2121,0.6,0.2985,2,10,12,12,4,Pagi
16233,2012-11-14,1,11,2,0,3,1,1,0.24,0.2121,0.6,0.2985,0,1,1,1,4,Pagi
16234,2012-11-14,1,11,3,0,3,1,1,0.24,0.2273,0.65,0.2239,0,5,5,5,4,Pagi
16235,2012-11-14,1,11,4,0,3,1,1,0.22,0.2273,0.69,0.194,0,6,6,6,4,Pagi
16236,2012-11-14,1,11,5,0,3,1,1,0.22,0.2273,0.69,0.194,0,39,39,39,4,Pagi
16237,2012-11-14,1,11,6,0,3,1,1,0.24,0.2273,0.65,0.194,4,142,146,146,4,Pagi
16238,2012-11-14,1,11,7,0,3,1,1,0.24,0.2121,0.65,0.2836,10,405,415,415,4,Siang
16239,2012-11-14,1,11,8,0,3,1,1,0.28,0.2576,0.56,0.2985,27,664,691,691,4,Siang
16240,2012-11-14,1,11,9,0,3,1,1,0.3,0.2727,0.52,0.3881,22,310,332,332,4,Siang
16241,2012-11-14,1,11,10,0,3,1,1,0.32,0.2879,0.45,0.3582,18,153,171,171,4,Siang
16242,2012-11-14,1,11,11,0,3,1,1,0.32,0.303,0.49,0.2537,25,126,151,151,4,Siang
16243,2012-11-14,1,11,12,0,3,1,1,0.34,0.3333,0.46,0.0,40,200,240,240,4,Siang
16244,2012-11-14,1,11,13,0,3,1,1,0.36,0.3333,0.43,0.2537,32,182,214,214,4,Sore
16245,2012-11-14,1,11,14,0,3,1,1,0.36,0.3485,0.43,0.1343,20,161,181,181,4,Sore
16246,2012-11-14,1,11,15,0,3,1,1,0.36,0.3333,0.43,0.2836,32,228,260,260,4,Sore
16247,2012-11-14,1,11,16,0,3,1,1,0.34,0.3485,0.46,0.1045,31,290,321,321,4,Sore
16248,2012-11-14,1,11,17,0,3,1,1,0.32,0.3182,0.49,0.194,19,564,583,583,4,Sore
16249,2012-11-14,1,11,18,0,3,1,1,0.32,0.3182,0.53,0.1642,24,543,567,567,4,Sore
16250,2012-11-14,1,11,19,0,3,1,1,0.3,0.303,0.52,0.1642,28,368,396,396,4,Malam
16251,2012-11-14,1,11,20,0,3,1,1,0.3,0.3182,0.52,0.0896,15,252,267,267,4,Malam
16252,2012-11-14,1,11,21,0,3,1,1,0.3,0.3333,0.56,0.0,5,208,213,213,4,Malam
16253,2012-11-14,1,11,22,0,3,1,1,0.28,0.3182,0.61,0.0,6,167,173,173,4,Malam
16254,2012-11-14,1,11,23,0,3,1,1,0.24,0.2424,0.7,0.1343,9,78,87,87,4,Malam
16255,2012-11-15,1,11,0,0,4,1,2,0.26,0.303,0.65,0.0,1,33,34,34,4,
16256,2012-11-15,1,11,1,0,4,1,2,0.26,0.2727,0.65,0.1045,2,14,16,16,4,Pagi
16257,2012-11-15,1,11,2,0,4,1,2,0.26,0.2576,0.7,0.1642,0,7,7,7,4,Pagi
16258,2012-11-15,1,11,3,0,4,1,2,0.26,0.2879,0.7,0.0896,0,2,2,2,4,Pagi
16259,2012-11-15,1,11,4,0,4,1,2,0.28,0.2879,0.65,0.1343,0,5,5,5,4,Pagi
16260,2012-11-15,1,11,5,0,4,1,2,0.3,0.2879,0.61,0.2239,3,34,37,37,4,Pagi
16261,2012-11-15,1,11,6,0,4,1,2,0.3,0.2879,0.65,0.2537,1,146,147,147,4,Pagi
16262,2012-11-15,1,11,7,0,4,1,2,0.3,0.2879,0.65,0.194,7,403,410,410,4,Siang
16263,2012-11-15,1,11,8,0,4,1,2,0.3,0.2879,0.61,0.2239,21,625,646,646,4,Siang
16264,2012-11-15,1,11,9,0,4,1,2,0.32,0.3182,0.61,0.194,17,306,323,323,4,Siang
16265,2012-11-15,1,11,10,0,4,1,2,0.32,0.3333,0.66,0.1343,11,142,153,153,4,Siang
16266,2012-11-15,1,11,11,0,4,1,2,0.34,0.3333,0.61,0.1343,28,138,166,166,4,Siang
16267,2012-11-15,1,11,12,0,4,1,2,0.36,0.3636,0.62,0.1045,29,184,213,213,4,Siang
16268,2012-11-15,1,11,13,0,4,1,2,0.38,0.3939,0.54,0.1045,20,197,217,217,4,Sore
16269,2012-11-15,1,11,14,0,4,1,2,0.38,0.3939,0.54,0.1642,27,174,201,201,4,Sore
16270,2012-11-15,1,11,15,0,4,1,2,0.38,0.3939,0.58,0.1642,26,191,217,217,4,Sore
16271,2012-11-15,1,11,16,0,4,1,2,0.36,0.3485,0.57,0.194,24,318,342,342,4,Sore
16272,2012-11-15,1,11,17,0,4,1,2,0.36,0.3485,0.57,0.2239,22,541,563,563,4,Sore
16273,2012-11-15,1,11,18,0,4,1,2,0.36,0.3485,0.57,0.194,10,563,573,573,4,Sore
16274,2012-11-15,1,11,19,0,4,1,2,0.34,0.3333,0.61,0.1343,11,375,386,386,4,Malam
16275,2012-11-15,1,11,20,0,4,1,1,0.34,0.3485,0.61,0.1045,23,262,285,285,4,Malam
16276,2012-11-15,1,11,21,0,4,1,2,0.32,0.3333,0.66,0.1045,20,204,224,224,4,Malam
16277,2012-11-15,1,11,22,0,4,1,2,0.32,0.3182,0.66,0.1642,10,143,153,153,4,Malam
16278,2012-11-15,1,11,23,0,4,1,2,0.32,0.3182,0.61,0.1642,7,118,125,125,4,Malam
16279,2012-11-16,1,11,0,0,5,1,2,0.32,0.3333,0.66,0.1045,7,58,65,65,4,
16280,2012-11-16,1,11,1,0,5,1,2,0.3,0.3182,0.65,0.0896,5,16,21,21,4,Pagi
16281,2012-11-16,1,11,2,0,5,1,2,0.3,0.303,0.7,0.1642,0,9,9,9,4,Pagi
16282,2012-11-16,1,11,3,0,5,1,2,0.3,0.303,0.65,0.1343,0,6,6,6,4,Pagi
16283,2012-11-16,1,11,4,0,5,1,2,0.3,0.3182,0.65,0.1045,0,5,5,5,4,Pagi
16284,2012-11-16,1,11,5,0,5,1,2,0.3,0.3182,0.65,0.0896,2,34,36,36,4,Pagi
16285,2012-11-16,1,11,6,0,5,1,2,0.3,0.3182,0.61,0.0896,4,126,130,130,4,Pagi
16286,2012-11-16,1,11,7,0,5,1,2,0.3,0.303,0.61,0.1642,5,362,367,367,4,Siang
16287,2012-11-16,1,11,8,0,5,1,2,0.32,0.3333,0.57,0.1343,17,694,711,711,4,Siang
16288,2012-11-16,1,11,9,0,5,1,1,0.34,0.3485,0.53,0.1045,21,330,351,351,4,Siang
16289,2012-11-16,1,11,10,0,5,1,1,0.34,0.3333,0.53,0.194,33,165,198,198,4,Siang
16290,2012-11-16,1,11,11,0,5,1,1,0.38,0.3939,0.43,0.2239,33,185,218,218,4,Siang
16291,2012-11-16,1,11,12,0,5,1,1,0.4,0.4091,0.43,0.2836,28,262,290,290,4,Siang
16292,2012-11-16,1,11,13,0,5,1,1,0.42,0.4242,0.38,0.194,52,226,278,278,4,Sore
16293,2012-11-16,1,11,14,0,5,1,1,0.42,0.4242,0.35,0.1045,47,204,251,251,4,Sore
16294,2012-11-16,1,11,15,0,5,1,1,0.42,0.4242,0.38,0.1343,30,237,267,267,4,Sore
16295,2012-11-16,1,11,16,0,5,1,1,0.42,0.4242,0.35,0.2836,33,350,383,383,4,Sore
16296,2012-11-16,1,11,17,0,5,1,1,0.36,0.3485,0.46,0.194,41,539,580,580,4,Sore
16297,2012-11-16,1,11,18,0,5,1,1,0.34,0.3333,0.53,0.1642,22,483,505,505,4,Sore
16298,2012-11-16,1,11,19,0,5,1,1,0.36,0.3485,0.46,0.2239,26,306,332,332,4,Malam
16299,2012-11-16,1,11,20,0,5,1,1,0.36,0.3333,0.46,0.2537,20,207,227,227,4,Malam
16300,2012-11-16,1,11,21,0,5,1,1,0.34,0.3333,0.49,0.194,21,157,178,178,4,Malam
16301,2012-11-16,1,11,22,0,5,1,1,0.32,0.303,0.53,0.2537,23,139,162,162,4,Malam
16302,2012-11-16,1,11,23,0,5,1,1,0.32,0.303,0.53,0.2239,14,114,128,128,4,Malam
16303,2012-11-17,1,11,0,0,6,0,1,0.3,0.303,0.52,0.1642,11,95,106,106,4,
16304,2012-11-17,1,11,1,0,6,0,1,0.26,0.2576,0.6,0.194,13,74,87,87,4,Pagi
16305,2012-11-17,1,11,2,0,6,0,1,0.26,0.2576,0.65,0.194,8,41,49,49,4,Pagi
16306,2012-11-17,1,11,3,0,6,0,1,0.26,0.2576,0.65,0.194,2,19,21,21,4,Pagi
16307,2012-11-17,1,11,4,0,6,0,1,0.24,0.2273,0.7,0.194,1,6,7,7,4,Pagi
16308,2012-11-17,1,11,5,0,6,0,1,0.24,0.2424,0.7,0.1642,1,10,11,11,4,Pagi
16309,2012-11-17,1,11,6,0,6,0,1,0.24,0.2273,0.7,0.2239,0,21,21,21,4,Pagi
16310,2012-11-17,1,11,7,0,6,0,1,0.24,0.2273,0.7,0.194,8,70,78,78,4,Siang
16311,2012-11-17,1,11,8,0,6,0,1,0.26,0.2576,0.65,0.2239,30,138,168,168,4,Siang
16312,2012-11-17,1,11,9,0,6,0,1,0.34,0.3182,0.49,0.2239,48,200,248,248,4,Siang
16313,2012-11-17,1,11,10,0,6,0,1,0.36,0.3333,0.46,0.2537,62,258,320,320,4,Siang
16314,2012-11-17,1,11,11,0,6,0,1,0.38,0.3939,0.43,0.194,80,343,423,423,4,Siang
16315,2012-11-17,1,11,12,0,6,0,1,0.4,0.4091,0.4,0.1642,117,359,476,476,4,Siang
16316,2012-11-17,1,11,13,0,6,0,1,0.42,0.4242,0.38,0.2537,179,346,525,525,4,Sore
16317,2012-11-17,1,11,14,0,6,0,1,0.42,0.4242,0.38,0.194,175,380,555,555,4,Sore
16318,2012-11-17,1,11,15,0,6,0,1,0.42,0.4242,0.35,0.2985,175,374,549,549,4,Sore
16319,2012-11-17,1,11,16,0,6,0,1,0.4,0.4091,0.4,0.2239,144,325,469,469,4,Sore
16320,2012-11-17,1,11,17,0,6,0,1,0.38,0.3939,0.4,0.1642,101,302,403,403,4,Sore
16321,2012-11-17,1,11,18,0,6,0,1,0.36,0.3636,0.5,0.1045,34,237,271,271,4,Sore
16322,2012-11-17,1,11,19,0,6,0,1,0.34,0.3485,0.53,0.0896,45,208,253,253,4,Malam
16323,2012-11-17,1,11,20,0,6,0,2,0.34,0.3485,0.66,0.0896,30,142,172,172,4,Malam
16324,2012-11-17,1,11,21,0,6,0,2,0.32,0.3333,0.57,0.1045,15,124,139,139,4,Malam
16325,2012-11-17,1,11,22,0,6,0,2,0.32,0.3333,0.57,0.1045,15,130,145,145,4,Malam
16326,2012-11-17,1,11,23,0,6,0,2,0.3,0.3182,0.7,0.1045,19,114,133,133,4,Malam
16327,2012-11-18,1,11,0,0,0,0,2,0.3,0.303,0.7,0.1642,11,118,129,129,4,
16328,2012-11-18,1,11,1,0,0,0,1,0.3,0.2879,0.7,0.194,14,81,95,95,4,Pagi
16329,2012-11-18,1,11,2,0,0,0,1,0.28,0.2879,0.81,0.1045,8,65,73,73,4,Pagi
16330,2012-11-18,1,11,3,0,0,0,2,0.3,0.303,0.81,0.1642,9,37,46,46,4,Pagi
16331,2012-11-18,1,11,4,0,0,0,2,0.3,0.2879,0.81,0.194,4,8,12,12,4,Pagi
16332,2012-11-18,1,11,5,0,0,0,1,0.28,0.2879,0.81,0.1343,5,7,12,12,4,Pagi
16333,2012-11-18,1,11,6,0,0,0,1,0.28,0.2727,0.81,0.1642,2,13,15,15,4,Pagi
16334,2012-11-18,1,11,7,0,0,0,1,0.28,0.2727,0.81,0.194,3,39,42,42,4,Siang
16335,2012-11-18,1,11,8,0,0,0,1,0.3,0.2879,0.75,0.2537,19,100,119,119,4,Siang
16336,2012-11-18,1,11,9,0,0,0,1,0.32,0.303,0.7,0.2537,49,155,204,204,4,Siang
16337,2012-11-18,1,11,10,0,0,0,1,0.34,0.303,0.66,0.2985,79,250,329,329,4,Siang
16338,2012-11-18,1,11,11,0,0,0,1,0.38,0.3939,0.62,0.2836,92,267,359,359,4,Siang
16339,2012-11-18,1,11,12,0,0,0,1,0.4,0.4091,0.62,0.2836,101,341,442,442,4,Siang
16340,2012-11-18,1,11,13,0,0,0,1,0.4,0.4091,0.62,0.3284,113,334,447,447,4,Sore
16341,2012-11-18,1,11,14,0,0,0,1,0.4,0.4091,0.62,0.2985,125,303,428,428,4,Sore
16342,2012-11-18,1,11,15,0,0,0,1,0.42,0.4242,0.54,0.2836,89,318,407,407,4,Sore
16343,2012-11-18,1,11,16,0,0,0,2,0.4,0.4091,0.62,0.3284,59,313,372,372,4,Sore
16344,2012-11-18,1,11,17,0,0,0,2,0.38,0.3939,0.66,0.2537,48,232,280,280,4,Sore
16345,2012-11-18,1,11,18,0,0,0,1,0.36,0.3485,0.66,0.2239,36,240,276,276,4,Sore
16346,2012-11-18,1,11,19,0,0,0,1,0.36,0.3485,0.66,0.1642,16,194,210,210,4,Malam
16347,2012-11-18,1,11,20,0,0,0,1,0.36,0.3485,0.66,0.1642,9,120,129,129,4,Malam
16348,2012-11-18,1,11,21,0,0,0,1,0.36,0.3333,0.66,0.2537,17,93,110,110,4,Malam
16349,2012-11-18,1,11,22,0,0,0,2,0.36,0.3333,0.66,0.2537,8,66,74,74,4,Malam
16350,2012-11-18,1,11,23,0,0,0,1,0.36,0.3485,0.66,0.2239,6,53,59,59,4,Malam
16351,2012-11-19,1,11,0,0,1,1,1,0.36,0.3485,0.66,0.2239,5,22,27,27,4,
16352,2012-11-19,1,11,1,0,1,1,2,0.36,0.3485,0.66,0.2239,0,19,19,19,4,Pagi
16353,2012-11-19,1,11,2,0,1,1,2,0.36,0.3333,0.66,0.2537,0,5,5,5,4,Pagi
16354,2012-11-19,1,11,3,0,1,1,2,0.36,0.3485,0.66,0.2239,0,2,2,2,4,Pagi
16355,2012-11-19,1,11,4,0,1,1,2,0.36,0.3485,0.66,0.2239,1,11,12,12,4,Pagi
16356,2012-11-19,1,11,5,0,1,1,2,0.36,0.3485,0.66,0.2239,1,38,39,39,4,Pagi
16357,2012-11-19,1,11,6,0,1,1,2,0.36,0.3333,0.66,0.2537,3,128,131,131,4,Pagi
16358,2012-11-19,1,11,7,0,1,1,2,0.36,0.3333,0.66,0.2985,5,381,386,386,4,Siang
16359,2012-11-19,1,11,8,0,1,1,2,0.36,0.3333,0.66,0.2985,13,650,663,663,4,Siang
16360,2012-11-19,1,11,9,0,1,1,2,0.36,0.3333,0.66,0.2537,18,260,278,278,4,Siang
16361,2012-11-19,1,11,10,0,1,1,2,0.36,0.3333,0.66,0.2537,33,106,139,139,4,Siang
16362,2012-11-19,1,11,11,0,1,1,2,0.38,0.3939,0.66,0.2537,33,164,197,197,4,Siang
16363,2012-11-19,1,11,12,0,1,1,2,0.4,0.4091,0.62,0.2836,35,207,242,242,4,Siang
16364,2012-11-19,1,11,13,0,1,1,1,0.44,0.4394,0.54,0.2537,46,205,251,251,4,Sore
16365,2012-11-19,1,11,14,0,1,1,1,0.44,0.4394,0.54,0.2537,47,170,217,217,4,Sore
16366,2012-11-19,1,11,15,0,1,1,1,0.44,0.4394,0.54,0.194,44,213,257,257,4,Sore
16367,2012-11-19,1,11,16,0,1,1,1,0.42,0.4242,0.58,0.2537,55,325,380,380,4,Sore
16368,2012-11-19,1,11,17,0,1,1,2,0.42,0.4242,0.58,0.194,33,586,619,619,4,Sore
16369,2012-11-19,1,11,18,0,1,1,2,0.4,0.4091,0.58,0.2537,21,559,580,580,4,Sore
16370,2012-11-19,1,11,19,0,1,1,2,0.4,0.4091,0.58,0.2836,25,381,406,406,4,Malam
16371,2012-11-19,1,11,20,0,1,1,2,0.38,0.3939,0.62,0.2537,7,252,259,259,4,Malam
16372,2012-11-19,1,11,21,0,1,1,2,0.38,0.3939,0.54,0.2239,15,188,203,203,4,Malam
16373,2012-11-19,1,11,22,0,1,1,1,0.34,0.3485,0.66,0.1045,7,106,113,113,4,Malam
16374,2012-11-19,1,11,23,0,1,1,1,0.34,0.3485,0.66,0.1045,2,72,74,74,4,Malam
16375,2012-11-20,1,11,0,0,2,1,1,0.32,0.3333,0.7,0.1343,3,26,29,29,4,
16376,2012-11-20,1,11,1,0,2,1,1,0.34,0.3485,0.66,0.1045,3,10,13,13,4,Pagi
16377,2012-11-20,1,11,2,0,2,1,2,0.32,0.3333,0.76,0.0896,0,5,5,5,4,Pagi
16378,2012-11-20,1,11,3,0,2,1,2,0.34,0.3485,0.71,0.1045,0,2,2,2,4,Pagi
16379,2012-11-20,1,11,4,0,2,1,2,0.34,0.3333,0.66,0.194,0,6,6,6,4,Pagi
16380,2012-11-20,1,11,5,0,2,1,2,0.34,0.3333,0.66,0.1343,2,32,34,34,4,Pagi
16381,2012-11-20,1,11,6,0,2,1,2,0.34,0.3333,0.71,0.1642,2,146,148,148,4,Pagi
16382,2012-11-20,1,11,7,0,2,1,1,0.32,0.3333,0.76,0.0896,7,411,418,418,4,Siang
16383,2012-11-20,1,11,8,0,2,1,1,0.34,0.3333,0.71,0.1343,16,649,665,665,4,Siang
16384,2012-11-20,1,11,9,0,2,1,2,0.36,0.3788,0.71,0.0,28,298,326,326,4,Siang
16385,2012-11-20,1,11,10,0,2,1,2,0.4,0.4091,0.66,0.0896,32,144,176,176,4,Siang
16386,2012-11-20,1,11,11,0,2,1,2,0.42,0.4242,0.67,0.0896,45,160,205,205,4,Siang
16387,2012-11-20,1,11,12,0,2,1,2,0.42,0.4242,0.67,0.0,70,243,313,313,4,Siang
16388,2012-11-20,1,11,13,0,2,1,2,0.44,0.4394,0.58,0.0,49,218,267,267,4,Sore
16389,2012-11-20,1,11,14,0,2,1,2,0.44,0.4394,0.58,0.1045,47,177,224,224,4,Sore
16390,2012-11-20,1,11,15,0,2,1,2,0.46,0.4545,0.55,0.1045,61,226,287,287,4,Sore
16391,2012-11-20,1,11,16,0,2,1,2,0.42,0.4242,0.62,0.0896,60,335,395,395,4,Sore
16392,2012-11-20,1,11,17,0,2,1,2,0.4,0.4091,0.71,0.1642,37,553,590,590,4,Sore
16393,2012-11-20,1,11,18,0,2,1,2,0.4,0.4091,0.66,0.0896,16,534,550,550,4,Sore
16394,2012-11-20,1,11,19,0,2,1,2,0.4,0.4091,0.71,0.0,23,361,384,384,4,Malam
16395,2012-11-20,1,11,20,0,2,1,2,0.38,0.3939,0.76,0.0,11,224,235,235,4,Malam
16396,2012-11-20,1,11,21,0,2,1,1,0.36,0.3788,0.71,0.0,14,143,157,157,4,Malam
16397,2012-11-20,1,11,22,0,2,1,1,0.36,0.3788,0.71,0.0,7,115,122,122,4,Malam
16398,2012-11-20,1,11,23,0,2,1,1,0.32,0.3333,0.81,0.1045,1,82,83,83,4,Malam
16399,2012-11-21,1,11,0,0,3,1,1,0.34,0.3636,0.81,0.0,1,25,26,26,4,
16400,2012-11-21,1,11,1,0,3,1,1,0.32,0.3333,0.81,0.1045,1,13,14,14,4,Pagi
16401,2012-11-21,1,11,2,0,3,1,1,0.28,0.2879,0.87,0.1045,2,6,8,8,4,Pagi
16402,2012-11-21,1,11,3,0,3,1,1,0.28,0.2879,0.87,0.1045,0,2,2,2,4,Pagi
16403,2012-11-21,1,11,4,0,3,1,1,0.28,0.2879,0.87,0.1045,0,10,10,10,4,Pagi
16404,2012-11-21,1,11,5,0,3,1,1,0.28,0.2879,0.87,0.1045,1,28,29,29,4,Pagi
16405,2012-11-21,1,11,6,0,3,1,1,0.28,0.303,0.87,0.0896,2,99,101,101,4,Pagi
16406,2012-11-21,1,11,7,0,3,1,1,0.26,0.2879,0.87,0.0896,11,262,273,273,4,Siang
16407,2012-11-21,1,11,8,0,3,1,2,0.28,0.303,0.81,0.0896,12,539,551,551,4,Siang
16408,2012-11-21,1,11,9,0,3,1,1,0.32,0.3333,0.76,0.0896,45,320,365,365,4,Siang
16409,2012-11-21,1,11,10,0,3,1,1,0.36,0.3788,0.62,0.0,22,150,172,172,4,Siang
16410,2012-11-21,1,11,11,0,3,1,1,0.4,0.4091,0.5,0.194,43,198,241,241,4,Siang
16411,2012-11-21,1,11,12,0,3,1,1,0.44,0.4394,0.41,0.194,74,270,344,344,4,Siang
16412,2012-11-21,1,11,13,0,3,1,1,0.44,0.4394,0.35,0.2239,70,295,365,365,4,Sore
16413,2012-11-21,1,11,14,0,3,1,1,0.46,0.4545,0.33,0.194,84,329,413,413,4,Sore
16414,2012-11-21,1,11,15,0,3,1,1,0.46,0.4545,0.36,0.0896,68,381,449,449,4,Sore
16415,2012-11-21,1,11,16,0,3,1,1,0.44,0.4394,0.33,0.1343,59,410,469,469,4,Sore
16416,2012-11-21,1,11,17,0,3,1,1,0.4,0.4091,0.4,0.1642,41,333,374,374,4,Sore
16417,2012-11-21,1,11,18,0,3,1,1,0.42,0.4242,0.38,0.1045,24,287,311,311,4,Sore
16418,2012-11-21,1,11,19,0,3,1,1,0.38,0.3939,0.43,0.194,23,220,243,243,4,Malam
16419,2012-11-21,1,11,20,0,3,1,1,0.34,0.3485,0.61,0.1045,11,125,136,136,4,Malam
16420,2012-11-21,1,11,21,0,3,1,1,0.36,0.3788,0.5,0.0,8,97,105,105,4,Malam
16421,2012-11-21,1,11,22,0,3,1,1,0.34,0.3636,0.49,0.0,6,82,88,88,4,Malam
16422,2012-11-21,1,11,23,0,3,1,1,0.32,0.3485,0.61,0.0,7,50,57,57,4,Malam
16423,2012-11-22,1,11,0,1,4,0,1,0.32,0.3333,0.66,0.0896,3,43,46,46,4,
16424,2012-11-22,1,11,1,1,4,0,1,0.28,0.303,0.65,0.0896,5,37,42,42,4,Pagi
16425,2012-11-22,1,11,2,1,4,0,1,0.24,0.2576,0.75,0.0896,3,15,18,18,4,Pagi
16426,2012-11-22,1,11,3,1,4,0,1,0.24,0.2576,0.75,0.1045,0,6,6,6,4,Pagi
16427,2012-11-22,1,11,4,1,4,0,1,0.22,0.2273,0.8,0.1343,1,2,3,3,4,Pagi
16428,2012-11-22,1,11,5,1,4,0,1,0.24,0.2576,0.75,0.1045,2,6,8,8,4,Pagi
16429,2012-11-22,1,11,6,1,4,0,1,0.26,0.2727,0.7,0.1045,2,15,17,17,4,Pagi
16430,2012-11-22,1,11,7,1,4,0,1,0.22,0.2273,0.75,0.1343,7,49,56,56,4,Siang
16431,2012-11-22,1,11,8,1,4,0,1,0.24,0.2424,0.75,0.1343,20,77,97,97,4,Siang
16432,2012-11-22,1,11,9,1,4,0,1,0.3,0.3333,0.65,0.0,25,94,119,119,4,Siang
16433,2012-11-22,1,11,10,1,4,0,1,0.36,0.3636,0.57,0.1045,65,154,219,219,4,Siang
16434,2012-11-22,1,11,11,1,4,0,1,0.42,0.4242,0.41,0.0896,89,143,232,232,4,Siang
16435,2012-11-22,1,11,12,1,4,0,1,0.44,0.4394,0.35,0.0,117,145,262,262,4,Siang
16436,2012-11-22,1,11,13,1,4,0,1,0.46,0.4545,0.31,0.0,125,144,269,269,4,Sore
16437,2012-11-22,1,11,14,1,4,0,1,0.48,0.4697,0.29,0.0,125,95,220,220,4,Sore
16438,2012-11-22,1,11,15,1,4,0,1,0.48,0.4697,0.29,0.0,132,96,228,228,4,Sore
16439,2012-11-22,1,11,16,1,4,0,1,0.46,0.4545,0.33,0.0,101,81,182,182,4,Sore
16440,2012-11-22,1,11,17,1,4,0,1,0.44,0.4394,0.35,0.0,66,43,109,109,4,Sore
16441,2012-11-22,1,11,18,1,4,0,1,0.4,0.4091,0.43,0.0,16,54,70,70,4,Sore
16442,2012-11-22,1,11,19,1,4,0,1,0.36,0.3788,0.76,0.0,13,31,44,44,4,Malam
16443,2012-11-22,1,11,20,1,4,0,1,0.34,0.3636,0.71,0.0,15,37,52,52,4,Malam
16444,2012-11-22,1,11,21,1,4,0,1,0.34,0.3485,0.61,0.0896,7,39,46,46,4,Malam
16445,2012-11-22,1,11,22,1,4,0,1,0.32,0.3485,0.61,0.0,8,36,44,44,4,Malam
16446,2012-11-22,1,11,23,1,4,0,1,0.3,0.3333,0.7,0.0,8,28,36,36,4,Malam
16447,2012-11-23,1,11,0,0,5,1,1,0.28,0.3182,0.65,0.0,0,32,32,32,4,
16448,2012-11-23,1,11,1,0,5,1,1,0.28,0.303,0.81,0.0896,2,11,13,13,4,Pagi
16449,2012-11-23,1,11,2,0,5,1,1,0.26,0.2879,0.75,0.0896,1,4,5,5,4,Pagi
16450,2012-11-23,1,11,3,0,5,1,1,0.26,0.303,0.7,0.0,1,0,1,1,4,Pagi
16451,2012-11-23,1,11,4,0,5,1,1,0.24,0.2576,0.75,0.1045,1,3,4,4,4,Pagi
16452,2012-11-23,1,11,5,0,5,1,1,0.24,0.2879,0.81,0.0,0,10,10,10,4,Pagi
16453,2012-11-23,1,11,6,0,5,1,1,0.24,0.2879,0.81,0.0,0,20,20,20,4,Pagi
16454,2012-11-23,1,11,7,0,5,1,1,0.24,0.2879,0.81,0.0,5,72,77,77,4,Siang
16455,2012-11-23,1,11,8,0,5,1,1,0.24,0.2576,0.87,0.0896,11,83,94,94,4,Siang
16456,2012-11-23,1,11,9,0,5,1,1,0.28,0.2879,0.75,0.1045,32,80,112,112,4,Siang
16457,2012-11-23,1,11,10,0,5,1,1,0.34,0.3333,0.61,0.1642,87,114,201,201,4,Siang
16458,2012-11-23,1,11,11,0,5,1,1,0.4,0.4091,0.5,0.194,121,130,251,251,4,Siang
16459,2012-11-23,1,11,12,0,5,1,1,0.44,0.4394,0.38,0.2537,186,193,379,379,4,Siang
16460,2012-11-23,1,11,13,0,5,1,1,0.46,0.4545,0.38,0.2836,224,200,424,424,4,Sore
16461,2012-11-23,1,11,14,0,5,1,1,0.5,0.4848,0.36,0.2537,240,195,435,435,4,Sore
16462,2012-11-23,1,11,15,0,5,1,1,0.48,0.4697,0.41,0.2537,233,214,447,447,4,Sore
16463,2012-11-23,1,11,16,0,5,1,2,0.48,0.4697,0.41,0.1045,158,199,357,357,4,Sore
16464,2012-11-23,1,11,17,0,5,1,2,0.48,0.4697,0.39,0.0896,117,183,300,300,4,Sore
16465,2012-11-23,1,11,18,0,5,1,2,0.46,0.4545,0.44,0.0,50,158,208,208,4,Sore
16466,2012-11-23,1,11,19,0,5,1,2,0.46,0.4545,0.47,0.1642,33,121,154,154,4,Malam
16467,2012-11-23,1,11,20,0,5,1,1,0.46,0.4545,0.41,0.0896,42,100,142,142,4,Malam
16468,2012-11-23,1,11,21,0,5,1,1,0.46,0.4545,0.47,0.2537,23,75,98,98,4,Malam
16469,2012-11-23,1,11,22,0,5,1,1,0.44,0.4394,0.33,0.5224,16,63,79,79,4,Malam
16470,2012-11-23,1,11,23,0,5,1,1,0.42,0.4242,0.38,0.4478,20,47,67,67,4,Malam
16471,2012-11-24,1,11,0,0,6,0,1,0.4,0.4091,0.37,0.4179,9,33,42,42,4,
16472,2012-11-24,1,11,1,0,6,0,1,0.34,0.2879,0.42,0.4925,1,19,20,20,4,Pagi
16473,2012-11-24,1,11,2,0,6,0,1,0.32,0.2727,0.39,0.6119,10,22,32,32,4,Pagi
16474,2012-11-24,1,11,3,0,6,0,1,0.28,0.2576,0.41,0.3582,6,5,11,11,4,Pagi
16475,2012-11-24,1,11,4,0,6,0,1,0.26,0.2121,0.41,0.4478,1,2,3,3,4,Pagi
16476,2012-11-24,1,11,5,0,6,0,1,0.26,0.2273,0.41,0.3284,1,2,3,3,4,Pagi
16477,2012-11-24,1,11,6,0,6,0,1,0.24,0.2121,0.44,0.2836,1,9,10,10,4,Pagi
16478,2012-11-24,1,11,7,0,6,0,2,0.26,0.2273,0.41,0.3284,4,21,25,25,4,Siang
16479,2012-11-24,1,11,8,0,6,0,2,0.26,0.2121,0.44,0.4627,7,55,62,62,4,Siang
16480,2012-11-24,1,11,9,0,6,0,2,0.26,0.2121,0.41,0.4478,26,96,122,122,4,Siang
16481,2012-11-24,1,11,10,0,6,0,2,0.26,0.2273,0.44,0.2985,46,96,142,142,4,Siang
16482,2012-11-24,1,11,11,0,6,0,2,0.28,0.2576,0.41,0.2985,55,131,186,186,4,Siang
16483,2012-11-24,1,11,12,0,6,0,2,0.3,0.2576,0.36,0.6119,53,146,199,199,4,Siang
16484,2012-11-24,1,11,13,0,6,0,1,0.32,0.303,0.36,0.3284,64,161,225,225,4,Sore
16485,2012-11-24,1,11,14,0,6,0,1,0.32,0.2879,0.33,0.4627,58,149,207,207,4,Sore
16486,2012-11-24,1,11,15,0,6,0,1,0.3,0.2727,0.36,0.4627,59,139,198,198,4,Sore
16487,2012-11-24,1,11,16,0,6,0,1,0.28,0.2424,0.38,0.4478,43,127,170,170,4,Sore
16488,2012-11-24,1,11,17,0,6,0,1,0.26,0.2273,0.41,0.3881,29,97,126,126,4,Sore
16489,2012-11-24,1,11,18,0,6,0,1,0.26,0.2273,0.38,0.3881,22,123,145,145,4,Sore
16490,2012-11-24,1,11,19,0,6,0,1,0.26,0.2424,0.41,0.2537,9,74,83,83,4,Malam
16491,2012-11-24,1,11,20,0,6,0,1,0.24,0.2121,0.44,0.2836,3,55,58,58,4,Malam
16492,2012-11-24,1,11,21,0,6,0,1,0.24,0.2273,0.44,0.194,9,66,75,75,4,Malam
16493,2012-11-24,1,11,22,0,6,0,1,0.24,0.2273,0.44,0.2537,7,69,76,76,4,Malam
16494,2012-11-24,1,11,23,0,6,0,1,0.24,0.2273,0.44,0.194,9,48,57,57,4,Malam
16495,2012-11-25,1,11,0,0,0,0,1,0.22,0.2121,0.47,0.2537,3,31,34,34,4,
16496,2012-11-25,1,11,1,0,0,0,1,0.22,0.2273,0.44,0.194,4,32,36,36,4,Pagi
16497,2012-11-25,1,11,2,0,0,0,1,0.22,0.197,0.44,0.3582,1,27,28,28,4,Pagi
16498,2012-11-25,1,11,3,0,0,0,1,0.22,0.2727,0.44,0.0,0,8,8,8,4,Pagi
16499,2012-11-25,1,11,4,0,0,0,1,0.22,0.2727,0.44,0.0,1,1,2,2,4,Pagi
16500,2012-11-25,1,11,5,0,0,0,2,0.22,0.2273,0.47,0.1642,0,3,3,3,4,Pagi
16501,2012-11-25,1,11,6,0,0,0,2,0.22,0.2424,0.47,0.1045,1,10,11,11,4,Pagi
16502,2012-11-25,1,11,7,0,0,0,2,0.22,0.2424,0.51,0.1045,2,19,21,21,4,Siang
16503,2012-11-25,1,11,8,0,0,0,2,0.22,0.2273,0.51,0.194,2,32,34,34,4,Siang
16504,2012-11-25,1,11,9,0,0,0,2,0.24,0.2273,0.48,0.2239,13,83,96,96,4,Siang
16505,2012-11-25,1,11,10,0,0,0,1,0.24,0.2273,0.48,0.2537,15,124,139,139,4,Siang
16506,2012-11-25,1,11,11,0,0,0,2,0.26,0.2576,0.41,0.2239,49,155,204,204,4,Siang
16507,2012-11-25,1,11,12,0,0,0,2,0.26,0.2576,0.41,0.2239,37,165,202,202,4,Siang
16508,2012-11-25,1,11,13,0,0,0,2,0.26,0.2576,0.41,0.1642,37,158,195,195,4,Sore
16509,2012-11-25,1,11,14,0,0,0,2,0.3,0.2879,0.42,0.2537,33,170,203,203,4,Sore
16510,2012-11-25,1,11,15,0,0,0,1,0.3,0.2879,0.42,0.2537,36,209,245,245,4,Sore
16511,2012-11-25,1,11,16,0,0,0,1,0.3,0.2879,0.39,0.2239,25,203,228,228,4,Sore
16512,2012-11-25,1,11,17,0,0,0,1,0.28,0.2727,0.41,0.1642,11,170,181,181,4,Sore
16513,2012-11-25,1,11,18,0,0,0,1,0.26,0.2576,0.44,0.1642,9,132,141,141,4,Sore
16514,2012-11-25,1,11,19,0,0,0,1,0.26,0.303,0.41,0.0,13,114,127,127,4,Malam
16515,2012-11-25,1,11,20,0,0,0,1,0.24,0.2879,0.6,0.0,9,110,119,119,4,Malam
16516,2012-11-25,1,11,21,0,0,0,1,0.26,0.303,0.48,0.0,4,60,64,64,4,Malam
16517,2012-11-25,1,11,22,0,0,0,1,0.24,0.2879,0.6,0.0,3,59,62,62,4,Malam
16518,2012-11-25,1,11,23,0,0,0,1,0.22,0.2576,0.69,0.0896,1,40,41,41,4,Malam
16519,2012-11-26,1,11,0,0,1,1,1,0.22,0.2727,0.69,0.0,4,19,23,23,4,
16520,2012-11-26,1,11,1,0,1,1,1,0.2,0.2576,0.69,0.0,1,9,10,10,4,Pagi
16521,2012-11-26,1,11,2,0,1,1,1,0.2,0.2576,0.69,0.0,0,5,5,5,4,Pagi
16522,2012-11-26,1,11,3,0,1,1,1,0.2,0.2576,0.69,0.0,1,4,5,5,4,Pagi
16523,2012-11-26,1,11,4,0,1,1,1,0.22,0.2727,0.69,0.0,0,10,10,10,4,Pagi
16524,2012-11-26,1,11,5,0,1,1,1,0.22,0.2273,0.69,0.1642,0,41,41,41,4,Pagi
16525,2012-11-26,1,11,6,0,1,1,1,0.22,0.2727,0.69,0.0,1,123,124,124,4,Pagi
16526,2012-11-26,1,11,7,0,1,1,1,0.24,0.2879,0.65,0.0,2,363,365,365,4,Siang
16527,2012-11-26,1,11,8,0,1,1,1,0.24,0.2879,0.65,0.0,9,629,638,638,4,Siang
16528,2012-11-26,1,11,9,0,1,1,1,0.28,0.303,0.56,0.0896,10,276,286,286,4,Siang
16529,2012-11-26,1,11,10,0,1,1,1,0.32,0.3485,0.49,0.0,20,127,147,147,4,Siang
16530,2012-11-26,1,11,11,0,1,1,1,0.4,0.4091,0.37,0.2985,18,112,130,130,4,Siang
16531,2012-11-26,1,11,12,0,1,1,1,0.42,0.4242,0.35,0.1045,22,188,210,210,4,Siang
16532,2012-11-26,1,11,13,0,1,1,1,0.42,0.4242,0.35,0.1045,20,197,217,217,4,Sore
16533,2012-11-26,1,11,14,0,1,1,1,0.42,0.4242,0.35,0.0,51,177,228,228,4,Sore
16534,2012-11-26,1,11,15,0,1,1,1,0.42,0.4242,0.35,0.0896,49,181,230,230,4,Sore
16535,2012-11-26,1,11,16,0,1,1,1,0.44,0.4394,0.3,0.0,49,297,346,346,4,Sore
16536,2012-11-26,1,11,17,0,1,1,1,0.42,0.4242,0.32,0.0,13,540,553,553,4,Sore
16537,2012-11-26,1,11,18,0,1,1,1,0.36,0.3485,0.5,0.1642,19,502,521,521,4,Sore
16538,2012-11-26,1,11,19,0,1,1,1,0.34,0.3636,0.53,0.0,16,355,371,371,4,Malam
16539,2012-11-26,1,11,20,0,1,1,1,0.34,0.3636,0.49,0.0,12,265,277,277,4,Malam
16540,2012-11-26,1,11,21,0,1,1,1,0.34,0.3636,0.49,0.0,9,172,181,181,4,Malam
16541,2012-11-26,1,11,22,0,1,1,1,0.32,0.3485,0.61,0.0,3,101,104,104,4,Malam
16542,2012-11-26,1,11,23,0,1,1,2,0.32,0.3333,0.66,0.1045,8,57,65,65,4,Malam
16543,2012-11-27,1,11,0,0,2,1,2,0.32,0.3333,0.66,0.0896,2,24,26,26,4,
16544,2012-11-27,1,11,1,0,2,1,2,0.32,0.3333,0.7,0.1343,0,6,6,6,4,Pagi
16545,2012-11-27,1,11,2,0,2,1,2,0.32,0.3182,0.7,0.1642,0,5,5,5,4,Pagi
16546,2012-11-27,1,11,3,0,2,1,3,0.32,0.3333,0.7,0.1343,1,3,4,4,4,Pagi
16547,2012-11-27,1,11,4,0,2,1,3,0.3,0.2879,0.81,0.194,0,5,5,5,4,Pagi
16548,2012-11-27,1,11,5,0,2,1,2,0.3,0.2879,0.81,0.2239,0,31,31,31,4,Pagi
16549,2012-11-27,1,11,6,0,2,1,2,0.3,0.303,0.81,0.1642,3,97,100,100,4,Pagi
16550,2012-11-27,1,11,7,0,2,1,3,0.3,0.303,0.81,0.1343,4,289,293,293,4,Siang
16551,2012-11-27,1,11,8,0,2,1,3,0.32,0.3182,0.81,0.1642,6,494,500,500,4,Siang
16552,2012-11-27,1,11,9,0,2,1,2,0.32,0.3333,0.81,0.1343,11,257,268,268,4,Siang
16553,2012-11-27,1,11,10,0,2,1,3,0.32,0.3182,0.81,0.194,5,52,57,57,4,Siang
16554,2012-11-27,1,11,11,0,2,1,3,0.3,0.2727,0.87,0.2985,6,59,65,65,4,Siang
16555,2012-11-27,1,11,12,0,2,1,3,0.28,0.2576,0.87,0.3881,6,70,76,76,4,Siang
16556,2012-11-27,1,11,13,0,2,1,3,0.28,0.2727,0.87,0.2537,4,73,77,77,4,Sore
16557,2012-11-27,1,11,14,0,2,1,3,0.28,0.2576,0.87,0.3582,8,86,94,94,4,Sore
16558,2012-11-27,1,11,15,0,2,1,2,0.3,0.2727,0.75,0.2985,9,146,155,155,4,Sore
16559,2012-11-27,1,11,16,0,2,1,2,0.3,0.2727,0.75,0.2985,5,252,257,257,4,Sore
16560,2012-11-27,1,11,17,0,2,1,2,0.3,0.2727,0.75,0.3881,13,514,527,527,4,Sore
16561,2012-11-27,1,11,18,0,2,1,1,0.26,0.2273,0.81,0.3582,13,469,482,482,4,Sore
16562,2012-11-27,1,11,19,0,2,1,1,0.26,0.2576,0.73,0.2985,12,338,350,350,4,Malam
16563,2012-11-27,1,11,20,0,2,1,1,0.26,0.2273,0.75,0.3284,4,228,232,232,4,Malam
16564,2012-11-27,1,11,21,0,2,1,1,0.24,0.2121,0.81,0.2836,6,179,185,185,4,Malam
16565,2012-11-27,1,11,22,0,2,1,1,0.24,0.2424,0.81,0.1642,2,95,97,97,4,Malam
16566,2012-11-27,1,11,23,0,2,1,2,0.26,0.2424,0.81,0.2537,3,64,67,67,4,Malam
16567,2012-11-28,1,11,0,0,3,1,2,0.26,0.2424,0.75,0.2537,1,22,23,23,4,
16568,2012-11-28,1,11,1,0,3,1,2,0.26,0.2576,0.75,0.2239,0,12,12,12,4,Pagi
16569,2012-11-28,1,11,2,0,3,1,2,0.26,0.2576,0.75,0.2239,0,1,1,1,4,Pagi
16570,2012-11-28,1,11,3,0,3,1,2,0.26,0.2576,0.7,0.2239,0,3,3,3,4,Pagi
16571,2012-11-28,1,11,4,0,3,1,2,0.26,0.2576,0.7,0.194,0,4,4,4,4,Pagi
16572,2012-11-28,1,11,5,0,3,1,2,0.26,0.2727,0.7,0.1343,0,39,39,39,4,Pagi
16573,2012-11-28,1,11,6,0,3,1,2,0.26,0.2576,0.65,0.2239,4,132,136,136,4,Pagi
16574,2012-11-28,1,11,7,0,3,1,2,0.26,0.2576,0.56,0.194,6,403,409,409,4,Siang
16575,2012-11-28,1,11,8,0,3,1,1,0.24,0.2121,0.6,0.2836,9,683,692,692,4,Siang
16576,2012-11-28,1,11,9,0,3,1,1,0.28,0.2727,0.52,0.194,13,309,322,322,4,Siang
16577,2012-11-28,1,11,10,0,3,1,1,0.3,0.3182,0.49,0.1045,17,144,161,161,4,Siang
16578,2012-11-28,1,11,11,0,3,1,1,0.32,0.3182,0.45,0.1642,19,127,146,146,4,Siang
16579,2012-11-28,1,11,12,0,3,1,1,0.34,0.303,0.42,0.3881,19,189,208,208,4,Siang
16580,2012-11-28,1,11,13,0,3,1,1,0.34,0.3333,0.42,0.194,21,193,214,214,4,Sore
16581,2012-11-28,1,11,14,0,3,1,1,0.36,0.3333,0.4,0.2985,15,161,176,176,4,Sore
16582,2012-11-28,1,11,15,0,3,1,1,0.36,0.3333,0.32,0.3284,7,172,179,179,4,Sore
16583,2012-11-28,1,11,16,0,3,1,1,0.36,0.3333,0.29,0.2537,9,316,325,325,4,Sore
16584,2012-11-28,1,11,17,0,3,1,1,0.34,0.3333,0.31,0.1343,17,546,563,563,4,Sore
16585,2012-11-28,1,11,18,0,3,1,1,0.32,0.303,0.33,0.2836,12,530,542,542,4,Sore
16586,2012-11-28,1,11,19,0,3,1,1,0.32,0.3182,0.36,0.1642,9,378,387,387,4,Malam
16587,2012-11-28,1,11,20,0,3,1,1,0.32,0.3333,0.36,0.1343,5,258,263,263,4,Malam
16588,2012-11-28,1,11,21,0,3,1,1,0.3,0.303,0.39,0.1642,4,219,223,223,4,Malam
16589,2012-11-28,1,11,22,0,3,1,1,0.28,0.2727,0.45,0.1642,6,148,154,154,4,Malam
16590,2012-11-28,1,11,23,0,3,1,1,0.26,0.2727,0.48,0.1343,5,73,78,78,4,Malam
16591,2012-11-29,1,11,0,0,4,1,1,0.24,0.2576,0.56,0.0896,4,25,29,29,4,
16592,2012-11-29,1,11,1,0,4,1,1,0.22,0.2576,0.64,0.0896,1,15,16,16,4,Pagi
16593,2012-11-29,1,11,2,0,4,1,1,0.22,0.2727,0.64,0.0,1,6,7,7,4,Pagi
16594,2012-11-29,1,11,4,0,4,1,1,0.2,0.2273,0.75,0.0896,0,7,7,7,4,Pagi
16595,2012-11-29,1,11,5,0,4,1,1,0.2,0.2576,0.69,0.0,0,42,42,42,4,Pagi
16596,2012-11-29,1,11,6,0,4,1,1,0.22,0.2727,0.69,0.0,1,120,121,121,4,Pagi
16597,2012-11-29,1,11,7,0,4,1,1,0.2,0.2576,0.64,0.0,8,354,362,362,4,Siang
16598,2012-11-29,1,11,8,0,4,1,1,0.2,0.2273,0.69,0.1045,15,664,679,679,4,Siang
16599,2012-11-29,1,11,9,0,4,1,1,0.24,0.2879,0.6,0.0,13,286,299,299,4,Siang
16600,2012-11-29,1,11,10,0,4,1,1,0.28,0.303,0.65,0.0896,25,153,178,178,4,Siang
16601,2012-11-29,1,11,11,0,4,1,1,0.36,0.3485,0.37,0.2239,13,150,163,163,4,Siang
16602,2012-11-29,1,11,12,0,4,1,1,0.36,0.3485,0.4,0.1642,11,225,236,236,4,Siang
16603,2012-11-29,1,11,13,0,4,1,1,0.38,0.3939,0.32,0.1343,15,209,224,224,4,Sore
16604,2012-11-29,1,11,14,0,4,1,1,0.36,0.3485,0.43,0.2239,13,174,187,187,4,Sore
16605,2012-11-29,1,11,15,0,4,1,1,0.36,0.3333,0.43,0.2836,19,201,220,220,4,Sore
16606,2012-11-29,1,11,16,0,4,1,1,0.36,0.3485,0.4,0.2239,24,346,370,370,4,Sore
16607,2012-11-29,1,11,17,0,4,1,1,0.34,0.3333,0.39,0.194,17,544,561,561,4,Sore
16608,2012-11-29,1,11,18,0,4,1,1,0.32,0.3182,0.49,0.1642,17,520,537,537,4,Sore
16609,2012-11-29,1,11,19,0,4,1,1,0.3,0.2879,0.52,0.194,18,326,344,344,4,Malam
16610,2012-11-29,1,11,20,0,4,1,1,0.3,0.303,0.52,0.1642,11,241,252,252,4,Malam
16611,2012-11-29,1,11,21,0,4,1,1,0.26,0.2727,0.65,0.1343,7,201,208,208,4,Malam
16612,2012-11-29,1,11,22,0,4,1,1,0.26,0.2879,0.7,0.0896,4,147,151,151,4,Malam
16613,2012-11-29,1,11,23,0,4,1,1,0.28,0.3182,0.61,0.0,6,124,130,130,4,Malam
16614,2012-11-30,1,11,0,0,5,1,1,0.26,0.2576,0.7,0.1642,4,48,52,52,4,
16615,2012-11-30,1,11,1,0,5,1,1,0.24,0.2576,0.7,0.0896,2,17,19,19,4,Pagi
16616,2012-11-30,1,11,2,0,5,1,1,0.24,0.2879,0.75,0.0,2,10,12,12,4,Pagi
16617,2012-11-30,1,11,3,0,5,1,1,0.24,0.2879,0.75,0.0,0,4,4,4,4,Pagi
16618,2012-11-30,1,11,4,0,5,1,1,0.22,0.2727,0.75,0.0,0,3,3,3,4,Pagi
16619,2012-11-30,1,11,5,0,5,1,1,0.2,0.2576,0.8,0.0,1,39,40,40,4,Pagi
16620,2012-11-30,1,11,6,0,5,1,1,0.2,0.2576,0.86,0.0,2,104,106,106,4,Pagi
16621,2012-11-30,1,11,7,0,5,1,1,0.22,0.2727,0.8,0.0,6,346,352,352,4,Siang
16622,2012-11-30,1,11,8,0,5,1,2,0.22,0.2576,0.8,0.0896,20,709,729,729,4,Siang
16623,2012-11-30,1,11,9,0,5,1,1,0.24,0.2576,0.75,0.0896,17,313,330,330,4,Siang
16624,2012-11-30,1,11,10,0,5,1,2,0.3,0.3333,0.65,0.0,10,159,169,169,4,Siang
16625,2012-11-30,1,11,11,0,5,1,2,0.34,0.3485,0.53,0.0896,31,170,201,201,4,Siang
16626,2012-11-30,1,11,12,0,5,1,2,0.38,0.3939,0.46,0.0,25,243,268,268,4,Siang
16627,2012-11-30,1,11,13,0,5,1,2,0.4,0.4091,0.4,0.1642,21,241,262,262,4,Sore
16628,2012-11-30,1,11,14,0,5,1,2,0.4,0.4091,0.4,0.1045,26,225,251,251,4,Sore
16629,2012-11-30,1,11,15,0,5,1,2,0.42,0.4242,0.38,0.1045,34,262,296,296,4,Sore
16630,2012-11-30,1,11,16,0,5,1,1,0.4,0.4091,0.43,0.1343,37,368,405,405,4,Sore
16631,2012-11-30,1,11,17,0,5,1,1,0.36,0.3485,0.5,0.194,31,551,582,582,4,Sore
16632,2012-11-30,1,11,18,0,5,1,2,0.34,0.3636,0.61,0.0,20,489,509,509,4,Sore
16633,2012-11-30,1,11,19,0,5,1,1,0.32,0.3485,0.66,0.0,18,359,377,377,4,Malam
16634,2012-11-30,1,11,20,0,5,1,1,0.32,0.3485,0.66,0.0,12,233,245,245,4,Malam
16635,2012-11-30,1,11,21,0,5,1,1,0.3,0.3182,0.75,0.0896,14,169,183,183,4,Malam
16636,2012-11-30,1,11,22,0,5,1,1,0.3,0.3333,0.75,0.0,18,145,163,163,4,Malam
16637,2012-11-30,1,11,23,0,5,1,2,0.3,0.3182,0.75,0.0896,11,99,110,110,4,Malam
16638,2012-12-01,1,12,0,0,6,0,1,0.26,0.303,0.81,0.0,9,99,108,108,4,
16639,2012-12-01,1,12,1,0,6,0,1,0.26,0.303,0.81,0.0,5,64,69,69,4,Pagi
16640,2012-12-01,1,12,2,0,6,0,2,0.26,0.303,0.81,0.0,3,47,50,50,4,Pagi
16641,2012-12-01,1,12,3,0,6,0,2,0.26,0.2727,0.81,0.1343,1,14,15,15,4,Pagi
16642,2012-12-01,1,12,4,0,6,0,1,0.26,0.2879,0.81,0.0896,0,5,5,5,4,Pagi
16643,2012-12-01,1,12,5,0,6,0,1,0.24,0.2576,0.87,0.0896,1,12,13,13,4,Pagi
16644,2012-12-01,1,12,6,0,6,0,1,0.24,0.2424,0.87,0.1343,7,20,27,27,4,Pagi
16645,2012-12-01,1,12,7,0,6,0,2,0.24,0.2424,0.87,0.1343,7,56,63,63,4,Siang
16646,2012-12-01,1,12,8,0,6,0,2,0.24,0.2424,0.87,0.1343,11,133,144,144,4,Siang
16647,2012-12-01,1,12,9,0,6,0,2,0.26,0.2424,0.93,0.2537,34,159,193,193,4,Siang
16648,2012-12-01,1,12,10,0,6,0,2,0.28,0.2727,0.89,0.1642,45,211,256,256,4,Siang
16649,2012-12-01,1,12,11,0,6,0,2,0.32,0.3333,0.76,0.1045,74,318,392,392,4,Siang
16650,2012-12-01,1,12,12,0,6,0,2,0.32,0.3333,0.81,0.0896,119,327,446,446,4,Siang
16651,2012-12-01,1,12,13,0,6,0,2,0.34,0.3636,0.76,0.0,123,386,509,509,4,Sore
16652,2012-12-01,1,12,14,0,6,0,2,0.36,0.3788,0.71,0.0,110,369,479,479,4,Sore
16653,2012-12-01,1,12,15,0,6,0,2,0.4,0.4091,0.62,0.0,113,371,484,484,4,Sore
16654,2012-12-01,1,12,16,0,6,0,2,0.38,0.3939,0.66,0.0,89,354,443,443,4,Sore
16655,2012-12-01,1,12,17,0,6,0,2,0.34,0.3485,0.76,0.1045,50,270,320,320,4,Sore
16656,2012-12-01,1,12,18,0,6,0,2,0.34,0.3636,0.76,0.0,42,255,297,297,4,Sore
16657,2012-12-01,1,12,19,0,6,0,2,0.32,0.3485,0.81,0.0,30,219,249,249,4,Malam
16658,2012-12-01,1,12,20,0,6,0,1,0.32,0.3485,0.81,0.0,28,170,198,198,4,Malam
16659,2012-12-01,1,12,21,0,6,0,2,0.3,0.3333,0.87,0.0,23,135,158,158,4,Malam
16660,2012-12-01,1,12,22,0,6,0,2,0.3,0.3333,0.87,0.0,17,130,147,147,4,Malam
16661,2012-12-01,1,12,23,0,6,0,2,0.32,0.3485,0.81,0.0,10,116,126,126,4,Malam
16662,2012-12-02,1,12,0,0,0,0,2,0.3,0.3182,0.87,0.0896,9,108,117,117,4,
16663,2012-12-02,1,12,1,0,0,0,2,0.3,0.3182,0.87,0.0896,10,84,94,94,4,Pagi
16664,2012-12-02,1,12,2,0,0,0,2,0.3,0.3333,0.87,0.0,2,72,74,74,4,Pagi
16665,2012-12-02,1,12,3,0,0,0,2,0.26,0.303,0.93,0.0,4,21,25,25,4,Pagi
16666,2012-12-02,1,12,4,0,0,0,2,0.26,0.303,0.93,0.0,1,6,7,7,4,Pagi
16667,2012-12-02,1,12,5,0,0,0,2,0.26,0.303,0.93,0.0,1,7,8,8,4,Pagi
16668,2012-12-02,1,12,6,0,0,0,2,0.24,0.2424,0.93,0.1343,1,15,16,16,4,Pagi
16669,2012-12-02,1,12,7,0,0,0,2,0.24,0.2424,0.93,0.1343,5,26,31,31,4,Siang
16670,2012-12-02,1,12,8,0,0,0,2,0.26,0.2879,0.93,0.0896,12,81,93,93,4,Siang
16671,2012-12-02,1,12,9,0,0,0,2,0.28,0.2727,0.93,0.1642,37,135,172,172,4,Siang
16672,2012-12-02,1,12,10,0,0,0,2,0.3,0.3333,0.87,0.0,63,230,293,293,4,Siang
16673,2012-12-02,1,12,11,0,0,0,2,0.32,0.3182,0.81,0.1642,81,274,355,355,4,Siang
16674,2012-12-02,1,12,12,0,0,0,2,0.34,0.3333,0.81,0.1642,111,409,520,520,4,Siang
16675,2012-12-02,1,12,13,0,0,0,1,0.4,0.4091,0.71,0.2239,84,347,431,431,4,Sore
16676,2012-12-02,1,12,14,0,0,0,1,0.44,0.4394,0.62,0.2537,142,331,473,473,4,Sore
16677,2012-12-02,1,12,15,0,0,0,1,0.44,0.4394,0.67,0.1343,106,311,417,417,4,Sore
16678,2012-12-02,1,12,16,0,0,0,2,0.44,0.4394,0.67,0.1045,85,358,443,443,4,Sore
16679,2012-12-02,1,12,17,0,0,0,3,0.4,0.4091,0.76,0.194,59,244,303,303,4,Sore
16680,2012-12-02,1,12,18,0,0,0,2,0.44,0.4394,0.72,0.1045,25,178,203,203,4,Sore
16681,2012-12-02,1,12,19,0,0,0,2,0.4,0.4091,0.82,0.194,16,158,174,174,4,Malam
16682,2012-12-02,1,12,20,0,0,0,2,0.42,0.4242,0.82,0.194,12,142,154,154,4,Malam
16683,2012-12-02,1,12,21,0,0,0,2,0.44,0.4394,0.77,0.2239,8,91,99,99,4,Malam
16684,2012-12-02,1,12,22,0,0,0,2,0.44,0.4394,0.77,0.194,11,85,96,96,4,Malam
16685,2012-12-02,1,12,23,0,0,0,2,0.42,0.4242,0.82,0.1343,7,44,51,51,4,Malam
16686,2012-12-03,1,12,0,0,1,1,2,0.42,0.4242,0.82,0.1642,3,18,21,21,4,
16687,2012-12-03,1,12,1,0,1,1,1,0.4,0.4091,0.82,0.1343,2,11,13,13,4,Pagi
16688,2012-12-03,1,12,2,0,1,1,1,0.42,0.4242,0.77,0.1642,1,9,10,10,4,Pagi
16689,2012-12-03,1,12,3,0,1,1,1,0.38,0.3939,0.87,0.0,2,6,8,8,4,Pagi
16690,2012-12-03,1,12,4,0,1,1,1,0.36,0.3788,0.93,0.0,1,4,5,5,4,Pagi
16691,2012-12-03,1,12,5,0,1,1,1,0.34,0.3485,0.93,0.0896,0,38,38,38,4,Pagi
16692,2012-12-03,1,12,6,0,1,1,1,0.36,0.3788,0.93,0.0,2,136,138,138,4,Pagi
16693,2012-12-03,1,12,7,0,1,1,2,0.34,0.3636,0.93,0.0,9,387,396,396,4,Siang
16694,2012-12-03,1,12,8,0,1,1,1,0.36,0.3788,0.93,0.0,19,712,731,731,4,Siang
16695,2012-12-03,1,12,9,0,1,1,1,0.4,0.4091,0.87,0.0896,19,289,308,308,4,Siang
16696,2012-12-03,1,12,10,0,1,1,1,0.44,0.4394,0.77,0.1343,31,105,136,136,4,Siang
16697,2012-12-03,1,12,11,0,1,1,1,0.48,0.4697,0.77,0.1343,51,182,233,233,4,Siang
16698,2012-12-03,1,12,12,0,1,1,1,0.52,0.5,0.68,0.1642,40,228,268,268,4,Siang
16699,2012-12-03,1,12,13,0,1,1,1,0.58,0.5455,0.56,0.0896,81,240,321,321,4,Sore
16700,2012-12-03,1,12,14,0,1,1,1,0.6,0.6212,0.53,0.0,51,209,260,260,4,Sore
16701,2012-12-03,1,12,15,0,1,1,1,0.6,0.6212,0.56,0.0,58,210,268,268,4,Sore
16702,2012-12-03,1,12,16,0,1,1,1,0.6,0.6212,0.53,0.1343,45,397,442,442,4,Sore
16703,2012-12-03,1,12,17,0,1,1,1,0.52,0.5,0.63,0.1045,43,665,708,708,4,Sore
16704,2012-12-03,1,12,18,0,1,1,1,0.5,0.4848,0.68,0.0896,26,666,692,692,4,Sore
16705,2012-12-03,1,12,19,0,1,1,1,0.5,0.4848,0.68,0.0896,27,444,471,471,4,Malam
16706,2012-12-03,1,12,20,0,1,1,2,0.46,0.4545,0.77,0.0,16,284,300,300,4,Malam
16707,2012-12-03,1,12,21,0,1,1,1,0.44,0.4394,0.82,0.194,14,207,221,221,4,Malam
16708,2012-12-03,1,12,22,0,1,1,1,0.42,0.4242,0.82,0.1045,5,139,144,144,4,Malam
16709,2012-12-03,1,12,23,0,1,1,1,0.42,0.4242,0.82,0.1045,9,93,102,102,4,Malam
16710,2012-12-04,1,12,0,0,2,1,1,0.42,0.4242,0.88,0.1045,6,49,55,55,4,
16711,2012-12-04,1,12,1,0,2,1,1,0.42,0.4242,0.82,0.1045,3,22,25,25,4,Pagi
16712,2012-12-04,1,12,2,0,2,1,1,0.42,0.4242,0.88,0.0896,3,5,8,8,4,Pagi
16713,2012-12-04,1,12,3,0,2,1,2,0.4,0.4091,0.87,0.1343,1,3,4,4,4,Pagi
16714,2012-12-04,1,12,4,0,2,1,2,0.4,0.4091,0.87,0.1343,0,7,7,7,4,Pagi
16715,2012-12-04,1,12,5,0,2,1,2,0.44,0.4394,0.88,0.0,1,45,46,46,4,Pagi
16716,2012-12-04,1,12,6,0,2,1,2,0.36,0.3788,0.93,0.0,3,150,153,153,4,Pagi
16717,2012-12-04,1,12,7,0,2,1,1,0.42,0.4242,0.88,0.1343,7,495,502,502,4,Siang
16718,2012-12-04,1,12,8,0,2,1,2,0.44,0.4394,0.88,0.1642,21,700,721,721,4,Siang
16719,2012-12-04,1,12,9,0,2,1,1,0.46,0.4545,0.82,0.1045,19,317,336,336,4,Siang
16720,2012-12-04,1,12,10,0,2,1,1,0.46,0.4545,0.82,0.194,26,130,156,156,4,Siang
16721,2012-12-04,1,12,11,0,2,1,1,0.48,0.4697,0.77,0.194,24,183,207,207,4,Siang
16722,2012-12-04,1,12,12,0,2,1,1,0.52,0.5,0.68,0.194,39,273,312,312,4,Siang
16723,2012-12-04,1,12,13,0,2,1,2,0.54,0.5152,0.64,0.1642,39,233,272,272,4,Sore
16724,2012-12-04,1,12,14,0,2,1,2,0.58,0.5455,0.56,0.2239,39,231,270,270,4,Sore
16725,2012-12-04,1,12,15,0,2,1,2,0.6,0.6212,0.49,0.2537,56,244,300,300,4,Sore
16726,2012-12-04,1,12,16,0,2,1,1,0.58,0.5455,0.49,0.2836,44,391,435,435,4,Sore
16727,2012-12-04,1,12,17,0,2,1,1,0.52,0.5,0.59,0.2239,43,700,743,743,4,Sore
16728,2012-12-04,1,12,18,0,2,1,1,0.5,0.4848,0.63,0.2239,38,693,731,731,4,Sore
16729,2012-12-04,1,12,19,0,2,1,1,0.48,0.4697,0.67,0.2239,46,414,460,460,4,Malam
16730,2012-12-04,1,12,20,0,2,1,2,0.5,0.4848,0.63,0.2239,34,272,306,306,4,Malam
16731,2012-12-04,1,12,21,0,2,1,2,0.5,0.4848,0.63,0.2537,28,252,280,280,4,Malam
16732,2012-12-04,1,12,22,0,2,1,2,0.5,0.4848,0.63,0.2985,26,155,181,181,4,Malam
16733,2012-12-04,1,12,23,0,2,1,1,0.48,0.4697,0.67,0.2537,5,91,96,96,4,Malam
16734,2012-12-05,1,12,0,0,3,1,1,0.5,0.4848,0.59,0.2836,6,31,37,37,4,
16735,2012-12-05,1,12,1,0,3,1,1,0.52,0.5,0.55,0.3284,0,11,11,11,4,Pagi
16736,2012-12-05,1,12,2,0,3,1,1,0.46,0.4545,0.67,0.1642,2,7,9,9,4,Pagi
16737,2012-12-05,1,12,3,0,3,1,1,0.48,0.4697,0.67,0.1343,0,7,7,7,4,Pagi
16738,2012-12-05,1,12,4,0,3,1,1,0.5,0.4848,0.63,0.4478,1,9,10,10,4,Pagi
16739,2012-12-05,1,12,5,0,3,1,1,0.5,0.4848,0.59,0.2836,1,48,49,49,4,Pagi
16740,2012-12-05,1,12,6,0,3,1,3,0.48,0.4697,0.55,0.3881,5,119,124,124,4,Pagi
16741,2012-12-05,1,12,7,0,3,1,3,0.46,0.4545,0.59,0.2985,9,389,398,398,4,Siang
16742,2012-12-05,1,12,8,0,3,1,2,0.44,0.4394,0.58,0.2836,22,737,759,759,4,Siang
16743,2012-12-05,1,12,9,0,3,1,2,0.44,0.4394,0.51,0.2239,26,362,388,388,4,Siang
16744,2012-12-05,1,12,10,0,3,1,2,0.44,0.4394,0.47,0.3582,14,127,141,141,4,Siang
16745,2012-12-05,1,12,11,0,3,1,1,0.44,0.4394,0.44,0.2836,11,161,172,172,4,Siang
16746,2012-12-05,1,12,12,0,3,1,1,0.44,0.4394,0.41,0.2836,24,208,232,232,4,Siang
16747,2012-12-05,1,12,13,0,3,1,1,0.46,0.4545,0.41,0.2836,14,200,214,214,4,Sore
16748,2012-12-05,1,12,14,0,3,1,1,0.48,0.4697,0.33,0.4925,39,179,218,218,4,Sore
16749,2012-12-05,1,12,15,0,3,1,1,0.48,0.4697,0.33,0.2836,20,265,285,285,4,Sore
16750,2012-12-05,1,12,16,0,3,1,1,0.46,0.4545,0.33,0.2836,23,354,377,377,4,Sore
16751,2012-12-05,1,12,17,0,3,1,1,0.44,0.4394,0.35,0.2836,29,576,605,605,4,Sore
16752,2012-12-05,1,12,18,0,3,1,1,0.42,0.4242,0.35,0.4478,29,580,609,609,4,Sore
16753,2012-12-05,1,12,19,0,3,1,1,0.38,0.3939,0.43,0.3582,14,400,414,414,4,Malam
16754,2012-12-05,1,12,20,0,3,1,1,0.34,0.303,0.46,0.3881,19,274,293,293,4,Malam
16755,2012-12-05,1,12,21,0,3,1,1,0.34,0.303,0.46,0.4179,14,184,198,198,4,Malam
16756,2012-12-05,1,12,22,0,3,1,1,0.32,0.2879,0.45,0.3881,4,101,105,105,4,Malam
16757,2012-12-05,1,12,23,0,3,1,1,0.3,0.2727,0.49,0.3881,5,69,74,74,4,Malam
16758,2012-12-06,1,12,0,0,4,1,1,0.26,0.2424,0.48,0.2836,1,43,44,44,4,
16759,2012-12-06,1,12,1,0,4,1,1,0.26,0.2424,0.48,0.2836,0,16,16,16,4,Pagi
16760,2012-12-06,1,12,2,0,4,1,1,0.24,0.2121,0.52,0.2836,0,9,9,9,4,Pagi
16761,2012-12-06,1,12,3,0,4,1,1,0.22,0.2273,0.55,0.194,0,2,2,2,4,Pagi
16762,2012-12-06,1,12,4,0,4,1,1,0.22,0.2121,0.55,0.2985,1,8,9,9,4,Pagi
16763,2012-12-06,1,12,5,0,4,1,1,0.22,0.2121,0.55,0.2836,0,32,32,32,4,Pagi
16764,2012-12-06,1,12,6,0,4,1,1,0.22,0.2121,0.55,0.2985,2,122,124,124,4,Pagi
16765,2012-12-06,1,12,7,0,4,1,1,0.22,0.2121,0.51,0.2985,8,381,389,389,4,Siang
16766,2012-12-06,1,12,8,0,4,1,1,0.22,0.2121,0.51,0.2985,13,646,659,659,4,Siang
16767,2012-12-06,1,12,9,0,4,1,1,0.24,0.2273,0.48,0.194,19,257,276,276,4,Siang
16768,2012-12-06,1,12,10,0,4,1,1,0.24,0.2273,0.52,0.194,23,122,145,145,4,Siang
16769,2012-12-06,1,12,11,0,4,1,1,0.26,0.2576,0.48,0.1642,16,162,178,178,4,Siang
16770,2012-12-06,1,12,12,0,4,1,1,0.28,0.3182,0.41,0.0,29,206,235,235,4,Siang
16771,2012-12-06,1,12,13,0,4,1,1,0.3,0.3333,0.39,0.0,33,212,245,245,4,Sore
16772,2012-12-06,1,12,14,0,4,1,1,0.3,0.3182,0.42,0.0896,37,175,212,212,4,Sore
16773,2012-12-06,1,12,15,0,4,1,1,0.32,0.3485,0.39,0.0,38,232,270,270,4,Sore
16774,2012-12-06,1,12,16,0,4,1,1,0.32,0.3485,0.42,0.0,39,292,331,331,4,Sore
16775,2012-12-06,1,12,17,0,4,1,1,0.3,0.3182,0.45,0.1045,31,586,617,617,4,Sore
16776,2012-12-06,1,12,18,0,4,1,1,0.28,0.2727,0.45,0.1642,23,542,565,565,4,Sore
16777,2012-12-06,1,12,19,0,4,1,1,0.26,0.2576,0.6,0.194,13,360,373,373,4,Malam
16778,2012-12-06,1,12,20,0,4,1,2,0.24,0.2576,0.6,0.1045,5,222,227,227,4,Malam
16779,2012-12-06,1,12,21,0,4,1,2,0.24,0.2424,0.6,0.1343,7,184,191,191,4,Malam
16780,2012-12-06,1,12,22,0,4,1,1,0.24,0.2424,0.65,0.1642,2,131,133,133,4,Malam
16781,2012-12-06,1,12,23,0,4,1,1,0.24,0.2424,0.65,0.1642,0,93,93,93,4,Malam
16782,2012-12-07,1,12,0,0,5,1,1,0.24,0.2576,0.7,0.1045,3,45,48,48,4,
16783,2012-12-07,1,12,1,0,5,1,2,0.24,0.2273,0.7,0.194,2,26,28,28,4,Pagi
16784,2012-12-07,1,12,2,0,5,1,2,0.26,0.2727,0.7,0.1343,0,11,11,11,4,Pagi
16785,2012-12-07,1,12,3,0,5,1,2,0.26,0.2576,0.81,0.194,0,5,5,5,4,Pagi
16786,2012-12-07,1,12,4,0,5,1,1,0.26,0.2727,0.75,0.1045,0,10,10,10,4,Pagi
16787,2012-12-07,1,12,5,0,5,1,2,0.26,0.2727,0.81,0.1045,1,25,26,26,4,Pagi
16788,2012-12-07,1,12,6,0,5,1,2,0.28,0.2727,0.75,0.1642,0,84,84,84,4,Pagi
16789,2012-12-07,1,12,7,0,5,1,3,0.28,0.2727,0.81,0.1642,3,212,215,215,4,Siang
16790,2012-12-07,1,12,8,0,5,1,2,0.3,0.2879,0.75,0.194,11,430,441,441,4,Siang
16791,2012-12-07,1,12,9,0,5,1,2,0.3,0.303,0.81,0.1343,10,291,301,301,4,Siang
16792,2012-12-07,1,12,10,0,5,1,2,0.32,0.3182,0.76,0.1642,16,150,166,166,4,Siang
16793,2012-12-07,1,12,11,0,5,1,2,0.32,0.3182,0.76,0.194,20,183,203,203,4,Siang
16794,2012-12-07,1,12,12,0,5,1,2,0.34,0.3333,0.71,0.194,36,204,240,240,4,Siang
16795,2012-12-07,1,12,13,0,5,1,2,0.36,0.3485,0.66,0.1343,23,197,220,220,4,Sore
16796,2012-12-07,1,12,14,0,5,1,2,0.36,0.3485,0.71,0.1642,40,175,215,215,4,Sore
16797,2012-12-07,1,12,15,0,5,1,2,0.36,0.3485,0.71,0.1642,34,269,303,303,4,Sore
16798,2012-12-07,1,12,16,0,5,1,1,0.36,0.3485,0.76,0.1343,39,336,375,375,4,Sore
16799,2012-12-07,1,12,17,0,5,1,2,0.38,0.3939,0.66,0.0,29,539,568,568,4,Sore
16800,2012-12-07,1,12,18,0,5,1,2,0.38,0.3939,0.71,0.1045,25,473,498,498,4,Sore
16801,2012-12-07,1,12,19,0,5,1,2,0.38,0.3939,0.76,0.0,15,337,352,352,4,Malam
16802,2012-12-07,1,12,20,0,5,1,3,0.38,0.3939,0.76,0.1045,12,229,241,241,4,Malam
16803,2012-12-07,1,12,21,0,5,1,2,0.36,0.3636,0.93,0.1045,9,162,171,171,4,Malam
16804,2012-12-07,1,12,22,0,5,1,2,0.36,0.3636,0.93,0.0896,15,150,165,165,4,Malam
16805,2012-12-07,1,12,23,0,5,1,2,0.36,0.3636,0.93,0.0896,6,116,122,122,4,Malam
16806,2012-12-08,1,12,0,0,6,0,2,0.36,0.3636,0.93,0.0896,5,98,103,103,4,
16807,2012-12-08,1,12,1,0,6,0,2,0.36,0.3485,0.93,0.1343,16,84,100,100,4,Pagi
16808,2012-12-08,1,12,2,0,6,0,2,0.36,0.3485,0.93,0.1343,3,67,70,70,4,Pagi
16809,2012-12-08,1,12,3,0,6,0,2,0.36,0.3636,0.93,0.1045,6,23,29,29,4,Pagi
16810,2012-12-08,1,12,4,0,6,0,2,0.36,0.3788,0.93,0.0,3,9,12,12,4,Pagi
16811,2012-12-08,1,12,5,0,6,0,2,0.36,0.3636,0.93,0.1045,2,4,6,6,4,Pagi
16812,2012-12-08,1,12,6,0,6,0,2,0.36,0.3636,0.93,0.1045,1,19,20,20,4,Pagi
16813,2012-12-08,1,12,7,0,6,0,2,0.36,0.3636,1.0,0.0896,3,36,39,39,4,Siang
16814,2012-12-08,1,12,8,0,6,0,2,0.38,0.3939,0.94,0.0896,5,106,111,111,4,Siang
16815,2012-12-08,1,12,9,0,6,0,2,0.38,0.3939,0.94,0.0,17,153,170,170,4,Siang
16816,2012-12-08,1,12,10,0,6,0,2,0.4,0.4091,0.87,0.1343,43,244,287,287,4,Siang
16817,2012-12-08,1,12,11,0,6,0,2,0.4,0.4091,0.87,0.1045,63,341,404,404,4,Siang
16818,2012-12-08,1,12,12,0,6,0,2,0.4,0.4091,0.87,0.2239,122,364,486,486,4,Siang
16819,2012-12-08,1,12,13,0,6,0,2,0.4,0.4091,0.87,0.1642,148,399,547,547,4,Sore
16820,2012-12-08,1,12,14,0,6,0,2,0.4,0.4091,0.87,0.2836,164,378,542,542,4,Sore
16821,2012-12-08,1,12,15,0,6,0,1,0.42,0.4242,0.82,0.1642,167,374,541,541,4,Sore
16822,2012-12-08,1,12,16,0,6,0,1,0.42,0.4242,0.82,0.1642,139,368,507,507,4,Sore
16823,2012-12-08,1,12,17,0,6,0,1,0.38,0.3939,0.87,0.1343,77,268,345,345,4,Sore
16824,2012-12-08,1,12,18,0,6,0,1,0.4,0.4091,0.87,0.1045,40,264,304,304,4,Sore
16825,2012-12-08,1,12,19,0,6,0,1,0.4,0.4091,0.87,0.0,34,212,246,246,4,Malam
16826,2012-12-08,1,12,20,0,6,0,2,0.36,0.3788,1.0,0.0,20,162,182,182,4,Malam
16827,2012-12-08,1,12,21,0,6,0,2,0.36,0.3788,1.0,0.0,34,175,209,209,4,Malam
16828,2012-12-08,1,12,22,0,6,0,2,0.38,0.3939,0.94,0.1045,23,137,160,160,4,Malam
16829,2012-12-08,1,12,23,0,6,0,2,0.4,0.4091,0.94,0.0,18,144,162,162,4,Malam
16830,2012-12-09,1,12,0,0,0,0,2,0.4,0.4091,0.87,0.1343,15,103,118,118,4,
16831,2012-12-09,1,12,1,0,0,0,2,0.4,0.4091,0.87,0.1045,17,85,102,102,4,Pagi
16832,2012-12-09,1,12,2,0,0,0,2,0.4,0.4091,0.87,0.1045,8,70,78,78,4,Pagi
16833,2012-12-09,1,12,3,0,0,0,2,0.4,0.4091,0.87,0.1045,14,34,48,48,4,Pagi
16834,2012-12-09,1,12,4,0,0,0,2,0.4,0.4091,0.94,0.1045,1,11,12,12,4,Pagi
16835,2012-12-09,1,12,5,0,0,0,2,0.4,0.4091,0.87,0.1045,0,8,8,8,4,Pagi
16836,2012-12-09,1,12,6,0,0,0,3,0.4,0.4091,0.94,0.1045,0,6,6,6,4,Pagi
16837,2012-12-09,1,12,7,0,0,0,3,0.4,0.4091,0.87,0.2239,1,22,23,23,4,Siang
16838,2012-12-09,1,12,8,0,0,0,3,0.4,0.4091,0.87,0.1642,1,68,69,69,4,Siang
16839,2012-12-09,1,12,9,0,0,0,2,0.4,0.4091,0.87,0.2537,9,94,103,103,4,Siang
16840,2012-12-09,1,12,10,0,0,0,2,0.4,0.4091,0.87,0.2836,39,180,219,219,4,Siang
16841,2012-12-09,1,12,11,0,0,0,2,0.4,0.4091,0.87,0.2985,40,210,250,250,4,Siang
16842,2012-12-09,1,12,12,0,0,0,2,0.4,0.4091,0.82,0.2985,60,255,315,315,4,Siang
16843,2012-12-09,1,12,13,0,0,0,2,0.38,0.3939,0.87,0.2836,65,220,285,285,4,Sore
16844,2012-12-09,1,12,14,0,0,0,2,0.38,0.3939,0.87,0.194,42,190,232,232,4,Sore
16845,2012-12-09,1,12,15,0,0,0,3,0.36,0.3485,0.93,0.1642,25,200,225,225,4,Sore
16846,2012-12-09,1,12,16,0,0,0,3,0.36,0.3485,0.93,0.1642,33,220,253,253,4,Sore
16847,2012-12-09,1,12,17,0,0,0,3,0.36,0.3485,0.93,0.1343,20,209,229,229,4,Sore
16848,2012-12-09,1,12,18,0,0,0,3,0.36,0.3636,0.93,0.0896,17,181,198,198,4,Sore
16849,2012-12-09,1,12,19,0,0,0,3,0.38,0.3939,0.94,0.0896,12,110,122,122,4,Malam
16850,2012-12-09,1,12,20,0,0,0,3,0.36,0.3636,1.0,0.0896,6,102,108,108,4,Malam
16851,2012-12-09,1,12,21,0,0,0,2,0.36,0.3636,1.0,0.1045,10,86,96,96,4,Malam
16852,2012-12-09,1,12,22,0,0,0,3,0.36,0.3636,0.93,0.1045,3,75,78,78,4,Malam
16853,2012-12-09,1,12,23,0,0,0,3,0.36,0.3636,1.0,0.0896,3,48,51,51,4,Malam
16854,2012-12-10,1,12,0,0,1,1,3,0.36,0.3636,1.0,0.0896,0,20,20,20,4,
16855,2012-12-10,1,12,1,0,1,1,2,0.36,0.3788,1.0,0.0,0,4,4,4,4,Pagi
16856,2012-12-10,1,12,2,0,1,1,2,0.38,0.3939,0.94,0.1045,2,3,5,5,4,Pagi
16857,2012-12-10,1,12,3,0,1,1,2,0.38,0.3939,0.94,0.1045,0,4,4,4,4,Pagi
16858,2012-12-10,1,12,4,0,1,1,2,0.38,0.3939,0.94,0.1045,3,9,12,12,4,Pagi
16859,2012-12-10,1,12,5,0,1,1,2,0.38,0.3939,0.94,0.1045,0,27,27,27,4,Pagi
16860,2012-12-10,1,12,6,0,1,1,2,0.38,0.3939,0.94,0.1642,2,121,123,123,4,Pagi
16861,2012-12-10,1,12,7,0,1,1,2,0.38,0.3939,0.94,0.2537,3,291,294,294,4,Siang
16862,2012-12-10,1,12,8,0,1,1,2,0.42,0.4242,1.0,0.2537,9,575,584,584,4,Siang
16863,2012-12-10,1,12,9,0,1,1,2,0.42,0.4242,1.0,0.2239,11,273,284,284,4,Siang
16864,2012-12-10,1,12,10,0,1,1,2,0.44,0.4394,0.94,0.2239,12,121,133,133,4,Siang
16865,2012-12-10,1,12,11,0,1,1,3,0.46,0.4545,0.94,0.2239,8,126,134,134,4,Siang
16866,2012-12-10,1,12,12,0,1,1,3,0.44,0.4394,1.0,0.2239,23,150,173,173,4,Siang
16867,2012-12-10,1,12,13,0,1,1,3,0.44,0.4394,1.0,0.2239,30,190,220,220,4,Sore
16868,2012-12-10,1,12,14,0,1,1,2,0.5,0.4848,0.94,0.2239,31,179,210,210,4,Sore
16869,2012-12-10,1,12,15,0,1,1,2,0.5,0.4848,0.87,0.1642,29,207,236,236,4,Sore
16870,2012-12-10,1,12,16,0,1,1,2,0.5,0.4848,0.88,0.1045,37,308,345,345,4,Sore
16871,2012-12-10,1,12,17,0,1,1,2,0.48,0.4697,0.82,0.2836,38,578,616,616,4,Sore
16872,2012-12-10,1,12,18,0,1,1,2,0.46,0.4545,0.88,0.2836,20,544,564,564,4,Sore
16873,2012-12-10,1,12,19,0,1,1,1,0.52,0.5,0.77,0.2836,18,409,427,427,4,Malam
16874,2012-12-10,1,12,20,0,1,1,1,0.46,0.4545,0.88,0.2537,13,287,300,300,4,Malam
16875,2012-12-10,1,12,21,0,1,1,2,0.46,0.4545,0.94,0.194,21,224,245,245,4,Malam
16876,2012-12-10,1,12,22,0,1,1,2,0.5,0.4848,0.82,0.2239,11,115,126,126,4,Malam
16877,2012-12-10,1,12,23,0,1,1,1,0.46,0.4545,0.88,0.2537,8,76,84,84,4,Malam
16878,2012-12-11,1,12,0,0,2,1,3,0.46,0.4545,0.77,0.4627,2,29,31,31,4,
16879,2012-12-11,1,12,1,0,2,1,1,0.42,0.4242,0.71,0.4478,1,7,8,8,4,Pagi
16880,2012-12-11,1,12,2,0,2,1,2,0.4,0.4091,0.66,0.3284,0,1,1,1,4,Pagi
16881,2012-12-11,1,12,3,0,2,1,3,0.36,0.3333,0.76,0.2836,0,3,3,3,4,Pagi
16882,2012-12-11,1,12,4,0,2,1,2,0.34,0.3182,0.76,0.2836,0,8,8,8,4,Pagi
16883,2012-12-11,1,12,5,0,2,1,3,0.34,0.303,0.71,0.3284,1,40,41,41,4,Pagi
16884,2012-12-11,1,12,6,0,2,1,2,0.34,0.303,0.71,0.2985,0,118,118,118,4,Pagi
16885,2012-12-11,1,12,7,0,2,1,1,0.34,0.303,0.66,0.4179,8,372,380,380,4,Siang
16886,2012-12-11,1,12,8,0,2,1,2,0.34,0.303,0.61,0.2985,16,708,724,724,4,Siang
16887,2012-12-11,1,12,9,0,2,1,1,0.34,0.303,0.61,0.3881,12,322,334,334,4,Siang
16888,2012-12-11,1,12,10,0,2,1,1,0.36,0.3333,0.57,0.3284,12,142,154,154,4,Siang
16889,2012-12-11,1,12,11,0,2,1,2,0.36,0.3333,0.53,0.3582,28,145,173,173,4,Siang
16890,2012-12-11,1,12,12,0,2,1,2,0.36,0.3182,0.53,0.4478,13,213,226,226,4,Siang
16891,2012-12-11,1,12,13,0,2,1,2,0.38,0.3939,0.5,0.2239,28,226,254,254,4,Sore
16892,2012-12-11,1,12,14,0,2,1,2,0.38,0.3939,0.5,0.2239,19,185,204,204,4,Sore
16893,2012-12-11,1,12,15,0,2,1,2,0.38,0.3939,0.5,0.2239,20,250,270,270,4,Sore
16894,2012-12-11,1,12,16,0,2,1,2,0.38,0.3939,0.5,0.2239,24,334,358,358,4,Sore
16895,2012-12-11,1,12,17,0,2,1,1,0.32,0.303,0.53,0.2239,21,580,601,601,4,Sore
16896,2012-12-11,1,12,18,0,2,1,1,0.32,0.303,0.53,0.2239,23,523,546,546,4,Sore
16897,2012-12-11,1,12,19,0,2,1,1,0.32,0.303,0.53,0.2239,21,412,433,433,4,Malam
16898,2012-12-11,1,12,20,0,2,1,1,0.32,0.303,0.53,0.2239,9,248,257,257,4,Malam
16899,2012-12-11,1,12,21,0,2,1,1,0.32,0.3182,0.53,0.194,14,193,207,207,4,Malam
16900,2012-12-11,1,12,22,0,2,1,1,0.3,0.2879,0.56,0.2239,6,100,106,106,4,Malam
16901,2012-12-11,1,12,23,0,2,1,1,0.3,0.2879,0.52,0.2239,4,60,64,64,4,Malam
16902,2012-12-12,1,12,0,0,3,1,1,0.3,0.303,0.52,0.1642,1,33,34,34,4,
16903,2012-12-12,1,12,1,0,3,1,1,0.28,0.2727,0.61,0.2239,3,18,21,21,4,Pagi
16904,2012-12-12,1,12,2,0,3,1,1,0.28,0.2727,0.56,0.1642,5,4,9,9,4,Pagi
16905,2012-12-12,1,12,3,0,3,1,1,0.26,0.2727,0.6,0.1343,3,7,10,10,4,Pagi
16906,2012-12-12,1,12,4,0,3,1,1,0.26,0.303,0.6,0.0,0,4,4,4,4,Pagi
16907,2012-12-12,1,12,5,0,3,1,1,0.26,0.2576,0.6,0.194,0,37,37,37,4,Pagi
16908,2012-12-12,1,12,6,0,3,1,2,0.26,0.2424,0.6,0.2537,2,126,128,128,4,Pagi
16909,2012-12-12,1,12,7,0,3,1,2,0.26,0.2576,0.6,0.194,3,366,369,369,4,Siang
16910,2012-12-12,1,12,8,0,3,1,2,0.26,0.2576,0.65,0.1642,18,670,688,688,4,Siang
16911,2012-12-12,1,12,9,0,3,1,2,0.28,0.2879,0.61,0.1343,13,272,285,285,4,Siang
16912,2012-12-12,1,12,10,0,3,1,2,0.3,0.303,0.56,0.1642,20,116,136,136,4,Siang
16913,2012-12-12,1,12,11,0,3,1,2,0.32,0.303,0.49,0.2239,24,148,172,172,4,Siang
16914,2012-12-12,1,12,12,0,3,1,2,0.34,0.3636,0.42,0.0,14,218,232,232,4,Siang
16915,2012-12-12,1,12,13,0,3,1,2,0.34,0.3636,0.42,0.0,18,220,238,238,4,Sore
16916,2012-12-12,1,12,14,0,3,1,2,0.34,0.3636,0.46,0.0,34,191,225,225,4,Sore
16917,2012-12-12,1,12,15,0,3,1,2,0.34,0.3485,0.46,0.1045,21,207,228,228,4,Sore
16918,2012-12-12,1,12,16,0,3,1,2,0.34,0.3333,0.46,0.1343,19,310,329,329,4,Sore
16919,2012-12-12,1,12,17,0,3,1,2,0.32,0.303,0.53,0.2239,21,540,561,561,4,Sore
16920,2012-12-12,1,12,18,0,3,1,2,0.32,0.303,0.49,0.2239,25,515,540,540,4,Sore
16921,2012-12-12,1,12,19,0,3,1,2,0.3,0.2879,0.56,0.2239,18,384,402,402,4,Malam
16922,2012-12-12,1,12,20,0,3,1,1,0.3,0.2879,0.52,0.2836,25,243,268,268,4,Malam
16923,2012-12-12,1,12,21,0,3,1,2,0.3,0.2879,0.52,0.2537,16,186,202,202,4,Malam
16924,2012-12-12,1,12,22,0,3,1,2,0.3,0.2879,0.52,0.2239,4,118,122,122,4,Malam
16925,2012-12-12,1,12,23,0,3,1,2,0.28,0.2727,0.56,0.2239,3,76,79,79,4,Malam
16926,2012-12-13,1,12,0,0,4,1,2,0.28,0.2727,0.52,0.2239,1,31,32,32,4,
16927,2012-12-13,1,12,1,0,4,1,2,0.28,0.2576,0.52,0.2836,4,19,23,23,4,Pagi
16928,2012-12-13,1,12,2,0,4,1,2,0.26,0.2424,0.56,0.2537,3,5,8,8,4,Pagi
16929,2012-12-13,1,12,3,0,4,1,2,0.26,0.2424,0.56,0.2836,0,2,2,2,4,Pagi
16930,2012-12-13,1,12,4,0,4,1,2,0.26,0.2576,0.56,0.194,0,8,8,8,4,Pagi
16931,2012-12-13,1,12,5,0,4,1,2,0.26,0.2576,0.56,0.1642,2,31,33,33,4,Pagi
16932,2012-12-13,1,12,6,0,4,1,1,0.26,0.2424,0.56,0.2537,2,112,114,114,4,Pagi
16933,2012-12-13,1,12,7,0,4,1,1,0.24,0.2273,0.6,0.2239,5,380,385,385,4,Siang
16934,2012-12-13,1,12,8,0,4,1,1,0.24,0.2273,0.6,0.194,24,655,679,679,4,Siang
16935,2012-12-13,1,12,9,0,4,1,1,0.28,0.2727,0.52,0.2537,25,300,325,325,4,Siang
16936,2012-12-13,1,12,10,0,4,1,1,0.32,0.303,0.45,0.2836,28,139,167,167,4,Siang
16937,2012-12-13,1,12,11,0,4,1,1,0.34,0.3182,0.42,0.2537,25,164,189,189,4,Siang
16938,2012-12-13,1,12,12,0,4,1,1,0.36,0.3333,0.4,0.2537,30,252,282,282,4,Siang
16939,2012-12-13,1,12,13,0,4,1,1,0.36,0.3485,0.34,0.194,41,230,271,271,4,Sore
16940,2012-12-13,1,12,14,0,4,1,1,0.36,0.3485,0.34,0.1642,31,211,242,242,4,Sore
16941,2012-12-13,1,12,15,0,4,1,1,0.36,0.3485,0.34,0.1343,40,240,280,280,4,Sore
16942,2012-12-13,1,12,16,0,4,1,1,0.34,0.3485,0.39,0.1045,50,356,406,406,4,Sore
16943,2012-12-13,1,12,17,0,4,1,1,0.32,0.3333,0.42,0.1045,43,507,550,550,4,Sore
16944,2012-12-13,1,12,18,0,4,1,1,0.32,0.3333,0.42,0.1045,20,446,466,466,4,Sore
16945,2012-12-13,1,12,19,0,4,1,1,0.3,0.303,0.45,0.1642,20,328,348,348,4,Malam
16946,2012-12-13,1,12,20,0,4,1,1,0.3,0.3333,0.45,0.0,6,235,241,241,4,Malam
16947,2012-12-13,1,12,21,0,4,1,1,0.28,0.3182,0.48,0.0,13,200,213,213,4,Malam
16948,2012-12-13,1,12,22,0,4,1,1,0.26,0.2879,0.6,0.0896,7,141,148,148,4,Malam
16949,2012-12-13,1,12,23,0,4,1,1,0.26,0.303,0.6,0.0,5,115,120,120,4,Malam
16950,2012-12-14,1,12,0,0,5,1,1,0.22,0.2576,0.64,0.0896,4,43,47,47,4,
16951,2012-12-14,1,12,1,0,5,1,1,0.22,0.2576,0.69,0.0896,0,26,26,26,4,Pagi
16952,2012-12-14,1,12,2,0,5,1,1,0.22,0.2727,0.69,0.0,3,6,9,9,4,Pagi
16953,2012-12-14,1,12,3,0,5,1,1,0.2,0.2273,0.69,0.1045,0,12,12,12,4,Pagi
16954,2012-12-14,1,12,4,0,5,1,1,0.2,0.2273,0.75,0.0896,1,9,10,10,4,Pagi
16955,2012-12-14,1,12,5,0,5,1,1,0.2,0.2273,0.69,0.1045,0,34,34,34,4,Pagi
16956,2012-12-14,1,12,6,0,5,1,1,0.16,0.1818,0.8,0.1045,1,112,113,113,4,Pagi
16957,2012-12-14,1,12,7,0,5,1,1,0.2,0.2121,0.72,0.1045,3,305,308,308,4,Siang
16958,2012-12-14,1,12,8,0,5,1,1,0.2,0.2273,0.69,0.0896,13,623,636,636,4,Siang
16959,2012-12-14,1,12,9,0,5,1,1,0.24,0.2424,0.75,0.1343,13,330,343,343,4,Siang
16960,2012-12-14,1,12,10,0,5,1,1,0.26,0.2576,0.81,0.194,28,162,190,190,4,Siang
16961,2012-12-14,1,12,11,0,5,1,1,0.32,0.303,0.65,0.194,31,180,211,211,4,Siang
16962,2012-12-14,1,12,12,0,5,1,1,0.36,0.3485,0.5,0.194,29,244,273,273,4,Siang
16963,2012-12-14,1,12,13,0,5,1,1,0.36,0.3485,0.5,0.2239,39,274,313,313,4,Sore
16964,2012-12-14,1,12,14,0,5,1,1,0.4,0.4091,0.43,0.194,48,251,299,299,4,Sore
16965,2012-12-14,1,12,15,0,5,1,1,0.4,0.4091,0.47,0.1642,57,252,309,309,4,Sore
16966,2012-12-14,1,12,16,0,5,1,1,0.38,0.3939,0.54,0.194,45,372,417,417,4,Sore
16967,2012-12-14,1,12,17,0,5,1,1,0.34,0.3333,0.57,0.1642,40,582,622,622,4,Sore
16968,2012-12-14,1,12,18,0,5,1,1,0.36,0.3485,0.46,0.1343,23,432,455,455,4,Sore
16969,2012-12-14,1,12,19,0,5,1,1,0.34,0.3485,0.53,0.0896,17,302,319,319,4,Malam
16970,2012-12-14,1,12,20,0,5,1,1,0.32,0.3333,0.61,0.1343,12,209,221,221,4,Malam
16971,2012-12-14,1,12,21,0,5,1,1,0.3,0.303,0.75,0.1642,7,165,172,172,4,Malam
16972,2012-12-14,1,12,22,0,5,1,1,0.28,0.2879,0.75,0.1045,4,134,138,138,4,Malam
16973,2012-12-14,1,12,23,0,5,1,1,0.28,0.303,0.75,0.0896,11,123,134,134,4,Malam
16974,2012-12-15,1,12,0,0,6,0,1,0.3,0.3333,0.7,0.0,4,90,94,94,4,
16975,2012-12-15,1,12,1,0,6,0,2,0.26,0.2879,0.81,0.0896,9,86,95,95,4,Pagi
16976,2012-12-15,1,12,2,0,6,0,1,0.26,0.303,0.81,0.0,6,63,69,69,4,Pagi
16977,2012-12-15,1,12,3,0,6,0,2,0.24,0.2879,0.81,0.0,5,18,23,23,4,Pagi
16978,2012-12-15,1,12,4,0,6,0,2,0.24,0.2576,0.87,0.1045,1,5,6,6,4,Pagi
16979,2012-12-15,1,12,5,0,6,0,2,0.26,0.303,0.75,0.0,0,3,3,3,4,Pagi
16980,2012-12-15,1,12,6,0,6,0,2,0.24,0.2879,0.75,0.0,0,11,11,11,4,Pagi
16981,2012-12-15,1,12,7,0,6,0,2,0.24,0.2576,0.75,0.0896,1,47,48,48,4,Siang
16982,2012-12-15,1,12,8,0,6,0,2,0.26,0.2879,0.75,0.0896,8,111,119,119,4,Siang
16983,2012-12-15,1,12,9,0,6,0,1,0.26,0.2727,0.75,0.1045,17,203,220,220,4,Siang
16984,2012-12-15,1,12,10,0,6,0,1,0.32,0.3182,0.61,0.1642,23,250,273,273,4,Siang
16985,2012-12-15,1,12,11,0,6,0,1,0.34,0.3485,0.61,0.0896,66,327,393,393,4,Siang
16986,2012-12-15,1,12,12,0,6,0,1,0.38,0.3939,0.5,0.0896,89,364,453,453,4,Siang
16987,2012-12-15,1,12,13,0,6,0,1,0.38,0.3939,0.54,0.2537,88,368,456,456,4,Sore
16988,2012-12-15,1,12,14,0,6,0,1,0.4,0.4091,0.5,0.1642,92,334,426,426,4,Sore
16989,2012-12-15,1,12,15,0,6,0,1,0.42,0.4242,0.47,0.0,95,352,447,447,4,Sore
16990,2012-12-15,1,12,16,0,6,0,1,0.4,0.4091,0.5,0.1343,85,328,413,413,4,Sore
16991,2012-12-15,1,12,17,0,6,0,1,0.4,0.4091,0.5,0.2239,35,274,309,309,4,Sore
16992,2012-12-15,1,12,18,0,6,0,1,0.38,0.3939,0.58,0.1642,40,232,272,272,4,Sore
16993,2012-12-15,1,12,19,0,6,0,1,0.36,0.3485,0.62,0.1343,32,225,257,257,4,Malam
16994,2012-12-15,1,12,20,0,6,0,2,0.36,0.3485,0.57,0.194,23,178,201,201,4,Malam
16995,2012-12-15,1,12,21,0,6,0,1,0.36,0.3485,0.62,0.1343,15,169,184,184,4,Malam
16996,2012-12-15,1,12,22,0,6,0,1,0.36,0.3485,0.62,0.194,22,134,156,156,4,Malam
16997,2012-12-15,1,12,23,0,6,0,2,0.36,0.3485,0.62,0.1343,11,108,119,119,4,Malam
16998,2012-12-16,1,12,0,0,0,0,2,0.36,0.3788,0.62,0.0,8,102,110,110,4,
16999,2012-12-16,1,12,1,0,0,0,3,0.34,0.3485,0.76,0.1045,14,82,96,96,4,Pagi
17000,2012-12-16,1,12,2,0,0,0,2,0.34,0.3485,0.87,0.0896,8,79,87,87,4,Pagi
17001,2012-12-16,1,12,3,0,0,0,2,0.34,0.3333,0.87,0.194,1,37,38,38,4,Pagi
17002,2012-12-16,1,12,4,0,0,0,2,0.34,0.3636,0.87,0.0,1,10,11,11,4,Pagi
17003,2012-12-16,1,12,5,0,0,0,2,0.34,0.3636,0.87,0.0,0,9,9,9,4,Pagi
17004,2012-12-16,1,12,6,0,0,0,2,0.34,0.3636,0.87,0.0,0,6,6,6,4,Pagi
17005,2012-12-16,1,12,7,0,0,0,2,0.34,0.3485,0.87,0.0896,5,22,27,27,4,Siang
17006,2012-12-16,1,12,8,0,0,0,2,0.36,0.3485,0.87,0.1343,12,76,88,88,4,Siang
17007,2012-12-16,1,12,9,0,0,0,2,0.36,0.3485,0.87,0.1343,19,113,132,132,4,Siang
17008,2012-12-16,1,12,10,0,0,0,2,0.36,0.3485,0.87,0.1343,42,215,257,257,4,Siang
17009,2012-12-16,1,12,11,0,0,0,2,0.36,0.3485,0.87,0.1343,47,248,295,295,4,Siang
17010,2012-12-16,1,12,12,0,0,0,2,0.38,0.3939,0.82,0.194,67,350,417,417,4,Siang
17011,2012-12-16,1,12,13,0,0,0,2,0.38,0.3939,0.76,0.194,67,289,356,356,4,Sore
17012,2012-12-16,1,12,14,0,0,0,2,0.38,0.3939,0.76,0.1343,50,260,310,310,4,Sore
17013,2012-12-16,1,12,15,0,0,0,2,0.38,0.3939,0.82,0.1045,46,292,338,338,4,Sore
17014,2012-12-16,1,12,16,0,0,0,2,0.38,0.3939,0.82,0.1045,66,334,400,400,4,Sore
17015,2012-12-16,1,12,17,0,0,0,2,0.38,0.3939,0.82,0.1045,29,214,243,243,4,Sore
17016,2012-12-16,1,12,18,0,0,0,3,0.38,0.3939,0.82,0.1045,8,99,107,107,4,Sore
17017,2012-12-16,1,12,19,0,0,0,1,0.36,0.3485,0.93,0.1343,10,99,109,109,4,Malam
17018,2012-12-16,1,12,20,0,0,0,2,0.38,0.3939,0.82,0.0,14,108,122,122,4,Malam
17019,2012-12-16,1,12,21,0,0,0,2,0.36,0.3788,0.93,0.0,14,92,106,106,4,Malam
17020,2012-12-16,1,12,22,0,0,0,2,0.4,0.4091,0.82,0.194,6,83,89,89,4,Malam
17021,2012-12-16,1,12,23,0,0,0,2,0.36,0.3485,0.93,0.1343,4,29,33,33,4,Malam
17022,2012-12-17,1,12,0,0,1,1,2,0.38,0.3939,0.87,0.0,2,26,28,28,4,
17023,2012-12-17,1,12,1,0,1,1,2,0.38,0.3939,0.87,0.1045,1,14,15,15,4,Pagi
17024,2012-12-17,1,12,2,0,1,1,2,0.38,0.3939,0.94,0.0,1,4,5,5,4,Pagi
17025,2012-12-17,1,12,3,0,1,1,2,0.36,0.3788,0.93,0.0,0,3,3,3,4,Pagi
17026,2012-12-17,1,12,4,0,1,1,3,0.36,0.3788,1.0,0.0,2,3,5,5,4,Pagi
17027,2012-12-17,1,12,5,0,1,1,2,0.38,0.3939,0.87,0.0,0,24,24,24,4,Pagi
17028,2012-12-17,1,12,6,0,1,1,2,0.36,0.3485,0.93,0.1343,1,107,108,108,4,Pagi
17029,2012-12-17,1,12,7,0,1,1,2,0.36,0.3485,0.93,0.1343,5,314,319,319,4,Siang
17030,2012-12-17,1,12,8,0,1,1,2,0.38,0.3939,0.87,0.1045,10,582,592,592,4,Siang
17031,2012-12-17,1,12,9,0,1,1,2,0.4,0.4091,0.87,0.0,11,271,282,282,4,Siang
17032,2012-12-17,1,12,10,0,1,1,2,0.38,0.3939,0.87,0.0896,15,120,135,135,4,Siang
17033,2012-12-17,1,12,11,0,1,1,2,0.4,0.4091,0.87,0.0896,22,148,170,170,4,Siang
17034,2012-12-17,1,12,12,0,1,1,2,0.4,0.4091,0.87,0.0,21,211,232,232,4,Siang
17035,2012-12-17,1,12,13,0,1,1,2,0.4,0.4091,0.87,0.1343,16,194,210,210,4,Sore
17036,2012-12-17,1,12,14,0,1,1,2,0.4,0.4091,0.87,0.0896,12,169,181,181,4,Sore
17037,2012-12-17,1,12,15,0,1,1,2,0.42,0.4242,0.88,0.0,15,196,211,211,4,Sore
17038,2012-12-17,1,12,16,0,1,1,3,0.4,0.4091,0.94,0.2537,15,287,302,302,4,Sore
17039,2012-12-17,1,12,17,0,1,1,2,0.4,0.4091,0.94,0.2537,17,478,495,495,4,Sore
17040,2012-12-17,1,12,18,0,1,1,2,0.4,0.4091,0.94,0.0896,14,493,507,507,4,Sore
17041,2012-12-17,1,12,19,0,1,1,2,0.42,0.4242,0.88,0.1343,7,333,340,340,4,Malam
17042,2012-12-17,1,12,20,0,1,1,2,0.42,0.4242,0.94,0.2537,8,192,200,200,4,Malam
17043,2012-12-17,1,12,21,0,1,1,2,0.42,0.4242,0.94,0.1343,6,114,120,120,4,Malam
17044,2012-12-17,1,12,22,0,1,1,2,0.42,0.4242,0.94,0.1343,5,49,54,54,4,Malam
17045,2012-12-17,1,12,23,0,1,1,3,0.42,0.4242,0.94,0.2239,6,41,47,47,4,Malam
17046,2012-12-18,1,12,0,0,2,1,2,0.44,0.4394,0.94,0.1343,0,18,18,18,4,
17047,2012-12-18,1,12,1,0,2,1,2,0.44,0.4394,0.94,0.1343,0,15,15,15,4,Pagi
17048,2012-12-18,1,12,2,0,2,1,2,0.44,0.4394,0.88,0.2239,2,5,7,7,4,Pagi
17049,2012-12-18,1,12,3,0,2,1,1,0.42,0.4242,0.88,0.194,0,5,5,5,4,Pagi
17050,2012-12-18,1,12,4,0,2,1,1,0.42,0.4242,0.82,0.1642,3,5,8,8,4,Pagi
17051,2012-12-18,1,12,5,0,2,1,1,0.38,0.3939,0.87,0.0896,0,36,36,36,4,Pagi
17052,2012-12-18,1,12,6,0,2,1,1,0.36,0.3485,0.93,0.1642,1,117,118,118,4,Pagi
17053,2012-12-18,1,12,7,0,2,1,1,0.36,0.3485,0.93,0.1343,4,351,355,355,4,Siang
17054,2012-12-18,1,12,8,0,2,1,1,0.38,0.3939,0.94,0.0,10,652,662,662,4,Siang
17055,2012-12-18,1,12,9,0,2,1,1,0.4,0.4091,0.87,0.0896,19,307,326,326,4,Siang
17056,2012-12-18,1,12,10,0,2,1,1,0.44,0.4394,0.77,0.0896,22,162,184,184,4,Siang
17057,2012-12-18,1,12,11,0,2,1,1,0.48,0.4697,0.63,0.2239,58,211,269,269,4,Siang
17058,2012-12-18,1,12,12,0,2,1,3,0.48,0.4697,0.48,0.2537,49,264,313,313,4,Siang
17059,2012-12-18,1,12,13,0,2,1,1,0.5,0.4848,0.42,0.2836,51,235,286,286,4,Sore
17060,2012-12-18,1,12,14,0,2,1,1,0.46,0.4545,0.47,0.4478,56,191,247,247,4,Sore
17061,2012-12-18,1,12,15,0,2,1,1,0.46,0.4545,0.44,0.4925,28,218,246,246,4,Sore
17062,2012-12-18,1,12,16,0,2,1,1,0.44,0.4394,0.41,0.4627,40,323,363,363,4,Sore
17063,2012-12-18,1,12,17,0,2,1,1,0.4,0.4091,0.47,0.4478,39,533,572,572,4,Sore
17064,2012-12-18,1,12,18,0,2,1,1,0.38,0.3939,0.46,0.3284,13,512,525,525,4,Sore
17065,2012-12-18,1,12,19,0,2,1,1,0.38,0.3939,0.46,0.3881,19,334,353,353,4,Malam
17066,2012-12-18,1,12,20,0,2,1,1,0.36,0.3333,0.5,0.2537,4,264,268,268,4,Malam
17067,2012-12-18,1,12,21,0,2,1,1,0.36,0.3485,0.5,0.2239,9,159,168,168,4,Malam
17068,2012-12-18,1,12,22,0,2,1,1,0.34,0.3333,0.49,0.0,5,127,132,132,4,Malam
17069,2012-12-18,1,12,23,0,2,1,1,0.34,0.3485,0.49,0.0896,1,80,81,81,4,Malam
17070,2012-12-19,1,12,0,0,3,1,1,0.3,0.3182,0.61,0.0,6,35,41,41,4,
17071,2012-12-19,1,12,1,0,3,1,1,0.3,0.3182,0.65,0.0896,1,14,15,15,4,Pagi
17072,2012-12-19,1,12,2,0,3,1,1,0.28,0.303,0.65,0.0896,1,2,3,3,4,Pagi
17073,2012-12-19,1,12,3,0,3,1,1,0.26,0.2727,0.75,0.1343,0,5,5,5,4,Pagi
17074,2012-12-19,1,12,4,0,3,1,1,0.24,0.2424,0.75,0.1343,1,6,7,7,4,Pagi
17075,2012-12-19,1,12,5,0,3,1,1,0.26,0.2879,0.75,0.0896,2,29,31,31,4,Pagi
17076,2012-12-19,1,12,6,0,3,1,1,0.24,0.2576,0.75,0.0896,3,109,112,112,4,Pagi
17077,2012-12-19,1,12,7,0,3,1,1,0.26,0.2727,0.75,0.1343,3,360,363,363,4,Siang
17078,2012-12-19,1,12,8,0,3,1,1,0.24,0.2576,0.87,0.1045,13,665,678,678,4,Siang
17079,2012-12-19,1,12,9,0,3,1,1,0.28,0.2879,0.75,0.1045,8,309,317,317,4,Siang
17080,2012-12-19,1,12,10,0,3,1,1,0.32,0.3333,0.7,0.1045,17,147,164,164,4,Siang
17081,2012-12-19,1,12,11,0,3,1,1,0.4,0.4091,0.54,0.2239,31,169,200,200,4,Siang
17082,2012-12-19,1,12,12,0,3,1,1,0.4,0.4091,0.54,0.2836,33,203,236,236,4,Siang
17083,2012-12-19,1,12,13,0,3,1,1,0.42,0.4242,0.5,0.194,30,183,213,213,4,Sore
17084,2012-12-19,1,12,14,0,3,1,1,0.42,0.4242,0.5,0.194,33,185,218,218,4,Sore
17085,2012-12-19,1,12,15,0,3,1,1,0.42,0.4242,0.5,0.2836,28,209,237,237,4,Sore
17086,2012-12-19,1,12,16,0,3,1,1,0.42,0.4242,0.5,0.3582,37,297,334,334,4,Sore
17087,2012-12-19,1,12,17,0,3,1,1,0.4,0.4091,0.5,0.3881,26,536,562,562,4,Sore
17088,2012-12-19,1,12,18,0,3,1,1,0.38,0.3939,0.5,0.3582,23,546,569,569,4,Sore
17089,2012-12-19,1,12,19,0,3,1,1,0.38,0.3939,0.5,0.3881,7,329,336,336,4,Malam
17090,2012-12-19,1,12,20,0,3,1,1,0.36,0.3485,0.57,0.2239,10,231,241,241,4,Malam
17091,2012-12-19,1,12,21,0,3,1,1,0.34,0.3182,0.61,0.2239,4,164,168,168,4,Malam
17092,2012-12-19,1,12,22,0,3,1,1,0.34,0.3485,0.61,0.0896,12,117,129,129,4,Malam
17093,2012-12-19,1,12,23,0,3,1,1,0.32,0.3333,0.66,0.1343,4,84,88,88,4,Malam
17094,2012-12-20,1,12,0,0,4,1,1,0.32,0.3333,0.61,0.1343,2,40,42,42,4,
17095,2012-12-20,1,12,1,0,4,1,1,0.32,0.3485,0.66,0.0,1,19,20,20,4,Pagi
17096,2012-12-20,1,12,2,0,4,1,1,0.32,0.3485,0.66,0.0,2,6,8,8,4,Pagi
17097,2012-12-20,1,12,3,0,4,1,2,0.3,0.3182,0.7,0.0896,1,3,4,4,4,Pagi
17098,2012-12-20,1,12,4,0,4,1,2,0.3,0.3182,0.7,0.0896,0,6,6,6,4,Pagi
17099,2012-12-20,1,12,5,0,4,1,2,0.3,0.3182,0.7,0.1045,0,35,35,35,4,Pagi
17100,2012-12-20,1,12,6,0,4,1,2,0.3,0.3333,0.65,0.0,4,114,118,118,4,Pagi
17101,2012-12-20,1,12,7,0,4,1,2,0.3,0.3333,0.7,0.0,4,346,350,350,4,Siang
17102,2012-12-20,1,12,8,0,4,1,2,0.3,0.3333,0.7,0.0,14,585,599,599,4,Siang
17103,2012-12-20,1,12,9,0,4,1,2,0.3,0.3333,0.7,0.0,14,303,317,317,4,Siang
17104,2012-12-20,1,12,10,0,4,1,2,0.32,0.3333,0.66,0.0,23,138,161,161,4,Siang
17105,2012-12-20,1,12,11,0,4,1,2,0.34,0.3182,0.57,0.2239,22,168,190,190,4,Siang
17106,2012-12-20,1,12,12,0,4,1,2,0.36,0.3485,0.53,0.1642,31,181,212,212,4,Siang
17107,2012-12-20,1,12,13,0,4,1,2,0.36,0.3485,0.57,0.194,46,171,217,217,4,Sore
17108,2012-12-20,1,12,14,0,4,1,2,0.36,0.3485,0.53,0.194,43,171,214,214,4,Sore
17109,2012-12-20,1,12,15,0,4,1,2,0.34,0.3333,0.57,0.194,33,216,249,249,4,Sore
17110,2012-12-20,1,12,16,0,4,1,2,0.34,0.303,0.53,0.3284,21,281,302,302,4,Sore
17111,2012-12-20,1,12,17,0,4,1,2,0.34,0.3333,0.66,0.194,25,450,475,475,4,Sore
17112,2012-12-20,1,12,18,0,4,1,2,0.34,0.3333,0.71,0.194,22,359,381,381,4,Sore
17113,2012-12-20,1,12,19,0,4,1,3,0.34,0.3182,0.71,0.2537,3,115,118,118,4,Malam
17114,2012-12-20,1,12,20,0,4,1,3,0.34,0.3333,0.76,0.1642,1,49,50,50,4,Malam
17115,2012-12-20,1,12,21,0,4,1,3,0.34,0.3333,0.76,0.1642,1,25,26,26,4,Malam
17116,2012-12-20,1,12,22,0,4,1,3,0.34,0.3333,0.87,0.194,1,20,21,21,4,Malam
17117,2012-12-20,1,12,23,0,4,1,3,0.4,0.4091,0.82,0.2985,0,13,13,13,4,Malam
17118,2012-12-21,1,12,0,0,5,1,3,0.42,0.4242,0.88,0.2985,0,17,17,17,1,
17119,2012-12-21,1,12,1,0,5,1,3,0.44,0.4394,0.88,0.3881,2,7,9,9,1,Pagi
17120,2012-12-21,1,12,2,0,5,1,3,0.46,0.4545,0.94,0.3881,0,3,3,3,1,Pagi
17121,2012-12-21,1,12,3,0,5,1,3,0.46,0.4545,0.94,0.3881,0,3,3,3,1,Pagi
17122,2012-12-21,1,12,4,0,5,1,2,0.36,0.3182,0.71,0.4925,1,5,6,6,1,Pagi
17123,2012-12-21,1,12,5,0,5,1,2,0.34,0.303,0.76,0.4179,0,13,13,13,1,Pagi
17124,2012-12-21,1,12,6,0,5,1,2,0.34,0.2879,0.57,0.5821,4,76,80,80,1,Pagi
17125,2012-12-21,1,12,7,0,5,1,2,0.32,0.3182,0.57,0.194,3,205,208,208,1,Siang
17126,2012-12-21,1,12,8,0,5,1,2,0.32,0.303,0.57,0.2836,8,464,472,472,1,Siang
17127,2012-12-21,1,12,9,0,5,1,2,0.32,0.2727,0.45,0.5522,2,265,267,267,1,Siang
17128,2012-12-21,1,12,10,0,5,1,1,0.32,0.2879,0.42,0.4627,8,146,154,154,1,Siang
17129,2012-12-21,1,12,11,0,5,1,2,0.32,0.2879,0.42,0.4179,12,150,162,162,1,Siang
17130,2012-12-21,1,12,12,0,5,1,2,0.32,0.2879,0.39,0.3582,25,199,224,224,1,Siang
17131,2012-12-21,1,12,13,0,5,1,2,0.32,0.2879,0.39,0.4179,26,214,240,240,1,Sore
17132,2012-12-21,1,12,14,0,5,1,2,0.32,0.2879,0.39,0.4478,20,199,219,219,1,Sore
17133,2012-12-21,1,12,15,0,5,1,2,0.3,0.2727,0.42,0.3881,29,234,263,263,1,Sore
17134,2012-12-21,1,12,16,0,5,1,2,0.3,0.2727,0.39,0.3284,28,253,281,281,1,Sore
17135,2012-12-21,1,12,17,0,5,1,2,0.26,0.2273,0.56,0.3284,24,297,321,321,1,Sore
17136,2012-12-21,1,12,18,0,5,1,2,0.26,0.2273,0.56,0.2985,7,236,243,243,1,Sore
17137,2012-12-21,1,12,19,0,5,1,1,0.28,0.2576,0.45,0.2985,5,148,153,153,1,Malam
17138,2012-12-21,1,12,20,0,5,1,1,0.28,0.2727,0.41,0.2537,8,104,112,112,1,Malam
17139,2012-12-21,1,12,21,0,5,1,1,0.26,0.2273,0.41,0.4179,2,68,70,70,1,Malam
17140,2012-12-21,1,12,22,0,5,1,1,0.26,0.2273,0.44,0.2985,6,57,63,63,1,Malam
17141,2012-12-21,1,12,23,0,5,1,1,0.26,0.2424,0.44,0.2836,1,39,40,40,1,Malam
17142,2012-12-22,1,12,0,0,6,0,1,0.26,0.2121,0.44,0.5821,1,30,31,31,1,
17143,2012-12-22,1,12,1,0,6,0,1,0.26,0.2121,0.44,0.4478,1,34,35,35,1,Pagi
17144,2012-12-22,1,12,2,0,6,0,1,0.26,0.2121,0.44,0.5224,0,23,23,23,1,Pagi
17145,2012-12-22,1,12,3,0,6,0,1,0.26,0.2121,0.48,0.4478,0,7,7,7,1,Pagi
17146,2012-12-22,1,12,4,0,6,0,1,0.26,0.2576,0.48,0.194,3,2,5,5,1,Pagi
17147,2012-12-22,1,12,5,0,6,0,1,0.26,0.2273,0.48,0.4179,0,5,5,5,1,Pagi
17148,2012-12-22,1,12,6,0,6,0,1,0.26,0.2273,0.44,0.4179,0,13,13,13,1,Pagi
17149,2012-12-22,1,12,7,0,6,0,1,0.26,0.2273,0.44,0.4179,2,18,20,20,1,Siang
17150,2012-12-22,1,12,8,0,6,0,1,0.26,0.2121,0.44,0.6119,0,29,29,29,1,Siang
17151,2012-12-22,1,12,9,0,6,0,1,0.26,0.2273,0.48,0.3881,13,77,90,90,1,Siang
17152,2012-12-22,1,12,10,0,6,0,1,0.26,0.2273,0.48,0.3284,13,105,118,118,1,Siang
17153,2012-12-22,1,12,11,0,6,0,1,0.28,0.2576,0.41,0.3582,29,130,159,159,1,Siang
17154,2012-12-22,1,12,12,0,6,0,1,0.3,0.2576,0.36,0.6567,18,128,146,146,1,Siang
17155,2012-12-22,1,12,13,0,6,0,1,0.32,0.2879,0.36,0.4478,23,135,158,158,1,Sore
17156,2012-12-22,1,12,14,0,6,0,1,0.32,0.2879,0.36,0.4627,20,141,161,161,1,Sore
17157,2012-12-22,1,12,15,0,6,0,1,0.32,0.2727,0.33,0.5821,14,139,153,153,1,Sore
17158,2012-12-22,1,12,16,0,6,0,1,0.3,0.2727,0.39,0.4478,23,124,147,147,1,Sore
17159,2012-12-22,1,12,17,0,6,0,1,0.28,0.2576,0.41,0.2985,15,99,114,114,1,Sore
17160,2012-12-22,1,12,18,0,6,0,1,0.26,0.2121,0.44,0.4627,7,75,82,82,1,Sore
17161,2012-12-22,1,12,19,0,6,0,1,0.24,0.2121,0.48,0.3582,9,51,60,60,1,Malam
17162,2012-12-22,1,12,20,0,6,0,1,0.24,0.2424,0.48,0.1642,6,55,61,61,1,Malam
17163,2012-12-22,1,12,21,0,6,0,1,0.22,0.2121,0.51,0.2836,4,49,53,53,1,Malam
17164,2012-12-22,1,12,22,0,6,0,1,0.22,0.2121,0.51,0.2836,1,38,39,39,1,Malam
17165,2012-12-22,1,12,23,0,6,0,1,0.22,0.2273,0.51,0.194,3,37,40,40,1,Malam
17166,2012-12-23,1,12,0,0,0,0,1,0.22,0.2121,0.47,0.2836,3,24,27,27,1,
17167,2012-12-23,1,12,1,0,0,0,1,0.22,0.2273,0.47,0.194,1,19,20,20,1,Pagi
17168,2012-12-23,1,12,2,0,0,0,1,0.2,0.2121,0.51,0.1642,1,17,18,18,1,Pagi
17169,2012-12-23,1,12,3,0,0,0,1,0.2,0.2121,0.51,0.1343,0,9,9,9,1,Pagi
17170,2012-12-23,1,12,4,0,0,0,1,0.2,0.2121,0.47,0.1343,1,3,4,4,1,Pagi
17171,2012-12-23,1,12,5,0,0,0,1,0.2,0.2576,0.51,0.0,0,6,6,6,1,Pagi
17172,2012-12-23,1,12,6,0,0,0,1,0.16,0.197,0.64,0.0896,4,5,9,9,1,Pagi
17173,2012-12-23,1,12,7,0,0,0,1,0.16,0.197,0.64,0.0896,3,16,19,19,1,Siang
17174,2012-12-23,1,12,8,0,0,0,1,0.14,0.1667,0.69,0.1045,5,43,48,48,1,Siang
17175,2012-12-23,1,12,9,0,0,0,1,0.2,0.2273,0.59,0.1045,7,49,56,56,1,Siang
17176,2012-12-23,1,12,10,0,0,0,1,0.22,0.2273,0.64,0.194,26,67,93,93,1,Siang
17177,2012-12-23,1,12,11,0,0,0,1,0.24,0.2273,0.52,0.194,48,104,152,152,1,Siang
17178,2012-12-23,1,12,12,0,0,0,1,0.3,0.2879,0.42,0.194,52,144,196,196,1,Siang
17179,2012-12-23,1,12,13,0,0,0,1,0.32,0.303,0.39,0.2239,63,123,186,186,1,Sore
17180,2012-12-23,1,12,14,0,0,0,1,0.34,0.303,0.31,0.2985,57,118,175,175,1,Sore
17181,2012-12-23,1,12,15,0,0,0,1,0.34,0.3333,0.34,0.1343,39,98,137,137,1,Sore
17182,2012-12-23,1,12,16,0,0,0,1,0.34,0.3333,0.34,0.194,53,137,190,190,1,Sore
17183,2012-12-23,1,12,17,0,0,0,1,0.32,0.3182,0.49,0.194,21,93,114,114,1,Sore
17184,2012-12-23,1,12,18,0,0,0,1,0.3,0.303,0.45,0.1642,8,85,93,93,1,Sore
17185,2012-12-23,1,12,19,0,0,0,1,0.3,0.3333,0.42,0.0,4,54,58,58,1,Malam
17186,2012-12-23,1,12,20,0,0,0,1,0.26,0.303,0.65,0.0,0,52,52,52,1,Malam
17187,2012-12-23,1,12,21,0,0,0,1,0.24,0.2879,0.7,0.0,4,38,42,42,1,Malam
17188,2012-12-23,1,12,22,0,0,0,1,0.24,0.2576,0.6,0.1045,5,53,58,58,1,Malam
17189,2012-12-23,1,12,23,0,0,0,1,0.24,0.2879,0.6,0.0,3,22,25,25,1,Malam
17190,2012-12-24,1,12,0,0,1,1,1,0.22,0.2727,0.69,0.0,0,12,12,12,1,
17191,2012-12-24,1,12,1,0,1,1,1,0.22,0.2727,0.69,0.0,0,11,11,11,1,Pagi
17192,2012-12-24,1,12,2,0,1,1,1,0.2,0.2576,0.75,0.0,0,5,5,5,1,Pagi
17193,2012-12-24,1,12,3,0,1,1,1,0.2,0.2576,0.75,0.0,1,2,3,3,1,Pagi
17194,2012-12-24,1,12,5,0,1,1,1,0.18,0.197,0.8,0.1343,0,9,9,9,1,Pagi
17195,2012-12-24,1,12,6,0,1,1,1,0.2,0.2576,0.75,0.0,1,16,17,17,1,Pagi
17196,2012-12-24,1,12,7,0,1,1,1,0.2,0.2576,0.69,0.0,3,27,30,30,1,Siang
17197,2012-12-24,1,12,8,0,1,1,1,0.22,0.2727,0.69,0.0,4,62,66,66,1,Siang
17198,2012-12-24,1,12,9,0,1,1,2,0.24,0.2576,0.65,0.1045,17,68,85,85,1,Siang
17199,2012-12-24,1,12,10,0,1,1,2,0.26,0.303,0.65,0.0,21,82,103,103,1,Siang
17200,2012-12-24,1,12,11,0,1,1,2,0.26,0.2576,0.6,0.1642,20,104,124,124,1,Siang
17201,2012-12-24,1,12,12,0,1,1,2,0.28,0.303,0.56,0.0896,22,113,135,135,1,Siang
17202,2012-12-24,1,12,13,0,1,1,3,0.24,0.2576,0.81,0.1045,16,54,70,70,1,Sore
17203,2012-12-24,1,12,14,0,1,1,3,0.24,0.2576,0.87,0.1045,13,33,46,46,1,Sore
17204,2012-12-24,1,12,15,0,1,1,3,0.24,0.2273,0.87,0.2239,6,27,33,33,1,Sore
17205,2012-12-24,1,12,16,0,1,1,3,0.24,0.2273,0.87,0.2239,6,27,33,33,1,Sore
17206,2012-12-24,1,12,17,0,1,1,3,0.24,0.2424,0.93,0.1642,7,19,26,26,1,Sore
17207,2012-12-24,1,12,18,0,1,1,3,0.24,0.2576,0.93,0.1045,6,20,26,26,1,Sore
17208,2012-12-24,1,12,19,0,1,1,2,0.24,0.2424,0.93,0.1343,4,14,18,18,1,Malam
17209,2012-12-24,1,12,20,0,1,1,3,0.24,0.2424,0.93,0.1343,6,17,23,23,1,Malam
17210,2012-12-24,1,12,21,0,1,1,3,0.24,0.2576,0.93,0.0896,13,9,22,22,1,Malam
17211,2012-12-24,1,12,22,0,1,1,2,0.24,0.2879,0.93,0.0,7,5,12,12,1,Malam
17212,2012-12-24,1,12,23,0,1,1,3,0.24,0.2879,0.93,0.0,1,10,11,11,1,Malam
17213,2012-12-25,1,12,0,1,2,0,3,0.24,0.2576,0.93,0.0896,3,10,13,13,1,
17214,2012-12-25,1,12,1,1,2,0,2,0.26,0.2576,0.87,0.1642,0,13,13,13,1,Pagi
17215,2012-12-25,1,12,2,1,2,0,2,0.26,0.2576,0.87,0.1642,0,7,7,7,1,Pagi
17216,2012-12-25,1,12,4,1,2,0,2,0.24,0.2576,0.87,0.0896,0,1,1,1,1,Pagi
17217,2012-12-25,1,12,5,1,2,0,2,0.22,0.2273,0.93,0.1343,2,1,3,3,1,Pagi
17218,2012-12-25,1,12,6,1,2,0,2,0.22,0.2273,0.93,0.1343,1,6,7,7,1,Pagi
17219,2012-12-25,1,12,7,1,2,0,2,0.22,0.2273,0.93,0.1642,0,6,6,6,1,Siang
17220,2012-12-25,1,12,8,1,2,0,2,0.24,0.2879,0.87,0.0,1,10,11,11,1,Siang
17221,2012-12-25,1,12,9,1,2,0,2,0.24,0.2576,0.87,0.0,7,21,28,28,1,Siang
17222,2012-12-25,1,12,10,1,2,0,1,0.28,0.3182,0.81,0.0,11,21,32,32,1,Siang
17223,2012-12-25,1,12,11,1,2,0,1,0.3,0.3182,0.75,0.0896,43,43,86,86,1,Siang
17224,2012-12-25,1,12,12,1,2,0,1,0.32,0.3333,0.76,0.0896,62,52,114,114,1,Siang
17225,2012-12-25,1,12,13,1,2,0,1,0.4,0.4091,0.5,0.3284,75,46,121,121,1,Sore
17226,2012-12-25,1,12,14,1,2,0,1,0.38,0.3939,0.46,0.2985,58,68,126,126,1,Sore
17227,2012-12-25,1,12,15,1,2,0,1,0.36,0.3333,0.5,0.2537,51,56,107,107,1,Sore
17228,2012-12-25,1,12,16,1,2,0,2,0.36,0.3333,0.5,0.2537,48,38,86,86,1,Sore
17229,2012-12-25,1,12,17,1,2,0,2,0.32,0.303,0.57,0.2537,16,34,50,50,1,Sore
17230,2012-12-25,1,12,18,1,2,0,2,0.32,0.303,0.66,0.2537,20,23,43,43,1,Sore
17231,2012-12-25,1,12,19,1,2,0,2,0.32,0.303,0.66,0.2239,16,20,36,36,1,Malam
17232,2012-12-25,1,12,20,1,2,0,2,0.32,0.303,0.66,0.2836,11,29,40,40,1,Malam
17233,2012-12-25,1,12,21,1,2,0,2,0.3,0.2879,0.65,0.194,8,26,34,34,1,Malam
17234,2012-12-25,1,12,22,1,2,0,2,0.3,0.303,0.7,0.1642,3,16,19,19,1,Malam
17235,2012-12-25,1,12,23,1,2,0,2,0.28,0.2727,0.65,0.2537,4,26,30,30,1,Malam
17236,2012-12-26,1,12,0,0,3,1,2,0.28,0.2727,0.65,0.2537,1,8,9,9,1,
17237,2012-12-26,1,12,1,0,3,1,2,0.26,0.2273,0.65,0.2985,0,7,7,7,1,Pagi
17238,2012-12-26,1,12,2,0,3,1,2,0.26,0.2273,0.65,0.2985,0,1,1,1,1,Pagi
17239,2012-12-26,1,12,3,0,3,1,2,0.24,0.2121,0.7,0.3582,0,2,2,2,1,Pagi
17240,2012-12-26,1,12,4,0,3,1,1,0.22,0.197,0.69,0.3582,0,2,2,2,1,Pagi
17241,2012-12-26,1,12,5,0,3,1,2,0.22,0.2121,0.69,0.2836,0,11,11,11,1,Pagi
17242,2012-12-26,1,12,6,0,3,1,2,0.22,0.2121,0.69,0.2239,0,36,36,36,1,Pagi
17243,2012-12-26,1,12,7,0,3,1,3,0.2,0.1818,0.86,0.3284,0,26,26,26,1,Siang
17244,2012-12-26,1,12,8,0,3,1,3,0.2,0.1818,0.86,0.3284,0,31,31,31,1,Siang
17245,2012-12-26,1,12,9,0,3,1,3,0.2,0.1818,0.86,0.3284,1,22,23,23,1,Siang
17246,2012-12-26,1,12,10,0,3,1,3,0.2,0.1818,0.86,0.2985,0,8,8,8,1,Siang
17247,2012-12-26,1,12,11,0,3,1,3,0.2,0.1667,0.86,0.4627,0,10,10,10,1,Siang
17248,2012-12-26,1,12,12,0,3,1,3,0.22,0.197,0.87,0.3284,0,10,10,10,1,Siang
17249,2012-12-26,1,12,13,0,3,1,3,0.22,0.197,0.87,0.3284,0,15,15,15,1,Sore
17250,2012-12-26,1,12,14,0,3,1,3,0.22,0.2121,0.93,0.2537,0,20,20,20,1,Sore
17251,2012-12-26,1,12,15,0,3,1,3,0.26,0.2273,0.87,0.3582,0,13,13,13,1,Sore
17252,2012-12-26,1,12,16,0,3,1,3,0.26,0.2273,0.87,0.3582,0,13,13,13,1,Sore
17253,2012-12-26,1,12,17,0,3,1,3,0.26,0.2273,0.93,0.3582,2,51,53,53,1,Sore
17254,2012-12-26,1,12,18,0,3,1,3,0.28,0.2576,0.93,0.2985,1,42,43,43,1,Sore
17255,2012-12-26,1,12,19,0,3,1,3,0.3,0.2879,0.87,0.194,2,33,35,35,1,Malam
17256,2012-12-26,1,12,20,0,3,1,3,0.32,0.303,0.93,0.2537,0,32,32,32,1,Malam
17257,2012-12-26,1,12,21,0,3,1,2,0.3,0.2727,0.87,0.2985,0,20,20,20,1,Malam
17258,2012-12-26,1,12,22,0,3,1,3,0.24,0.197,0.93,0.4478,0,11,11,11,1,Malam
17259,2012-12-26,1,12,23,0,3,1,3,0.26,0.2273,0.87,0.2985,2,8,10,10,1,Malam
17260,2012-12-27,1,12,0,0,4,1,3,0.26,0.2273,0.87,0.2985,0,3,3,3,1,
17261,2012-12-27,1,12,1,0,4,1,3,0.24,0.197,0.93,0.4478,0,5,5,5,1,Pagi
17262,2012-12-27,1,12,2,0,4,1,2,0.24,0.197,0.87,0.4478,0,2,2,2,1,Pagi
17263,2012-12-27,1,12,3,0,4,1,2,0.24,0.2273,0.87,0.2239,0,1,1,1,1,Pagi
17264,2012-12-27,1,12,4,0,4,1,2,0.24,0.2121,0.87,0.3284,0,3,3,3,1,Pagi
17265,2012-12-27,1,12,5,0,4,1,1,0.24,0.2424,0.75,0.1642,1,10,11,11,1,Pagi
17266,2012-12-27,1,12,6,0,4,1,1,0.24,0.197,0.7,0.4925,0,45,45,45,1,Pagi
17267,2012-12-27,1,12,7,0,4,1,1,0.24,0.2273,0.7,0.2239,0,90,90,90,1,Siang
17268,2012-12-27,1,12,8,0,4,1,1,0.26,0.2273,0.65,0.3582,2,206,208,208,1,Siang
17269,2012-12-27,1,12,9,0,4,1,1,0.26,0.2121,0.6,0.4925,6,127,133,133,1,Siang
17270,2012-12-27,1,12,10,0,4,1,1,0.28,0.2273,0.56,0.5224,8,67,75,75,1,Siang
17271,2012-12-27,1,12,11,0,4,1,2,0.28,0.2424,0.56,0.4478,23,80,103,103,1,Siang
17272,2012-12-27,1,12,12,0,4,1,1,0.3,0.2727,0.49,0.4627,22,87,109,109,1,Siang
17273,2012-12-27,1,12,13,0,4,1,1,0.3,0.2727,0.49,0.4627,19,99,118,118,1,Sore
17274,2012-12-27,1,12,14,0,4,1,2,0.26,0.2121,0.56,0.5224,25,94,119,119,1,Sore
17275,2012-12-27,1,12,15,0,4,1,2,0.26,0.2121,0.56,0.4478,31,89,120,120,1,Sore
17276,2012-12-27,1,12,16,0,4,1,2,0.26,0.2424,0.52,0.2836,23,151,174,174,1,Sore
17277,2012-12-27,1,12,17,0,4,1,2,0.26,0.2424,0.52,0.2836,30,227,257,257,1,Sore
17278,2012-12-27,1,12,18,0,4,1,2,0.24,0.2273,0.6,0.2537,9,188,197,197,1,Sore
17279,2012-12-27,1,12,19,0,4,1,1,0.24,0.2121,0.6,0.2836,11,106,117,117,1,Malam
17280,2012-12-27,1,12,20,0,4,1,1,0.24,0.2424,0.6,0.1642,12,79,91,91,1,Malam
17281,2012-12-27,1,12,21,0,4,1,2,0.24,0.2273,0.6,0.2537,12,51,63,63,1,Malam
17282,2012-12-27,1,12,22,0,4,1,2,0.24,0.2121,0.6,0.2836,11,33,44,44,1,Malam
17283,2012-12-27,1,12,23,0,4,1,2,0.24,0.2273,0.6,0.2537,2,24,26,26,1,Malam
17284,2012-12-28,1,12,0,0,5,1,2,0.24,0.2424,0.6,0.1642,3,22,25,25,1,
17285,2012-12-28,1,12,1,0,5,1,1,0.24,0.2273,0.6,0.194,0,9,9,9,1,Pagi
17286,2012-12-28,1,12,2,0,5,1,1,0.24,0.2273,0.6,0.2537,0,5,5,5,1,Pagi
17287,2012-12-28,1,12,3,0,5,1,2,0.24,0.2424,0.6,0.1642,0,2,2,2,1,Pagi
17288,2012-12-28,1,12,4,0,5,1,2,0.24,0.2576,0.6,0.1045,0,4,4,4,1,Pagi
17289,2012-12-28,1,12,5,0,5,1,2,0.24,0.2576,0.6,0.0896,0,15,15,15,1,Pagi
17290,2012-12-28,1,12,6,0,5,1,1,0.22,0.2121,0.64,0.2836,2,49,51,51,1,Pagi
17291,2012-12-28,1,12,7,0,5,1,1,0.22,0.2273,0.64,0.1642,1,111,112,112,1,Siang
17292,2012-12-28,1,12,8,0,5,1,2,0.24,0.2424,0.6,0.1343,1,238,239,239,1,Siang
17293,2012-12-28,1,12,9,0,5,1,2,0.24,0.2121,0.6,0.2836,18,173,191,191,1,Siang
17294,2012-12-28,1,12,10,0,5,1,2,0.26,0.2424,0.56,0.2537,77,85,162,162,1,Siang
17295,2012-12-28,1,12,11,0,5,1,2,0.28,0.2727,0.52,0.2239,71,107,178,178,1,Siang
17296,2012-12-28,1,12,12,0,5,1,2,0.3,0.303,0.49,0.1343,72,150,222,222,1,Siang
17297,2012-12-28,1,12,13,0,5,1,2,0.3,0.303,0.49,0.1343,76,146,222,222,1,Sore
17298,2012-12-28,1,12,14,0,5,1,2,0.3,0.303,0.49,0.1343,84,177,261,261,1,Sore
17299,2012-12-28,1,12,15,0,5,1,2,0.3,0.3182,0.49,0.0,74,151,225,225,1,Sore
17300,2012-12-28,1,12,16,0,5,1,1,0.3,0.303,0.49,0.1343,42,208,250,250,1,Sore
17301,2012-12-28,1,12,17,0,5,1,1,0.24,0.2424,0.6,0.1343,43,228,271,271,1,Sore
17302,2012-12-28,1,12,18,0,5,1,1,0.24,0.2424,0.6,0.1343,16,197,213,213,1,Sore
17303,2012-12-28,1,12,19,0,5,1,2,0.24,0.2273,0.65,0.194,15,113,128,128,1,Malam
17304,2012-12-28,1,12,20,0,5,1,2,0.24,0.2576,0.65,0.1045,14,83,97,97,1,Malam
17305,2012-12-28,1,12,21,0,5,1,2,0.24,0.2424,0.7,0.1343,17,75,92,92,1,Malam
17306,2012-12-28,1,12,22,0,5,1,2,0.24,0.2576,0.7,0.0896,13,49,62,62,1,Malam
17307,2012-12-28,1,12,23,0,5,1,2,0.24,0.2576,0.65,0.0896,5,54,59,59,1,Malam
17308,2012-12-29,1,12,0,0,6,0,2,0.24,0.2424,0.7,0.0,1,25,26,26,1,
17309,2012-12-29,1,12,1,0,6,0,2,0.24,0.2424,0.75,0.0896,6,31,37,37,1,Pagi
17310,2012-12-29,1,12,2,0,6,0,2,0.24,0.2424,0.7,0.0,1,18,19,19,1,Pagi
17311,2012-12-29,1,12,3,0,6,0,2,0.24,0.2424,0.75,0.0,1,5,6,6,1,Pagi
17312,2012-12-29,1,12,4,0,6,0,2,0.24,0.2424,0.75,0.0896,0,3,3,3,1,Pagi
17313,2012-12-29,1,12,5,0,6,0,2,0.24,0.2424,0.75,0.0896,0,3,3,3,1,Pagi
17314,2012-12-29,1,12,6,0,6,0,2,0.26,0.2424,0.7,0.1045,0,7,7,7,1,Pagi
17315,2012-12-29,1,12,7,0,6,0,2,0.26,0.2424,0.7,0.1343,1,17,18,18,1,Siang
17316,2012-12-29,1,12,8,0,6,0,2,0.26,0.2424,0.81,0.0,9,35,44,44,1,Siang
17317,2012-12-29,1,12,9,0,6,0,2,0.26,0.2424,0.81,0.0,16,33,49,49,1,Siang
17318,2012-12-29,1,12,10,0,6,0,3,0.26,0.2424,0.81,0.1343,6,35,41,41,1,Siang
17319,2012-12-29,1,12,11,0,6,0,3,0.2,0.2424,0.93,0.0896,7,38,45,45,1,Siang
17320,2012-12-29,1,12,12,0,6,0,3,0.2,0.2424,1.0,0.0,5,43,48,48,1,Siang
17321,2012-12-29,1,12,13,0,6,0,3,0.2,0.2424,1.0,0.0,13,71,84,84,1,Sore
17322,2012-12-29,1,12,14,0,6,0,2,0.24,0.2424,0.87,0.0896,10,88,98,98,1,Sore
17323,2012-12-29,1,12,15,0,6,0,2,0.24,0.2424,0.87,0.0,19,110,129,129,1,Sore
17324,2012-12-29,1,12,16,0,6,0,1,0.3,0.2424,0.75,0.1045,22,125,147,147,1,Sore
17325,2012-12-29,1,12,17,0,6,0,1,0.26,0.2424,0.79,0.1045,18,100,118,118,1,Sore
17326,2012-12-29,1,12,18,0,6,0,1,0.3,0.2424,0.7,0.194,8,102,110,110,1,Sore
17327,2012-12-29,1,12,19,0,6,0,2,0.3,0.2424,0.61,0.2537,7,90,97,97,1,Malam
17328,2012-12-29,1,12,20,0,6,0,2,0.3,0.2424,0.56,0.5522,2,64,66,66,1,Malam
17329,2012-12-29,1,12,21,0,6,0,2,0.28,0.2424,0.56,0.4925,4,56,60,60,1,Malam
17330,2012-12-29,1,12,22,0,6,0,2,0.26,0.2424,0.6,0.4627,3,51,54,54,1,Malam
17331,2012-12-29,1,12,23,0,6,0,2,0.26,0.2424,0.6,0.0,0,32,32,32,1,Malam
17332,2012-12-30,1,12,0,0,0,0,2,0.26,0.2576,0.6,0.1642,0,41,41,41,1,
17333,2012-12-30,1,12,1,0,0,0,2,0.26,0.2273,0.56,0.4179,1,27,28,28,1,Pagi
17334,2012-12-30,1,12,2,0,0,0,2,0.26,0.2424,0.56,0.2836,0,19,19,19,1,Pagi
17335,2012-12-30,1,12,3,0,0,0,2,0.26,0.2273,0.56,0.4179,1,14,15,15,1,Pagi
17336,2012-12-30,1,12,4,0,0,0,2,0.26,0.2576,0.56,0.2239,0,7,7,7,1,Pagi
17337,2012-12-30,1,12,5,0,0,0,2,0.26,0.2273,0.48,0.2985,0,2,2,2,1,Pagi
17338,2012-12-30,1,12,6,0,0,0,2,0.24,0.197,0.52,0.4179,1,7,8,8,1,Pagi
17339,2012-12-30,1,12,7,0,0,0,1,0.24,0.2121,0.56,0.3582,0,13,13,13,1,Siang
17340,2012-12-30,1,12,8,0,0,0,1,0.24,0.197,0.52,0.4627,1,32,33,33,1,Siang
17341,2012-12-30,1,12,9,0,0,0,1,0.24,0.2121,0.52,0.3881,9,65,74,74,1,Siang
17342,2012-12-30,1,12,10,0,0,0,1,0.26,0.2121,0.41,0.5821,31,91,122,122,1,Siang
17343,2012-12-30,1,12,11,0,0,0,1,0.26,0.2273,0.41,0.4179,33,103,136,136,1,Siang
17344,2012-12-30,1,12,12,0,0,0,1,0.28,0.2273,0.36,0.5821,47,97,144,144,1,Siang
17345,2012-12-30,1,12,13,0,0,0,1,0.3,0.2576,0.36,0.6567,49,120,169,169,1,Sore
17346,2012-12-30,1,12,14,0,0,0,1,0.3,0.2727,0.36,0.4627,39,121,160,160,1,Sore
17347,2012-12-30,1,12,15,0,0,0,1,0.28,0.2576,0.38,0.3284,37,101,138,138,1,Sore
17348,2012-12-30,1,12,16,0,0,0,1,0.28,0.2424,0.38,0.4179,31,102,133,133,1,Sore
17349,2012-12-30,1,12,17,0,0,0,1,0.26,0.2273,0.41,0.3284,26,97,123,123,1,Sore
17350,2012-12-30,1,12,18,0,0,0,2,0.24,0.2121,0.44,0.2985,12,113,125,125,1,Sore
17351,2012-12-30,1,12,19,0,0,0,1,0.34,0.3636,0.61,0.0,16,86,102,102,1,Malam
17352,2012-12-30,1,12,20,0,0,0,1,0.22,0.197,0.47,0.3284,9,63,72,72,1,Malam
17353,2012-12-30,1,12,21,0,0,0,1,0.2,0.2121,0.51,0.1642,5,42,47,47,1,Malam
17354,2012-12-30,1,12,22,0,0,0,1,0.2,0.197,0.55,0.194,6,30,36,36,1,Malam
17355,2012-12-30,1,12,23,0,0,0,1,0.2,0.197,0.51,0.2239,10,39,49,49,1,Malam
17356,2012-12-31,1,12,0,0,1,1,1,0.18,0.1818,0.55,0.194,4,30,34,34,1,
17357,2012-12-31,1,12,1,0,1,1,1,0.18,0.1818,0.55,0.194,6,13,19,19,1,Pagi
17358,2012-12-31,1,12,2,0,1,1,1,0.16,0.1667,0.59,0.1642,3,8,11,11,1,Pagi
17359,2012-12-31,1,12,3,0,1,1,1,0.16,0.1818,0.59,0.1045,0,1,1,1,1,Pagi
17360,2012-12-31,1,12,4,0,1,1,1,0.14,0.1667,0.69,0.1045,0,3,3,3,1,Pagi
17361,2012-12-31,1,12,5,0,1,1,1,0.16,0.1515,0.64,0.194,0,9,9,9,1,Pagi
17362,2012-12-31,1,12,6,0,1,1,1,0.16,0.1667,0.64,0.1642,0,40,40,40,1,Pagi
17363,2012-12-31,1,12,7,0,1,1,1,0.16,0.1818,0.64,0.1343,2,83,85,85,1,Siang
17364,2012-12-31,1,12,8,0,1,1,1,0.14,0.1515,0.69,0.1343,9,187,196,196,1,Siang
17365,2012-12-31,1,12,9,0,1,1,2,0.18,0.2121,0.64,0.1045,13,144,157,157,1,Siang
17366,2012-12-31,1,12,10,0,1,1,2,0.2,0.2121,0.69,0.1343,33,87,120,120,1,Siang
17367,2012-12-31,1,12,11,0,1,1,2,0.22,0.2273,0.6,0.194,43,114,157,157,1,Siang
17368,2012-12-31,1,12,12,0,1,1,2,0.24,0.2273,0.56,0.194,52,172,224,224,1,Siang
17369,2012-12-31,1,12,13,0,1,1,2,0.26,0.2576,0.44,0.1642,38,165,203,203,1,Sore
17370,2012-12-31,1,12,14,0,1,1,2,0.28,0.2727,0.45,0.2239,62,185,247,247,1,Sore
17371,2012-12-31,1,12,15,0,1,1,2,0.28,0.2879,0.45,0.1343,69,246,315,315,1,Sore
17372,2012-12-31,1,12,16,0,1,1,2,0.26,0.2576,0.48,0.194,30,184,214,214,1,Sore
17373,2012-12-31,1,12,17,0,1,1,2,0.26,0.2879,0.48,0.0896,14,150,164,164,1,Sore
17374,2012-12-31,1,12,18,0,1,1,2,0.26,0.2727,0.48,0.1343,10,112,122,122,1,Sore
17375,2012-12-31,1,12,19,0,1,1,2,0.26,0.2576,0.6,0.1642,11,108,119,119,1,Malam
17376,2012-12-31,1,12,20,0,1,1,2,0.26,0.2576,0.6,0.1642,8,81,89,89,1,Malam
17377,2012-12-31,1,12,21,0,1,1,1,0.26,0.2576,0.6,0.1642,7,83,90,90,1,Malam
17378,2012-12-31,1,12,22,0,1,1,1,0.26,0.2727,0.56,0.1343,13,48,61,61,1,Malam
17379,2012-12-31,1,12,23,0,1,1,1,0.26,0.2727,0.65,0.1343,12,37,49,49,1,Malam
